2 75
143 55
78 98
151 42
145 5
137 70
84 74
99 77
115 88
85 8

10011111111111111111111011111010111011001111011101111111111111111111111222211222101011210201222121120111101111111001011100111110012122212202b1222202112200212102
11111001011111111111101111110111111111111111101111111101101001111111112222202112120011212102221201122011111011111110101111111111111210100100a0202101220122222111
11101111111111111111111110110111100101111111101111111111111110111111112202212010101211121211212122101001111110111111111111111110111101201211a1010112122221220210
01101101111011110111111111001111111110100011101111101111001001111111012121112202221102222211011121120111111110111111101101100111112210221121a2011220122200122111
11111100111101110111101101111111111010111111111011000111010111100111110112221111101102221211210222211110110001111011110011101101112022202111b2122212202122000110
11111111111111111111011111110111011011101111111101011111100111111111111202121100121220121200122122122001111010010111001111011011110110012110b0212120112220100121
11111011111111101111101111011110111110110111111101101111110111111110111122122201221212201112001201210111111101010111101111111101111102121221b2102212001122221122
10111111111100011111011111111111110111100110111111111101111111111101101112121100020120111022210111212111111011101110011111101111001212221122a2210112220011211110
11111111111101110111011111011111111111111111011111011101111011011111112021211121010112022010022021112111110110111101110111101111002202111202a2111011222021021012
11111111111111111101110011110111001011011110111011011011101111111111011212221110012022222212122121101111110101111011011111110111111211222212a2022110112002011210
11101111110100111110101111110111101110111011111110101100111111011111111110121200212002221101221121222101101111101101001011111011110212212222a2112012121112122221
10111111111011001111111111111111110111011111001100011111111111111001012111120221222221201212222000120111101111011111001111111111111220202102b1111110122121212111
11011111111111111111101111111110111111111111111110110011111111110011112121201220001200211002110122012101111111011111011001011011110121121200a2222221111102021212
01110111111101101110011101101111111111101111111100111111101111110101112110211201010220110122201120220111101111011101110111111111002022121211a2210221121221111102
11111110111111111011101111111111011111111011110110111101111111111101111111112221112010012212221222222101111011001111111111100111011102010122a2212121222021212111
00101111111101111111111111111111111110111111101111111111001111111111102120121001110210122221101122122111111111011011111110111111112201222022b1122211220022121102
11110011111111111011011111101111001111001110110001011010001110001111102121120211010122222101122211112000111111101111111111100111012101201100b2121121200111212220
aaaaaaaaaaaaaaaaaaaaaaaaaaaaaaaaaaaaaaaaaaaaaaaaaaaaaaaaaaaaaaaaaaaaaaaaaaaaababbbaabbbbaaababaaaabbaaaaaaaaaaaaaaaaaaaaaaaaaaaaaababbbabbbba1011111221112022222
0001110111111111101111111111111111011111101110111111110101110101011111101021122101112212210211110101111011011111100111100111011111021011212200211200021210001212
0010111110111101111101111111111011110001101111110111110111111111111111221111012112111022112120122022110111100011101011111101100111220221102202000221222212221202
1110111101011111110011111011111111111111111111110110111110101111111101102222220000222022102022222112111011111011111001111111111111012201222221212010000220211022
1111111111111111111011111110001111101111110110001110011101111011111111110111221012222212220111011220111100101111111111101111111101112212211212222121211220201002
1010111111101001111110111011110111001111111111111111101100111111111111112122012112121112001202121112111011011010111011011010101111022122211110211120021212210111
1110101111111111010111110111010100011111011101011101001001111111111110222021201111221211111111201210111010111111111111111011111111022211120121221211022121122212
0110111111111111110111011010101111111111111011111111100111011000111110101012111102221102021202210200201111100111111111011111111110102020212122221112110120221221
1111111111001110111111111101111110011111001110111110111000010101011111111211221210110121101112221201211111111111111111001110111111102010202221122112222111122221
1001011111011111111011011011111110001111110101111110101111111111111101120112211120011210022201022001210101100111111011010101011110212121221112212220111221120112
1111111111111111111110011101101110111011010110001111111110111111011101122110211121210001220122211100211111011110111100110110111111122101102201220022022212222222
1001111111101111111111111100111111110111110111111111111101111111111111211121201222220211020001221121111111101101111111010101111101022111222222202212012210122222
1111111110011101110011101111101110011011111100111101111111111111111111102201102222122221111222211021000101111111111111111111110111220121020202220222220202022120
1111110111011111011111001110111010011101111001110111111011111011111011101121220112112120001222222221110011111011111111110011011011022100202222010100202022012122
aaaaaaaaPPPPPPPPPPPPPPPPPPPPPPPPPPPPPPPPPPPPPPPPPPPPPPPPPPPPPPPPPPPPPPPPPPPPPPPPPPPPPPPPPPPPPPPPPPPPPPPPPPPPPPPPPPPPPPPPPPPPPPPPPPPPPPaaaababbbbbaabaaabaabbbaaa
1111111P11111110111111111111010111111111111011110111111100111011111001101111100aaaaaaaaaaaaaaaaaaaaaaaaaaaaaaaaaaaaaaaaaaaaaaaaaaaaaaaPaababbabababbaaaaabaabaab
1011111P11110111011100111111111111110111011010111111110010111001111101111001011a1101111111111101110111111111111011100110111111111111111P202112112010222112111222
1111111P11101011111001101111010101011111111110111111111101011111101111111111111a1111111111111110001010110111111111111111100101100110111P102001210020111101121121
1111110P01111111101111111111111101111111111111101010101111101001111111001010111a1111101111101111001101111111111111111111111011111111100P222211121021022011120212
111111P111001101111111110111111111111111111111111010111111111111111111111111111a0111100111111111111100111111110110011011110101111111101P011002111200122112201110
011101P111111011111111101111011101111111111111111111011110111100111111011111111a1111011111110111111011101111011111111111111011010010111P021121122212102210202212
111010P011111111111011111011101111111111101111111101111111111011111111111111101a1011100111111001101111111111111100110001111011111110111P000211222110111022212002
111111P110110001110011101111111110111111101010111100111111011111111111101111101a01111111110110111101111011111110111111111110111011111111P10221111222022110212010
111111P110101110101111111110110110111011111101111101111111111111111111111111011a110111111110011011100111110111010110111111110011111110101P2021021120111021100001
011111P111111100111111111110101011111111110111111011010111111010111101110001010a1111110111100101110101110111011111010111111011111100111102P112222212101211212111
100011P101110110110111011111101100111111110111111111111111111101100111101111111a110111111111111111111101111011110110011111110110011111111P0020001020211212212221
101100P111010110011101111111111111111011111111111110101110111111101011110111111a1011101111111110111110111110111101111110111111110111011122PP11211101112100112012
010110P101010110110111011111111011000111111111111011111111101110111111011111011a111001111111111110010011111111011110111111111111011111112111P1121122102222112122
10111P1011110111111111111101111101110010100111111110101111111111111111111111011a1101111111011110101011111111101111111111111010111110110122102P112222110112102110
01111P1111111101111111111111011011111111111101111111111110101111011111011111011a1101111111010111110111001111111101111010100111101101111100211P112212122111112211
11111P0101110111111111110111110011011111111011111011110111011111101111110110110a01101111111101110100101011111111111111101111111111001111111112P02100122122122112
011111P111011111000111111010111111111111100011111111101101111101001110111111111a110011110111111111111111011011101111101111011111111110111222012P1211121111222021
111111P111111111101111110111111110111011111111000101111111111111110111101101111a1111011011011110111010101011111111111101111111111111101110120012P221210102221110
111101P111111110111111111111111111101001111111001111110111111111111001111111111a1111111111111001111110011100011101111101111111111011101121012022P221211001221212
101110P111111010110111011011101001111100111111111101011110111111011111110111100a1111111111111110111111111001100111111111101111111111111101121221P201011121001212
111111P111101111101011111011111011111001110010011111110111101000111111111111111a1011111111111011111101111100011111111000111111111111111110000211P101122210120101
110111P101110111111111111111011010110011111011011110111011110110110011111110111a1011111101110110000111111110111010110011111111111111111111222022P121212222011222
111110P011100111110011111111110001111011111111111111111111111111001111110011011a111111011110001011110111111100111111110111111110111111110112122P2012221021112221
11100P1111111111110011110010111111001101111010101111011111111101111010011111011a100111111111111011010111111111111101010111112222110211122222220P1222020222012221
11001P1011001011111111111110111111110111001111001011111111011111111010101111111a11111010111111011111111011111100011101010111020002201112220011221112222121220221
11111P1111101111111111111011101111011111011110111100011111111111011111011111111a10110111101111010111111111111110111111101121221222211201220022201212222222001212
11110P1110111110111111111001111111101011111011110111111111010101011111111010100a11101101111110111101111111111111111110010122111002212120001201111001210221111111
11011P1111111111111111111111111111111101010111111111001111111111111111210222201b02200102122111121211110010110111111aaaaaaaaaaaabaaaaaabaaaababbaaaaabaaabaaaaaaa
1111P11111110110101111010101110101111111101110111111111110111111111102112112101a20121200121001121122110011010011111a01111021122112211102010222211200210211111111
1110P11011100101111101100001111111111111111111111111111111011111011110101011122b21212202101121121122101111111111111a11111112022112122112221120121200000210111010
1011P11111110111111111110111011111111101111110111111011110111100111110102122212a10210012212221022221121122202222012a11111100102012111011002121221211211120111111
1111P11011011110111101111011111111011111111110111011111111111011110111010212222a22110222221201220210210221002122210a11111111121011112221011001112222122001111111
1001P10101111111011100011111111110101111111111111111111101110111100110222211021b12022222002201222220222111122202111a11101121111211221010021110100021112121011111
1111P01111111111111111111011011111111111111110111111111111111111111110120221122a02122222221220122212020122022112120a11111122102011122120001121111210122221010010
1101P10111100011101101111111011111101110101111111111101110101110111112210011101b11011120111120222212212222022200100a01111111202201102011102222112022020211111010
0110P10111111111111111101111101111110111101111011011111111011111111112101111200a02111221022102220210020121221212212a11111101100221212120221021112111111021111011
1110P11100111111111101111111010111111101110111111111111111101001111011101202210b11102222110221012111221022221101011a11101010221122100212221221102212212211111101
011P101101111111011111111110111111111110111111101111111111110011011111022211101a10212222222222221222222212122222102a11111012111222112111111111201112222001111111
11P1111011011111111111011111111101010101110111100111010110010110101012200122201b20122011212202222022112221212211112a10111021210111201110112102000111212101111111
11P1011100111011011111111111111110111111101100110111001010101111101110002100201b11112010222220221222222210012111202a11111121112102011121112021222022110221111011
11P0011110011111011111111011111011000110111111110011111111110001111110122102211b22222221202222121122121112221221222a11111011221212102122212220121020120121011111
10P0111111111101100011111111111111110111101111111101111111111011110110222220222a11122202211100022222202012202222020b00110212220221221020222220221211200211111111
01P1111111011111011111111111111110111111110111110110110101011110010112111121222a12112220202022222220122202222212202b01121221210122212121221210210120112211111111
01P1101010111110111110111010110101111111111100111101111101101011101112221102222a02122120220212102222211222222202222b21121102222120120210210221011111121010011001
1111001111111000101101111111111111111111111111011011111110110011101112220221011a11211002102222122012220220220202122b00012120022222220212221211021122112221100110
0111111111111011101111111011111101111110111111111101111111101111001111100211122a22210112222000120212022012002212002a20221121112122221120200021212212001200111111
1111111111111111011111110111111011010010011101100111111011100011101011121022101a11110002222111220022210212222122112b11111212222220212112210221121112000101111110
1111011111111101001111011011101111100111111111110111101111000110101011101200200b12022102011122100122022222201202222a11212121200022211222120111121121012121101011
0011111010111111100111110111111111111110011101101111111110110110111111112010120b00212111212202022012212200220012122b12001122112200211101222102012201111111111111
0111111111111100011111111111011111010110111111111110010111111111110111121121210b11222210012110102220202110022202222b12221102122122211212212121022110221010111101
1011011111101101111100111111111111001111011110100111111111101111110012102100221a12210122220112200222122222021102222b11022122222122221121102111012120222111110101
1111101011011111101010111111001000111111111111011101111111111110121122012222212a22000222222122221222202222210222220a02010112222220020202211101110112022120101111
1111111111011001111011110111011011111111111111100101000111111111220012222220022b22222202102222221122221202122220222a20102122222222222112201200210011122011111111
1110111111010111111110101011010111011110101101111101011111111111222212002112201a22222220022222022202222102222222122b00112001222022012222001002112221121220101111
1000111111100111011111111111001110111111110011111111111111100111001122002112202b22122220222121020212221022222112222a21112202121211110111110101111111111111111101
1111111111111110111111111001101110111010110111111101111111111112121000000222201b11222002222220022121211221112222222b11111202011112011111111111111001111010101100
0111111111111111110101011111111101011111111100111011111011111112221222221112202b12012210222220112222112122222122002a02220100221222001111010110111111101101111110
1110101111001100111011011011111101111101111111111011010011111110212021222212122a02110222112220220222112102222220012b11201122212212011111111001111111111111001001
1010111110111101111111111110010101111111111111111001111011111112010011102121112a11012021122221121121002222010220222b22222211110211111110101111110110010100111111
0111111101111111111111100001111100111111111101111111011111111010112011202010122a00202220221221110222102011220202122b00201211012112110111010111111111111101101111
0011111011011111111111111110111111111111111110111111111110110101111212102202220b21212200202122212001222202221222222b12101221202212211011111111111111010110111111
1110101011111110011101011110111101101100101111111111111111110101222102212121122b01122100121202111111110011220122212a01212210221210111111111111011101001111111100
0101001111011101101110111111111111101101111111111111111101111112220201101210122a22122112211221111111121020111012221a21011021202111111111111111011101010111111011
0111101101111111110101011011110101110101111111111111011111111112222111200012211a01121112021211111110122212222020201b21211210110111210110111111111111011111000011
1111110100110111011011111111101111111110111101111111111111111111121002211101101a21110111112012110111212110222202220b21021112211122011110111111111111101111010111
0111111111111111111110110111110011111111111101100101101111110110111122222111101b02122201211122111111221222221211122a12200021101211001100101011111111111111111111
0111100111111000101011111101110101111111111101111111111110111112122112122101200b11022122021222111111211122111100211a11121202111212111110111001111111100001110111
0111100111110111111010101111011111111111111110101111001111110111202112100121211b12102212122121101111221002121122112a21202011110222211111111100111111101011111111
0111111111101011111101101110110011111101011111111111101111101111221111011121211b21122012212122101111221100110112121a02121112211020211110101111111111111110111101
1111111010111111011111111111000111111110111111111111111111111112122111212222221b21121220212222111011001121000112112a12112112101200201111111111111110111111110111
1111111111111111111111011101101111001101011111111111110111111111111111002012211b12011102001202111111122112201211112a02221212222201111111111111110111111111101101
1010111111111110110111011101111111111111010111011101111110111102211201210012220a10112212121220111111212122112100120b11100012102120111111111011001111101111111111
1110111110111111111010111101111111111111011011110110111111101011112111022211101a11002010212212111111111111111101111a11111111111101111011000011001111011011101111
1111111111011111111110111111111111111111111111110010101111111111122111120021111b10020221220202110111101111111011101a11011110111110111111111100011111111100110111
1111110111001101111111101111111111111101111111110011111111111111112211121100021b01201122111222111110111111001111111a10111111111111111110111110111010001111111111
1011111111110110111000111111111111111101111110111111101110111112101211221210212a21022211111102011111111010111111100a11111101111011011011111111011010111111111011
1111101011111101111101101111111111011101011111101010001011110110220222212220110a12222120221112101011111110111111111a11110111111011111111011110010101011011010111
1101010111010111111111011111111111111111111101101011101111110111122112022110101b11211122002120111101111011111111110a11111011111111111111101111111101101111111111
1010110011111111110101110101111111011010111011110111011001111112110222201120112b22012222221002111111101111111111010a10111111111111111111011110111111111110111110
1011111111110111111110110011010101111111111111111111111111010101222112201210211b20221122002202111111011001111011110a01110110111011111111111011101001011111111111
1011111111010111111111111111101100011101111110001101101111111100111211121210001a11201100111220101111111110111101111a11111101100111111110110111101111111100001111
0111100011101111111110110111111110101110111111111111101111111111012110200121121b21012222111110111101010111110111101a11111011111101101111111111111011111111111111
1110111111111111111101011111011001111011111110111101110111111111111011111111011a10010111111111111111111111101111111a01111110111111011111110101111110011111001101
0111011111111010101100000101111001110110101000111111111111001110111011111011011a11111101111011111111111111111100101a11111110110111111111111110111111010101111111
1111111110110111001111101111011101111100111111111111011111111111111111110011101a01111010111001111110111010110111111a10111011111111111111111101111011101110101101
1011111101111101110011110001110111111101111111011101111110111101111110010110111a11011111111111011100011011011110011a11111111000111011110111110110111111010111110
1111111010111011101111111111111001000111111111111011110111111101111011101001110a11101111111111110010111110110111011a11111001110011111011111100011011101111101010
1111100001011111111101011111101111100111011011111110111110111111111110010111100a11011111111101011111011011111110101a11111111101111111101111111111111001011011110
