11 26
144 79
78 98
151 42
145 5
137 70
84 74
99 77
115 88
85 8

111111111011111111011011110111101010111011111111111111110111a011111101221b101122222201111222112222112110011111101a0111111111111111221221210001122211211121022020
110111111110111101011001111110110111111011101001011101111111a111110000222a212221000112212201122111111111111101101a1111111111111110221111212211122012220101221102
111111111011100111101110101111111101010111111111110110111111a111111111122a122222111221121122002211120111111111111a1110111111111101112221221212022122221110222111
011111111111111111111100011110101110101111110111111110110101a100111100202a211202222012121211200222111111111011111a1111111101111010200221112111111220022221122211
101111111111111100110111111111111110111111001111011011111111a111110111102b010111111211222102022211121111110111111a1100111111110111222011212111212101222221222222
011101011111011101011100101111111001110111001110101011101111a011111101110a110220110122111221122010212111111011111a1111101110110111101200020112222101111202110211
011010111100001101011111011111110111111011100111111100101100a011110111121b011211112120211111212101022111101111111a1011101001110100022122210212121112122212122120
001110110111111110111111110111111101001011111111101110111111a111110011212b121201201222202201112020122110111011111a1111111011111011210021202212111122011220122112
111111111111101111101000111011111010011111111111111111110101a110111110222a212222111012212211002210222111111111111a1011111111111110222112121211021022112012212102
101110111110101001111111111111111111011111111110111111111000a011111001211b212200002101202211111102121111111111101a0111011111111111211221211121201021012211121200
101101011010011111111010111110111111111111110111111111110011a011111111121a202120121120201020211221112111110011111a1111111101110101222012122220111120122100021111
110110111010110111010111100111111111111111011101111011011111a110111111121a210010212012101021221112101111111101111a1111111111101111002012212121212121111121201211
111101101101111111111111100110111110101101111110101111111100a111101001220a021200110211212210212011111001001111111a1110111111111010220022112112220122112122122222
011111111011111011111011111011001111111101111110111011011111a011110111101a222102122112202211112112111111101011111a1101011110011111210122221210110211122111212011
111111111011111111111110101111111011111101111111111111101001a100111110220b210002211012212212210021220101111011111a0111111111011101111122111021122012112001212110
101111111011111111111111111111111111110111111110100111111001a111011111021b221211101112111022122022022110111110110a0111111111111111212122011211122221011122101111
101101111111100111111111111110111011101111011111111011111101a111111111021b222101022211002222220121122101100011011a1101011111101110120012122112102012222122012022
111111101110111011110111011111111110101111111011011100011011a011111111212a212121121221211220221112211110111011101a1111010110111010121012210111121010222111112102
111111110011101110111111111111111111111111110111101101110101a111111111112b211222201121022212021211120111111011111a1001011011111101211221110202102122202022202102
101111011011010110101111111111001011111111110110011101111111a001100101221a202112012222111220222101001011111111011a1111111111101100121121011222212122211111222220
111101111110011010010111100111110111111111110111111111111111a111111101012b122001212222212221221210222011101111111a1111110111111110201221102201212211112202221210
101111101111010011111111011111101111111111101011111010111001a111110011212b110212211010010212200202222101101111111a1111111111111111122200221221122121201212221221
111111111101111101110010111110111111110101111111001011111111a011111111202b202101111111001210202012221111110111111a1111111111111010201221221111222120211202100110
111111111011111010111110110110011101111110111111111110011011a011111111110b101221012210121001210102221111111111111a1111111111111111110222210012222011012012222001
111111111111110111111101011110111010111100111111110101101110a101111110112b210202102212200112120002210100101111111a1011111111111111122221211221121001211111121111
011111101110010001011110011111011001111011111111101111101000a101111001222a022221110122022221110000011111111011110a1111110111111111011121010012101122010012121210
111111111111011101111111101100110011111111110111111011110110a110011111121a221122112102212110100120111111111111111a1111111111111111121001220102112122111102011212
111111001011111111110110111101001101111111100100111010111111a101111111110b221121111210212110222111011111111111110a1110111111111011221012220212222102120102212211
111111110111111111011111110111111111111111110111111111010111a111101111221b021122222022212120101121120111011001011a1111111111011001012112220121022200222220012020
111110100101111111111111011111010111111111111111110111011111a011111101122b122101111022120122222100111111111111111a1101111111111111111022012022210212222220212212
111111111111111111111100111111111011001110111101111011111111a011101111112b102210112211000101212122222011111110111a1011111111111111112202220220222222220121212220
111111111111101111011011111111111110111111111110111101101111a011111111010a111111111111001111110001111111001111111a1111110101111110110110212221200221212110122111
011111100111111110101111011110111111101111011111110111111111a011011011111a010111100001011111111111010110111011011a1101101101111101110011200001220121111112112122
111111011110111011111111111111111111011000111111011111101011a101111111111a110111101110011001111011111111111110011a1111111100001001101001100211201100121122001012
111111110101011111011111011111011011000111111001011110111101a111111101111a111110010011111111010111111111111111111a0111101111111011110110101102211220100022222211
111001110111111110111111101110111100111101011111111011111101a111110110111a111100111111011111110110001111001111011a1111001111101100011111012220222120120110121111
101110101111111110101011111111110111110111111111111111011110a111011011111a111111101011011101111111011100111111111a1001101111110111011111212201120012112112122121
011111011110111110111111110011111110011111111111111101111111a111111111111a111111010111111101101110100101111111001a1111011010111011111111212221021111200202222222
111011110111011101110011011111111011011011001101011111100110a101111011101a101011100111001111111110010110111111111a1101110110111111100111220201112111202122100022
010011111111111111011101110110110011111111111011111011101110a111101111100a111111011111110110001111111111111010111a1111001100111011011111010122220121120122221102
010011101111111011110110111011010111111101111111110111101111a011101001111aaaaaaaaaaaaaaaaaaaaaaaaaaaaaaaaaaaaaaaaa1111111111111011111101120121011122020002210011
100111111101111111111011111111110111110111111011111111010111a010111110111111111111111011111111111110111111111111110010100111011111110111111112221210111111112222
111111111011111010110111101110111010011111111111111101111011a100101111101111111111111101111110111110111111101111111111110101101111111111110010210111121212122212
101011111001111111001011111111111011111111011111100001111111a101111101111111111101111111111011111111111101110011011111011111111110111111212222220221121111021211
111111101110111101111010011011111011101111011101110111111111a111111111101111111100010101111111110101101110100001111101111011110111110110001122111020122112211021
110110110111111111111101111110111111111001111111110101111110a111011001111111111011111011111111111011110111111111111101111110011011101111120012022220211121111222
111111111111101111111111110111111111111001101100111111010111a111111110111111111011101110111110010111100110101111111110111110110111111100211111012201120011212220
110111111110110111111111111110110110110111111111111011010101a111011111111110111101001111111110110110010100111111111111111111110111101111022121202221112211011021
111111111111111011111111111111111101111111111111001100111011a111111101101100011100111001111111011100101111101100101111111001111111111011120121101111212211112110
011101111111111111110111101111011111111110110110111111111111a111111001111001111110111101110110101111110111111111111101111100101111111101120021011112202122221101
111101110001111111010100111110111111011011111111011111110110a110110111111111101110111111110111011111101111111110110111001111101111111011112120101021111212010202
011111111011111111111100111111111111111001101010111111111111a111111110110101110111110101111111111111111111110111011010111111100110111111112221011122112102112112
111011011010111011111111100111101110010100111101111111111111a011111111110011110111111011110111111011111011101111111011110011001110111101120120222122221221221221
111111100110111101011010111111111101111011110111110111111010a111111011111111110110111111110110110110111110110100011001000111111110111101122121121120222111121101
100111110111011101111111111111111110111111011111110111011101a111001111111111111101101010110111101011100111010111101111111111111110111111121211122121120120222012
110110111111101101111101110111011111101010011101111111111001a101110111011110011011111110111011111101111011100111111111111111112220112011100012021202122212020120
111110111111011101111110111101011111111101111110111111100111a101111111110111111101100101011111110110111111101111001111010122201110212210102020122202111101221211
011011110101011111010111111111010111011011111111110111110111a111110111111111110011011100111110111111111111111111111111111122212202111200112222201210222201122112
111010111101100101110011011111111111100111101111110111001111a111011101011111101101111111101111111111111011111111111100101002111222122111111002112111221111100110
101111111101111110111111101111111110010111111111111111111111a101111111111102012211112012121212221222111010011111011011011121010212200202012111021122211121010111
aaaaaaaaaaaaaaaaaaaaaaaaaaaaaaaaaaaaaaaaaaaaaaaaaaaaaaaaaaaaa111011102010211211202101210220211112110011110011110110111111120211012222211211212022222112211011110
1101111101110111010111111111111110111101101111011110111111101011011110222001220221111221221220110121111110110111111011110120222111221211112122112211222111111111
0111001101101111111111111111100111111111111111011111011101110111111112021122121202012022222201210012111210122112200101011121102112022220222110221110202021110111
1011110101101101111101111111100110101111101001011101001111111111111111012111111110122222020202122022110222112220210110111102211201112200201022211201010211011111
1111111011111111111011111111111011011111111111001101111111111101111002012212222212112121222201120122120222111201121111011110002122222222121212120111211111101111
1011111111111111111110111111111111110011111111011011111110110111101011012220101212212022122212222022122221222202121111110001121201211222121221200222212221101100
1111110111111111110101111111111111111011110111111111111111101111111011020022200222011220202112212122202011222202220111111122221211122101002022111212222211110111
1111110101010111011111110111111111110111110111111111111011111111011110010122110201201220122022102220210120112122221110100112221020222010212210122101011221101111
1011110111111010111111111111110011110111110110111111110110111111111111022121221122102122220121212221212112122210110111101110121101101012111222021222022220101111
1101111111101111111011011111111011110011110010101011101001101011011111122020222112121222022122222020200012110022222111111121101222211112221111110102001211111111
1111111011101111111011101111111111001111110111111011101010101111111111101011011210222222202221222222120212220110222111110112022201100110021121102111202111111111
1101111111111010011111101111110011100011011111111010110111111111101112210122210210112020022022222112210212010022211111011122111112001111111212021110212120011011
0011011111111101010111101101001111111111111110010111111111101101101110201110021212020021212221220222210112221121111111101121220220010121122112222121120211111111
1101111111011101111111101000101001111000111110011011111011101011111011101220021112220201221222022222121210212210211112011212220222211110222111020210211121101111
0101101110011011110110111010111011111111111111111111001111111111110111111121121222222202221202121201111210211122222001012221222122201220220221120102102111001111
0111011111101111110110111111011111111101111111110111111111011111010110211122011020122010220212201222202210222220221120222212222222212122112221112022201201101011
1111111111111011111110111111111111111111101111111011100111111101110111110220212221102222212001201200222212221210222211022202212212002012120022012022112011011101
1101111101011111110110111011110100111111110011111111111110111101110111110112101212212220012122022202212222221202021021122210222222212212022202222101001221101111
0111111111111011111111111110111010111111011111111011101111111111111111122111022001112022222212022220022101222211211011010100202212222112012001212211021121111011
1111111111011110011111110111111110100111110011111010111111111101010110111101210201122212212220021120122222011222012000221122022002221202221220222220221011111011
1111111110100110110111111011111111100111101111101010101111111100101101022210221201000022122201022122212201220210202122022100021201012120121010222122001101110111
1011111011111101111010001010001111111111101111101111011111111111111110110220221110202102122020212122122122202221222221222222111222211202211222222012222121111011
1111111110011110111111111111110111110011101101111111111111111111111112202211221122012212221001202210202022211122101120221222022222212020212120211101122221110101
1111101111011111111111111111011111001101010111111111111111110010102111022022221222222201221222122222100122222212210212121212222112010101211110122101121121110111
1110111111110111110111100101110111111111011111111111111011101111112222122010212122012202222222022222221022122120021021201022122202212111212002221111100221110101
1111111111011111010111011111011101111111111110111011111111111112121211202212022221022222222202022212122221122222220110201010222221211222212110200121120121111011
1111101111111101111110111111111101011111111111111101111011101011022121222220220122220202222021221122220112022222222221212201212111000101111111011111011111011110
aaaaaaaaaaaaaaaaaaaaaaaaaaaaaaaaaaaaaaaaaaaaaaaaaaaaaaaaaaaaaaaabbabbbbbbbbbbbabbbbbbbabbbbbbbbbabbbabbabbbbbbbbbababaabbababbbabaaaaaaaaaaaaaaaaaaaaaaaaaaaaaaa
1001010111111110110101111100111011101101101111111111111111111111021111120221100212122021202002222221020220202222120211112211022122111110111110110101110011101111
1111111111011001111111111110111011110000110101100111111110011012212202220212222222220220202222221022012202222002022121001121121221001100111101111111111110101111
1100000111110111111101111111111111011111111111110111111110110111211101122202011020021222222212021121222212022202222021122111121201211100111001111011111111111111
1010110010001110111111111110111111011010010111011011111001111101122210122100112201120121222202211121222222011120102122221211211022211001101111110110011100010111
1111111111101111111011011111011110111111110011110101111001011111102221112211101222121222222222002212210022121002212120111121110121210111011110011110010111111101
101111111111110101111100100010100101111101011011000111111011010222212021002120111211012200211110011aabbaabaaaaaaaabbaabbbbbabbbabaaaaaaaaaaaaaaaaaaaaaaaaaaaaaaa
111011111010111011011010110111111110111111101011101111011111111121120102110211121002212111021011001a112120121011221122212002211212111100111010101100010111111011
101110101111011111110111101111011111001101110100011111011111111010222201122202111110222002112111111a100120212112211221211202201110111111011111101111111111111101
111111111110011111011111101101111111111111111011101111110011010121121211201122020122210012111011011a020111111112112210001201222020201111110110110110101101100101
111111111111110111111111101111111111111010010111111101111011111211020111021201202111011101111111111a221201121021220112221121112121211110001111111111111111101111
111111111111101011101111011101011111110111111111101111111110111122221102001112121011221221122100111a222210122021202022111110212212111111100110111111101111111111
111111101111100110010111111111110010111111001101010101101111111222122102101011120211121110121211110a211101222112111011111011110011000111011111111111111111111010
111111101011011111011100110110111110011011111111110101111111111000021010201112201221021212202201101a220012212221202010212101111012111111111111111011111111111011
111010110111011011111110011001111111111111011111111010011111011220212112012111020120122201021211110a122112111222010212110002110212110111111011110111111110001111
101111110111111111111111110110111101111101110011111101111110001112222002102011202211202022221001111a221211020202212201111211002221011110100101111110011111010011
101111111011111111111111111111100101111110111110011011011111111110022021022111222100210210201111111a010220101111122211222201112111011011011010011111111011111111
111110011111110111111011111111001111111111111001101110111001111221122020210022111221211201111210011a110011111111111111111011101110111101111111100110101111111111
111111101111110011111111011110111111100011101011101111111110111011121102000220122121111101021111111a111111111111011111011001111111111111111110101111111111001110
111111010101111111111110010101001010101110101111111110101111111102112110111221211012112212112110111a111111101111000011111110111001111100111110010111110111011111
101001111110011111110111111111011111111111111011111100111111111202122221101120111001002121122111110a111111110111111011110111100101101001111111111111111111010011
110101001011111111110111101011111111111011110101111111101111001211221121101222212221211202001201111a110111011111110111011101100111111111110111101111111111111011
110111111111111111111111110111011111111111111111111011111111101221221022010011112111121221021210001a011011101111111011110111111111011111001111111111001011101111
011101111111111111111111100111111011101111111110101101011110111210220111202121122221121120221111101a111100111111111111111111111111101110111011111110111111101111
001100110110111111111111011111001011111001111110111100101100111110102222201200111222211012010110111a111110111101111101111111010111111011111111110111101111111111
111111111111101011101101100111111111011101111011111111111111111202002020222210211221021211012211111a101111001111011111111101001110111111101111011111001011111111
aaaaaaaaaaaaaaaaaaaaaaaaaaaaaaaaaaaaaaaaaaaaaaaaaaaaaaaaaaaaaaabaabbbbbbaaabaaaabbaabbabbabaaaaaaaaa011011110111110010111111111111011111001111111111101111101001
1111110111111111011111110111011111011111111110101111111111111111111111111111110111110111111111111001111101111101111111111111110011111011011101111111101111010101
1111110111101101111111111111111111111111111011001111111111011001111111111011111110111011111100111110110111101111111111111111111110101111101111010101110011101101
1101110110110111111111111111101110111100111110101111101011101111010111111010111111111101010111111100110111000111001011110101110111011101111111111111101111111111
1111111111111101101110110111101110111111111111111101101101110011111111111111001111101011011111111001111101101111111111110111111111110011110111111010111111111011
0011111011111110111111111110111110011110011111111011111111111011111100110100101111111111111111111011100111111111111111111100111011111111111110111101110011111111
0110111001111100101111111111001111111101110110111011011111111101010111111111111111111011111010111111111011111111100111011100011110110111111111101111111101111111
