85 16
107 109
78 98
151 42
145 5
137 70
84 74
99 77
115 88
85 8

111111a110101101111111111011011111001110111101110111111110111111111010221110212020012211110220110212111111111011111111111111111111212022110112211020220022111210
111111a011111110111111100111111101011111111010111101111011111100111101210220202102112220221102011110111111111101011111011101111111211221121210211221220122120221
111111a010111110111111001111001111100111011011111111111101111111111111221011012122121110221121222012211101111101110101110111011111010222201020111212222122122112
110101a011111101111111111111111111111110111101101011011110011111000111112201212121111221112212221221210111111101110011011111111111201122201011221202202100222122
111111a100111010011111111111101111111111110111101111111010010111101111221211200222220210220022112221211110101111110011111011111001101222222202222102121010212111
111101a110011111111110111111110110111111100111110111111111110110111111011121122122111102110112222111211111111111111111110001111101012011121010221101100020222020
101110a011111011110001111111111111001011100111111111101111111011111100012212121110222012112101101201111100101111111111100110111111211111112112121122122120110012
011111a011111111101110111111111011111110111110110111111111011111111111102212022111200211200111012220101011111111111101111111111011220111011111212201112202011222
110101a011101111111110111111111111111011111111101111111111110111111110020202022121100121212011220120101111111011111111111111111111200121222111211212122112222011
111111a100101111111101111111111111111001110011111111110110011011011111202120221220111022120111210121210011010011011111111111101101112222102222222111122212101201
101100a110111111011001111111111111110111011111101000111011111111011111112221111202122121121202111011211101011111111111011011111111110010001121110101112221201220
101111a111011011111010111111011110011111111111110101101110111111111111112020121112110211112010222210001001011010000111111101101111212022211221220012102022120021
111101a110111011111110111101111111110111110111110001111110111111111010111112211022101221200011201211110111110111111111111111111111112112021121112111211112221112
001111a111111111101111111101111111111110101101011111111011110011110101112102212111212212122222211221210110111101111101101111110111202210220002221112220122022011
110011a111010111101011101111111011101011111011111111111010100101110110122121121000001021112012222022211101111111111111111101001111210211101100020221222102122202
110111a101111011001111111101010101010011110101111111111111011111110110100021111022112220112102212122111111101111111110101111111111001221221211220120120012121100
101110a110111111110011111101111111111110111111110010111110101011111111221112101202222110012020112122110111101011110111011111001101211221002100122101122111210021
110011a101111111111111101010111000111111010111111011101111111111011111122212111012222020122201110112101011101101111011110111101111211222111121211101221221012211
111111a111111011111110111111111111111010000111010111111101101110111101022212221120110120112211021102011111110101011111011111111011012121201211210221122120222221
101110a111111111111111101111110111110111111110111111111111110111101111001112202212212221110112210020110111110111111111100111111001200021211222221201112222022122
011110a1011101011111111111110110101101101111101101011111111111011111011100110022202200aabbaababbababaaaaaaaaaaaaaaaaaaaaaaaaaaaaaaaaaaaaaabbbbaaabaabbaaabbbaaab
111111a0101111110001100010011110011001101010111010111111011111001111102220102010221210b2221121102111211010101010111011111110101100022002122202111221211021200110
111111a0111110111111111011011101111011111111111100111111111110101111112110201111112222b2210222121121111111111111110111011111111111120112211202120212001022210201
110101a1110001011111011011111111111111111011111110110111101111111111112101121002210211a2110011110211211111111101110110111101011101022201202221202211121102112212
110101a0011001111111111011011111011111100011111110111111101111000110012221021010002112a1102102122111010111110111111111001111111100221202121222002100220210220210
111110a1111101101011110111110111111111111111111011111111111011110011010222212211221001a1221110201022100111111111110111010111111111112102201210212002112210221222
111110a0111100101111111111111100111111011111010111111111000011101101011002110221221112b2212121112221201111011110011111110111011111122101122101111102202111211120
011101a0001111101111111111010011001011110111011011111111001111111101110022022121110121a0211220112211211111111111000101111001111111102211121021122212212222222120
111011a1111111111101110111101111111010011111111110111111111011111111111212200101202211b1102022112010011111110111110111110101011111001222210220021212121222002222
111111a1101111110111011110110111110111111101111111101111111110011110102122111122212121a2122220212021111110110111111011101111111111211110221212222211020210122121
011111a1111111111101101111101101111110101110110111101111111100110101111212112012222012b0222121210022110111101111111101111011100101101112202222122222122202222102
101111a1111100111111111111101111111111010101111111111111111111111111111111111111111111a1111111000011011111111101111001111101110111111111121222112201101202122110
011111a0011101110111011111111111111111111001011111111111111111111111111110111110110111a1101111110100011111111111101111111011010111111011011122112222112012212101
111110a1111111001110111111011111011110111111111111111111110111011101011111111110111111a1101011101111111101001110111111111111001111101111222021202121010211021201
111111a0110011111011101111111011011111111111111111111101111101111111001110011111011101a1110110111111111101111111110011111110110101111011200121112022012111120021
000111a1111111111110111110111101111101110111101011011100111011011101111111011111111111a1010011001001111111111000011111111001100111111110211212111211020022122221
011111a1111101111010111111011111111111111111111101111101111111110011111101111111111110a1111111111110111101111100111111011011111111111101122211210222122212110011
111111a1110111111111111111100111011111111101111111110011111011111110111011011111110111a1111011110111111011111111110011111111001111111110201121122211122202012201
111111a1111101111110101110111101111011110111110001001111011111011111110111111111110111a1011111111110011011110111111111111111111101101101200102011201221212102220
111110a1111111111101011001001111001001111111111111111111101111111011001111111111111111a0110111111111111111111111111111011101111111101111212211212211211101121200
111111aaaaaaaaaaaaaaaaaaaaaaaaaaaaaaaaaaaaaaaaaaaaaaaaaaaaaaaaaaaaaaaaaaaaaaaaaaaaaaaaa1111111111111111111111111101010001111110111100111222022022111222210220201
1111111111110101110101111011111111111101111111011111101111011010111010110111110011101110111111011111101001110111110111111101111111001011100221021212221220110111
11110011111111011111111110001111111110110011100111111011111aaaaaaaaaaaaaaaaaaaaaaaaaaaaaaaaaaaaaaaaa111101111111011110110111110011111110021002002122202212112120
11111111101110111011011111000111110111111111111111111101110a110001111111111111101110110011111111111a111111111010111111111111111101111110201212122201120110111201
01111011110111001001111111111111010111111010110111111111110a111011111111011011110101111011111110111a111111111011110111111011111111111011202001122110022001201211
11110111011111111011111011111111011001111111111011111101111a110111111111111111111111111111011101101a110010111111111111111111111110101111121211211102112210122112
10111011110111110101101110110011011111111111111111111111110a111011111101111111001100001111111101101a111110111101111111111111111010111111122102112122211010222011
11110111111111001111111110111111111111111101011111110001111a111111011101111111111011101111111101111a111001111010111111111111111100111111001222012022012101212121
11111111111101111100010011111110101011111111111111110110110a111111111110101111101101101111001111110a111010111011111111011110101011111011122202211222221221211220
11100110111101111111110110101111101111001101111111100101111a101011111111111110111110111111110111111a111011111001111101111111111110111101221210120222212201211222
01111111111101111111011010010111111111101001111111111001111a111011111111001101101111011011111111111a111111101101111011110111111110111110222111011112211111121120
11111010111111111111111011001101111011011111111111001110001a111011111111010111110101111111111111111a100111110111111111110110011011111111220122101221101111202211
11111101111111110111111111111111101111111010111111111011111a111010111111011011111111111010110110111a1101111111110101111aaaaaaaaaaaaaaaaaaaabbbbaaaabbaaaaaaaaabb
01111111111110111100101010111111111111100111111010010111111a101111011111011111110011111111111111111a1111011111110111110a1111011111111111012022212120010202012121
10011111010111111101011011111111101011100010111010111111101a110111111111101110110111111011111111111a1111111111010101111a1111011111111101211222121122011122121221
11111111111010101110110011001011111110100001111110111111101a110110101111101011111111111111010111111a1111101111100011111a1121101001021211220122212021202200212221
11101111111111011011111111101111011110111010111111111111111a111111111001101011111111110011111111111a1111111111111111011a0122211101221222022212222120102101221212
11001110110111011101111011111111110111011111111111101111110a111111100100111110110101111011111100110a1011111111101101110a1121122112201212221202122221121220112121
11010011111111111011111101111110111100111011111111111111110a011111111001110111011110011111111111111a1111111001010111111a1111122101002112111222011002121200111111
01111111101101010101111011111111111100011111110001111111101a111101101121211120200102012101202122212a1001111111101111111a1101202021221122110222011111211111111101
11011111111001001111110011101111111111111011111110111111111a111111011012021022002221111200012212211b1111101111011110001a1100121112121120111222112221222211101011
11011011111101111111111111001110111110110111111100101110101a111111111220121212111022012111210101212a1111110111110101110a1122221222121020121112221220011211011111
01001111111011111111111011101110111111101111011111111111101a100111111012101211201221221201122002220b0021200111112201010a1012121101220100201011202201111001110111
11111110111010111000111010011111111111101111110101110111111a010101011000220121222202222222211222022b2210112122021021111a1120111201121220211202111102221121111000
01111111111111101111010111001111111011110111101100101111111a111110111012101211212012122002222012222a1211221120211001110a1021111200211202111220120120121021000111
01111110111111011101111110110001101111001011101110111111111a111001111020101110210120022002220222222b1211211112121221101a1112212221021112110111201211002121111100
11111100101011110111111110111111111111110111111001011111111a011011111011101212022212210122222212221b1221121111112200011a1111212202012210111222021110111111010111
11111110111011010111101111111111101111001101111110011101110a111001101200012212222111111212222221100b2110111212120110011a1112002212012220211212211212101201111111
11100110111011111011101011110111111110111111111111111011111a110111101221002111212221221200111222220b2200211111210211111a1122120022222222211200220212122100111101
10111110111111011100011111111010111110111011111100111111110a111111010211021111021022112222222012022a1112012110221211111a1122012220022021112111120011011120110110
00110110101111111110111111111001101111111011111111110111011a110111111211201102211212120222122222221b2212210022121110001a1111121022101212211212102222211211101101
11111110111100111011011101111111010011111101101111111111111a100111101122210110222101202222222220220a2110002212222200111a1122100010002111011211122001121120111111
11011111111011110000111111010111001011111101111010110111111a110111111102220221211212000222002222000b2001012110001211010a1111102121020212210112211021011221111011
11011101100011111111101111100111111111011111111011001001011a111110111101101100010212022222202222022b1221202222212221200b0122220122012110101222122212211121110011
11111111111001111100111111111111011101111111111010111111101a110111110112120210101221222222110222222b0222210210211211112b1200102202100110222111201202112101111110
11101111111111111111111011111001111110110001111111111111110a010111111222021122221120122221112220120b2222022222221100210a0122200120110111111020221122221221111111
11111111111101110111011111111111011101111111101111111011111a011111101210012112122110021222210222202a2212212221202222212b1110012122101221110200211211201220101011
11101111111110111111011101111110101110100111110100111110111a011111111210222222001221222112211202210b2202022212122222112b2012002222211010122210110210021011110011
11001101101111111111110111111011010111001001111011111100111a111111111010220121211010101020012022202b2022012220211022101a2022022222100210012111221112211121111110
11111110011011111011110101111001111110101111111111111111111a111101111222111221002111222221202022222a1102010012220222202a2112022222021221121120210221002011111111
11111101110001011101111111010111110111111101111110111111111a110111111200112222212210112022222111120b1220121222022222122a0010022002121221101111222112120100110110
01110111111101111111111011111111011111011111111111001111111a001011111222201202222012212210012221212b1212222202201001012b0202012122220021212211010201110211110111
aaaaaaaaaaaaaaaaaaaaaaaaaaaaaaaaaaaaaaaaaaaaaaaaaaaaaaaaaaaa110100011222110212121020102222122110222b1222210012201222122a0102220220121011110201012202102221011110
011110110111111111100111111111011111110110111111111101111101111112112111122212222102222202222012210b2010202220222202212a2122220222222112211100101201211121011011
111010111101111110110111111110111100011111111111001110101111110212220122120212202010221120022022221b2222122221220201111a1000021020111020222121212122100111111110
111111111110100111001111001111111111111001101111001110111011111222222222201212220002212201211201202b2112222120022020110b1212222211222010211111212212202221100111
101111111111001111011111101111111000010111111111100111111111101012102002201211202112202222222102221a2222212200220221000a1112210221011111111111101101111111111111
101110111101011111101101111111111111111111111111101110101111110102022121222222122212022022220222222b2212220202211200111b2211011001110011111111111011011111101101
1110101111101111101111111100110101011111aaaaaaaaaaaaaaaaaaaaaaabbabaaabbbbabbbbab222222222202221222b2220221222202202121b1211212210111111111101011111111011111111
1010011111111011111111110110101111101111a101001101101111111101122101122002112222b222122222122221122b0202202222022102022a1112211212011111101011001101011111110110
1111111111111100010101101011101111111101a111111101111111100110121122122220001001b202020222201201012b0111122102222002222b2222112121001111011011111011111101111111
1110111111111111101011101011111101011110a011111101111011111101122112221122222022a211222222021200202b2122002220100201112a0200221102010111101101111111101101111111
1111111111011111111111001111011110110010a111111110101100110110011021122011120201a021112222222010201a2221110012221221121abababbbbbbaaaaaaaaaaaaaaaaaaaaaaaaaaaaaa
1110111111111010111011011110111111111111a011111001110111001111121121110111211212a101221210212110010a001022112110222101200101012212011111111111011111111111111111
1001111011111111111111111111111011110111a111101111111011111011122211101011022012b102220010111210111a012022111120010121221022110022200111110110001100111111011001
0111011111111011110111111011100111101101a010011011110111011111122111210120212012b012122112101211111a121222112202221020110212002221211100111111111110111110111011
1011111001111111110111111111111111110111a111111111001111101011121220002111210222b210112121201011111a120122022111112201022002112222211111111111100110111111111111
1011101111111110101011111000111110111111a111111000101111100110112120200211102221a111112100222211111a120222112021111210222112221202211110101111111111111110111110
1111111111110011011101110111111110111111a111001110111010100111112122110020121110b111012212111211111a122220201110012122121222010012011111101111111111111111110101
1111111111001011101111110100011110011011a111011101010110011111122212101202000020a201012210022210111a111211011001210212222112111021011111111111111111010011111111
1111111111011111010111111111110011110101a111011111111011111101112101002101100221b220102101122211111a121122221101222121201022122212210011001111101111111111111111
0111111110010011100111110011111111111111a111111011101111010110121011011222020212b111112211122211111a122110020222211222120221221221211111011011110111111011111010
1111111100111001111111100000111111101111a111111111101111001111102211102121211021b210121210021211111abaabbaaabbaaaaababbbaabbaabbaabaaaaaaaaaaaaaaaaaaaaaaaaaaaaa
1110111111111101111110111101111111110101a111011011001110110111110202220211112121a1102011210111111011200021111220121212002201222122211110111111111111111011101110
1110111011111011110111111111111011111111a111111111110110011111121202101112121211b1021002201120011111011111110011111111110111111111111010111111111101111111110111
1001111101111000011010111011111111111111a111011011111111110111122201122201021111b2221212212011011110101111110110111111111101111010111111010011111010111011111111
0011111111110111111111011111111111101111a101011111011101110110112221021221211222a2212122202111101101111110000111111101111110101111111111011011110110111111111111
1111111111111111101111110111110111011011a111111111110100001111120202111210211112b0112022211120101111111111111111011101111001011111111011111111110011101111101111
aaaaaaaaaaaaaaaaaaaaaaaaaaaaaaaaaaaaaaaaa111011111101111011011122012012112112010a1120221211102110111111011011111111111011111110010111010111011101111111111111111
11111011111100111111110101110110111101101111110111110111111111110112111111021001b1212221121210111111111111111111111101111111011100011101110111110001111110011011
00011011111101111011111011001111110101111111111111111111111111020012022112201102a1102221011222101111110110011111111001101111101111111111111011111011011111011111
11111110111111111111111101111110101111001111111110111111110111111011021102220021b2022121221212111111110111111011101111011101111100111100101111011110111111111011
01111111111101100111101111011111011011111001110101111110111101110001111201121212b1121202122222111111110111101111111111111011111011111110000101111111001111111111
11111001110101110111111111101111111111111111101111111111111011122111212212110202a2110202021200110110110111111101111111111111111110011101011011111111110111111111
10111111111111111101111111111111110011111110110010101011000101101111101111111111a1011111111111101111111111111111111101111111011111100011111011110011111111110001
11101101011010001111111111110011111110111111011110101111101110111110011011111110a1110101110011101001000111011111110111111111111110111111011111111111111111011111
11101111110111111111110000110010001111111110111111110111001011111110110111111111a1011111111111010111111111111111110111111111111111101111011011111111100001101111
11110110111111101011011111111110110111011111111101111011111111010110011111011111a1111111011111111101011111111111111111111111111111111111111111110111111111111011
11111111111001111011101111011111110110110110111111101110110110110011111111011111a0011111011011101011101111111111111100011011110111101101011111110111011111100011
11011111011011111111011111111111011011111011111111111111101111111111111111011110a1011111111111111111101000111111111101111111101101111111111111111111110101110111
