144 103
35 4
78 98
151 42
145 5
137 70
84 74
99 77
115 88
85 8

0011110110010111111011111010111001011111011111110101011111111111111100101111110202221102212121122112211110011111101111111111111111221020121022211221102121110111
1100011111101110111011111111001110101110010111001011101101111011111111211121111221122002221112021210211111101111110010111101111100120221001122222222212112220001
1110111111101011100011111101111011110101100110101011111111110111111110001002221122102201211121011011201110111111110111110111011111112212211111100211122121221011
aaaaaaaaaaaaaaaaaaaaaaaaaaaaaaaaaaaaaaaaaaaaaaaaaaaaaaaaaaaaaaaaaaaaaaaaabaabaaaabbaaabbbabbabaabbbabaaaaaaaaaaaaaaaaaaaaaaaaaaaaabababaababbbaababaaabbaabaabbb
1011111100111110111111111101111111101001111111101011111111111100111111102001210211021212011021112112111101101111111111111001110111111222020211121021121101022111
1111100101010010101111111111011111001110101011111110101110111111011110110122212211210010012012202212211101111011110100001011101011220222002220212112221201100121
1111111000111111010011000111010010111101111101111111110010111110101001011220000021202001211222122122111111110111110111111001101111101001201222102212211122212021
1010110111010111110101111111101110111111110001111011011111101101100100201021022011121120211222022202211111100111111111111110111011001121021011111202212122202210
1111111111111110111011111011001110111111101111111011111000101111111111011110010110012121211222122122111010110001011111111010111110202101220102212220111211211100
1111111111111111110101111111110111111011111110011111111011111111011101211221222120111221211122022110210101011110111111110110111010122021201221112211212101102212
0101111110111001111011010111111011111001111111101111011111111110111011111122012120121011111120102100111111010111111110111101110111022102121121212101121211101222
0111101111111111111111111101111111011011111111111101111101111110111111212212012112120220202122211222211100111011101111111101110010021021112120220110202212202221
1111101010111001011001011110001111100111100111011111111101111110111111221112202111112110010122111111200111101101100111111110011101011110010112021112110111111211
1111111110111110111111101111101000111011101111101111011011111111111111222120122210020212111202122022211101111101111110101111100110121120211222012111121211220211
0111111101111011101111101110111101111011001111111110101111111111111111001122012220220211001111021011111111111010110111110111111011211022102212221111221112222121
1111101011111100111011111111111111111110101111101001111111111101011011111210221221112101122210120122210100111111111011111111111100110002221111102101122210101112
1111011111010110111111111111111101101111111111111111111100111100111111020002111120212112211022022112011111111101110111001111111110010212211221112100210001111102
1100111111101101111111101011111111001011111111011111001101111111111111121120220122101002202120012021000111011111110111110011111111022211222211011211211120022111
1111011111111111111011111111111101110111101011111111111011111101111101122122101212220112111012110121201101011111101111111111111010221210112112122122222122122122
1111111111111111111011111110011110111101111011110110111100111011111111222201021022100102102202121221111111111111111110111111111111110100122221012212100212211120
1111101111111111111101111101110110101111110111101010101100111111111110212212110211122011101220122111011101110011111111101111110110121202122122201111212021212212
1110111111111101111111111101111111110010111110111110111111111111111101021012111120111211111112211220211111111111111110100111111111211112211122212002000201111212
1110111111011100111011111011111110011111111101111111111111011111111101112111211221212122202202201221011111111111111111011110111111100102112202212012012122111222
1111110111110111110111111111111111011111111111011101111111110001111110222110202211021110111222120022100111111111111111101111111111122122120101111101212111221201
1111101111011101111111111111101111111110111110111110101111101101111111222112122010211220011220211102101111100111111111110110111111221012010222011202111201211112
1001011011011110110010110011111101101011110111111101111011011010101111211020211121100221222001210021111101111111011110111101110111122122002021211020020211220212
1111111111110010100111111111111111111111100111110101110111101111111111021022010212221210212011101212201111110111101111011111110111211111022221222222021102010212
1111111111110011110111111110101111111111111111111111111111111011111111021210120022111211110101212111001100011100101011110111111111221220202210200122110120200102
0101111011110011111111110101100111111110010101110100101110101101111111212111121211121011120110101112211110010111011101110101110111011110220022222020222201202212
1111111111101011111111111101111111111111111111111111111111101111110111020222110002222121202021202120101111111011110111100111110111222102011222220222222101221222
1111110011111100111111111111110111110111110111111111111101101111111100111112211000112111211101210122211111111011111111111011100100211021222222122022101212222220
1111111101111101111011010111111110111110111001011001011111111111101111111111010111111111101011111111101110111011111101111000111111101010200112221110122122210121
1111101111101111100110111111101111110111111111011011111111111111110111011011011111001011011111100111100001011110101111111001111111111110002101010222112201102111
1111111100111111011110111100111110110111111111011110011101111010101011010111111111111111111100011101111101111111011111011011010111111111102122221110122111121121
1111101001111110111101111010110111110101110111001111111111010111111011011111111111101011111111111111111100111011011100111111001101111110011121222222001112201022
0111101110011110110111110111110111111111101011010101011101101111111011101110111111111111111111110011111111111101111111111111011101111110210212112211222102020222
1110111111111111011101001110111010111101011110110101111110101111111011111111001111101111111111110111111111111011110111111111101110111111212222111211101101222120
1111101110110011011101111111101011110111111110111111111100111001111010011101111011111111101011111011111101111010111111011110111110011111221222200102222212121111
1101101110011110011101111111111111110010101111011111111111111011111111011101110011111110110111111101111010111111111101111100101111111111101212200102101022121112
1111101111111011111111111011101110100110001111111111111011110101101111111110111011011111111010110100111111111111111011110111111110111001211121021111200111111111
0111011111111111011101100011010111111101110110111011101000111100111110101111111101111110111011100101011111111101111101101010011001110111122212210102102101010111
1111111111110111111001110111111111111111111111111100111111000101101111111111111111111111011111111111110101111111111110011011111011111111202212210201101001012021
1111011001011011111011111111111111101101111110111011010000111111111111101111011001111111111111111011111011111111111011111101011111110111120212102011212211111202
0111111111111111111111101011111111110111011111001001111111110111010001110110111111111101011111111110111010111011110111111111111110111011020221120221110002122122
1111111111111111110111011110101111111111111111101011110111110111101111111111110100111111101010111111111111001111110110011011111111100110121122101020111210021201
1100101111111101111011101110111111000110110111111101111110111111101110111111111110111111101110011110111111111101011111111111111101001111010111101022001220212201
1111111111101111001011110111001111101110001111101111111110111011110111111111010111101111111111111011101110111101111111111111111111111011211202120022122022121211
1011100111111011111011111110111111110111111111111101111111011101010111101111111101111110111010111011111010010101010111111111111111111110110022112222112112222012
1010111111101111111111111111111101110111111011101111111111111110111110111101101111011111111110111111111111111111011011011010010111111010200122021201211020212211
0111110110111011011001111110111011110111111101111111101101111111011110011111011111111101011110011111111011101110101111111111110110011111022211111121211112212221
aaaaaaaaaaaaaaaaaaaaaaaaaaaaaaaaaaaaaaaaaaaaaaaaaaaaaaaaaaaaaaaaaaaaaaaaaaaaaaaaa1111011111111110111111111111111101111111111111111111000121211221111212010212101
11111011101111111111111110111010101001111011101111101101111111101111111111111111a1101011110111111111011111111101001111111111111111111111111221211112121102212111
11101011111101110111101111101111011101111111111011111111011111010101110111111010a1111111111111110011111111111011111111110110101111111110222112212212222112202222
11111011101011111111111110111111111101111100111101111110011111111111110011010110a1101111111101111111111011111110011111001101110111111111022112122121012111211212
11111011111111111111111111100111111101111111111111111010111111101111011110111100a1111011110011111110101111111011011111111111110111001111111112201221111000222220
11011011011111101111111110111111111111010111111111110111011101100111111111101111a1111011010110101110111111101111111111111120102110211222222121200102200222112202
11111111011001001101111111110111111011101110111110111111011011111110011111101001a1111011111111111111111111011101111101011112212100211012221220022202222202212110
11111111111111111011111101110111101011101011111111111111111111111001111111110111a1111011011111101111111111000111100111101111111212102202200221211221212221121122
11100011111111101110111111111111111111101111011111111111111101111101111100111010a0110011100111000111111011111111111011101122222212022211022100111202012221111111
10111101001101111101111111110110111111111100111111101111001101111110111021121111b2202112120112010112111111111011110111110111222101202222121221021112101111111111
11111111111011011011111111111111110011001111110110111111111110111110112210120221a2221221122221212111011101111111111101111101112102100121210220120121122021011101
11111110101111111111111111111111110011110111111001011010111111110101120021111221b2201221112201110102111010011101101011011101102211021112021222202200221011111101
10011111111011111111010111111110111001111111111101111111110011111110101121021001b0102221211220122220101120122202122111111111121112202211111112212222212211101011
11111111101011111111110011011111011111111101110111111110111110111111021110221102a1012222002222222020011222111212212111111100011222101120120202121202211121111011
11111111001101011110111011111111110010011111101111110011101101111111021012202211b2210220222222211220110120222112111110111112111102122210222202210121212201111111
10011101011111111101000111110111101101101011101111111111011111111110120212121111b1100212220022112221021102122111121111110022212121211210221221121012121121111111
11101100111111101111111111111010010101111000111011111111111111011011112210112221b2112220222210222212212211110021112111110110012211112020122120102211111200111101
11110111101111111111110111011110111101111111111111110011111011111011002101110211a0102012221010221000122111211102102111011122001100221201022101102110211101011011
10101011011110111011111111111011110110011111111011101101111100111111112222212122b2212212102212122201120122210111002111101112112112012121102112002120221111111101
10101111111111111111011111110110000111111111111111111011111111111011102222212101b0221200221122222002111122212212120100001112200212201011210211001022001221110111
10110111111111110111110111111111111110111001110110111111111111101111110121112122b1212200010001022220101121120211121111111110112121020211111012021122112011101111
11111111110100011111111101011111011111101101111111001111100100001001102112110121b2222120210222221201110212210221212110101101221211012012210202202222112121111101
10101111111111110111011101011111111111110011111111110110111110110111022121221120a2222021122120022022112101201122112110011012210222102110221122211102220220110111
01011101110110011111101111111111111110111101111110010111011101111011112212121211b1112122112202122222122202222122102002001212011022222002222101202222210121110111
10111111110101111111111111111101001111011111111111111011111111110011110100111221b1210122220212201221122202022020210121122220122220121212101101111220112211111111
11110111110111111111110110111011111010111110111011101111110100100111012022212012b1121222222201222220222120122221122211202122122202212021102112222111121221111111
11110111101111111111001111101111110100111101111101111111111011001111020120012012a1122220112122220220222221221112211102211222222200211222021221211111200211111111
aaaaaaaaaaaaaaaaaaaaa10111111111111111101000101001110111111110101110121211102222b1222202201222222221222220222121212022221212210212212110110212201222202221111100
11011110111111101111a11111010001111111100111011111011101100111111110110112112221a2211122220221222022221222012220020222221202002222201121110111111212111111111100
10101111110111111110a11101111101101111111110111100111011110111110111120212201021abaaabbbbbababbaabbbbbbabbaaabbbbbbaaabbaabbbbbbabababbbaabbababaabaababbaaaaaaa
10111001100101101011a11111011111001111111011101111011111111111111111121202121022bb120122222222221101211222220202121122110122000211011121100112122122012201111101
11111011111111110111a11111101111110010111111101111111111111111111101002212221221ba201120221222222120122022101102221222120222220222211120212112001010112101111101
10011111111101101010a11110110110011111101111101100111111111110111111011122101120aa212202021121120212222220212202202012011102222012022212222120121221121121011110
11111100100111111111a01101111101111111110111111101101111111111102111012121222202ba221202222221022222102222120221021220001102121210022112122122112121201221111111
10101111101111011111a10101111111011011111111010111011101111101021212222122202121bb022202222100222210222222102222220112200222120120012211212012210111201010011111
11111011111111011111a00111111111110110111111101111111111111011111112220220200222bb202002002222121220012210121021221220122222100012212211212210010100212101101111
11111111101111101111a11011111111101111111111011111111001111110122121201222021021ba222221112222212200222102222022220111120210111101110110010011101111111111111011
11011101111110111101a11111111111101111111011001111111110111111121221101222020022ba201220221222122011220221221212222211122112112200211011111111111011111111111111
11111101111111111111a11001111110111111101111101111100111101011112102202222122202bb020122202210022221222122121202200112202121200220201111111010111111111111011111
10111101011111011101a11111111010110111101111011111111111111010111111101220222212ab222122222220202010022211111222212101102102022212211011011111111111111110010100
11111101010101111111a10111111000111001111101110111110011001010101111111222211112aa121122220112010012020200112212222022120022212221011111111011111100111000111111
11111011101001110111a11111011111110110111111011101111001101111112022202011210211bb220222002210221202211022220222211110211111121100011111111111011011001111111100
10111010111111111111a11111111100001111011101111101101101011101122012220210222222bb010212222222202110001212210212202010112021212112210111111110111111011101111101
11101111111111111110a01111111111111111111110011110111100101111112112220211022020ba201211222221111111122012222211212212101222112001010110111111011111111011110111
11101111111101111111a11010110101101101101100111111110111111111112220111211011221ba202022200011111101000221022210111211022201012111110110111111110111101011111111
11111110111010111011a11111111111111011111011110101111111110101110112010121111221ab221022111111011111212221201212211111220212202122101011011101011111101101110111
11011011111111011111a10101110111110110011111111110110011111111120111211211122212ab011202002221101011222020111121211021111102121011201111111111010111111111111011
00111110111101111100a11000011011111111011111110011111111101111122211210111211220aa111002211210111110212020221121122021112201212211210111110111011010011111111111
11101110011111110101a11010011111011101111111101011111011111111120112011022211212bb222111211121111111222002012121121221222222212221101110001111111111011111111110
11111111111001011111a11010111011111111110111011101111111111011112210101112220222ba221120112220110111112120122220121212110112202222210111011110111110111111110111
11111111101111110111a01111011101111011111111111111111101101111120121121222111211ba211001122002111111212211200221012212121210001020200101111100111111111011101110
00111111111111111111a11101110111011101100111100110101100101111122011122022011022aa212101120212101111012120112210211102210210102112211110011111111011111111111111
11101111111111111111a11110111110010101111110111100111111111111110100110102102002ba211121222112111111210221221212212120211020100012211011111111111110101011111110
10101110111100011110a11100110111011111111111111011101111111111100210112022112022ba011010120021110111102111222210212220021212221211200111011100111110101011111111
11111111101110111011a11011111101111111110111111111111111111111111121022022220111bb221221112121011111110101111011111110111111111110100111101100110111111011101111
11111100110110111110a11101111111111111111110111101111111011111121110211110200112ba112221222210111111111101101101101101111101101111111111111111110010001111111111
11111111111101101101a11110110011111111111111111101111101011111100001111102111122ab211211021120110100101011011110111110101111110011111111111101111111101001111011
11010111111001111010a01111111101111101101011111101110111111110121210121112121011ba102111220120110101101111001111010101111111111111011100111011111111111111101010
11111111110110111011a11110111111101110110111110101111111111110112000222221110112ba111222112010101111101010101111110101111111111111111011111111111111011011001101
11111011011111110110a10011100110110100111111111111011101011111112011221001112221bb001220222202111111110001111111111111111110111011101111110111101111101101110111
11011111111110101111a01111101110111111101101111111101110011111011102110201222202ba102122011202011111111111111010101111111111111111111111110010111011101111111101
11011011011110111101a11111111110110011001111111111111110111101102122221211111110bb012120010112101111111011101100111100101110111111111111111011111110111111110011
11011110100111101101a11101110110111011111001111111111111110101120221112102112011ba111221221221010111111111100110111101111101111111101011011111011111000110110111
11101110111011010110a11111111111111111111111110111111101100001011111210111112200bb101120210122010111111111110010111110011110111111011111111111111111110111111111
11111111011111111111a11111111111110111111110111110111111111111101111110101111110aa111111111111101110101011011011101111111111101111111110101100101110111111111111
11001111111111111111a11101111111111101111011111111111101101111011111110111110011aa111011110101111111111011111111011111011011011101110111111111110111111111111111
11111111110110001011a11110001110011111111101011111011111111111111111111111111111aa111111111111110111111110111111111111111011101111100111110111110111101111111011
11101110100111111111aaaaaaaaaaaaaaaaaaaaaaaaaaaaaaaaaaaaaaaaa1100111111111011011aa111111100101111111111110011111010111010111111111101101111011011011101110101111
111111111111110111011111111110011111111110111111001111111110a1111110111101111111aa011110111101010111111011110111001111111101110111111111111111110111111111011000
111111011101111111111111111110111111111111111111011111111111a1011100110101111111aa111011001011001000111111111110111111111111111111110101111011110111111011111111
