66 2
42 101
78 98
151 42
145 5
137 70
84 74
99 77
115 88
85 8

0111110111010011011111010111001101111111a01111011111110111111111011111222211112122120121220121112211210011110001111101111010101101221002121121012120202121111221
0101111111101111111111111101101111101111a11110111011101111111111111111222110112122121122111012021121110101111111001111111111111011110020122211111102012110012121
1101111011010001111110111111111110101111a11111110011111110110101111011111222210020011021112201011011110111110101101011101111110111100212121100210121112210221111
1011011111111100111011111110101011111011a11111101111111011111101101101021122220101222110121211000110111001111011101110111101111011012112222121000121211121022110
1101011110011111111111111101110011111101a10111101101101111111001111111010110102112211011011111011222211111111111011011101111111111110202202122222102112212122121
1101110110111111101111111111011111111111a01110111111111111111011111101120210212212112202212120121120101011111011111111101011111111211121110220220020102200122211
1110011101111110111101111110111111100001a01111111110101111011111111101100011122011010122212210110220111110111011101110011111111011211222022120021110211110112212
1011011110011111111111111111111111111111a11011111110110101110111110111212211112220010011121211121212211111111101110111111111111111121211121211000111012220121111
1111101111111110110111010111110110111011a11111111111111101111101110101021112202111012221211120021011111111111111111110111111111111122211211021001022101212121112
1011111110110111110111111111111110101000a11111111111110011111101111111121002112202121112221001120221111111100111011111111100111111001120121120101211212121121212
0010111011011010111111111111111110111111a01111111111111101101111011110022002222222100221222221220221211101111111110110101011111111012000210111122221001212222221
1111111111101111111111001101111101100111a11111110000011111111101101100121202102212121211211221221112111101111001111111111111110111210222212211122122220202221222
1111111110111011111101111011011111111111a11110111101110111111110011101120120221212102100222112222221211111111011111111100111111011101212121222102211100221112221
1111111110101011111101001111110111111111a10111111111111011111011110111212210122111112101102102221112211111101101111111111111111111221002202111010111222211122001
0101111111111110110111001011110111010111a01100111111111111111110111111122201212012222122112012011112011111011111111111111101101111201202110121112211211122202011
1101111111111111110111111111111111111011a01011101011111011111010111111222212012211101121220101222011011111110110111111011111111111122221122222212221201211112122
0111011110111111011100111110111111111011a01101001111111111110111111111011220100202121001221221212121101101111110110111011110111111111202021211101210221201212211
1011111111111111111111100010111111111111a11100101111111111111010111010221001221022112012111201211212011110111011111111111110111001212222121100000120221212101111
1101011001111111111111111111111111111111a11110101111010101111111101111221121102020121002222102110121111111011111111111111111111101211112122111122120211121121212
1111111111011111111001001101110010011111a01111011111101000100001111001121221111100022211000122012111211111111101111111111111111111111101222120120121101200121121
0111111111100101111111111111111111111011a01110111111111111111111100011021122111210101011110222112101111101111111111111110111111101222012022211121011212022022222
1101111111000000100101100111111011101101a11010111101111111110111111011212120222022201112221122022100211111100110111011111011111111201212112010112110121122200100
aaaaaaaaaaaaaaaaaaaaa1111111011101011110a11111111101111111111111110111220221220210021202220120022122111110100111101110111011111111112011222210210212011122021212
11011111110111100101a1110111111100110111a11011101111011110111100111111100010221121122120210011112121010111011110111111011111111110221220221100112212202222210221
11111110111111110111a1111111111111000011a10001110111111111111101011110221121111121100201210220022122201010111111011111111110101111100111022221220110120121110022
11011101111111011111a0111100010110111111a01111111111100111101111111100100101010002221120001121022000201111101001111110110111010101111111211112112021111012011121
11011101101111001111a0101111101101111101a01111110111111101110001111111211120211212102211112101102020111010111011110100111111111111222011111121202112122112111020
11111110111110110111a1010010110011101111a11110001101111111110111111110012202010211200002001102111212100110111111111111110110111011221112201201222211220212022222
11111110110011111111a1111110111110011011a10101111111111111111011011001010112102122212222201111022211111101110010101101111111111101222122201210221222110222202111
11110101110100111111a1111110110110111111a01011111111111111110111111111201112222020000202201201221001111111111111011111111110111111200011122022210222121212202022
10111111101111011011a1111111011111101011a11101101101111001111111011110122012202211101212221121102210111111110000111111110011011111110121212022222022102121221222
11111111111111100000a0111111111111111111a00101111110010111101100111110001111111101110101111111011111111101111111010111111001101111111111121211012121021122002102
11111110111101110101a0111001111111111101a11110111111110111011101111101011001101111100101111111111111111111011011111100111000101001111101102022111222110221111002
11111101111001111011a1111111111011101101a11111011111111111111111100100111111111110111111111100111101110110111111111101111001111111111011201212221212111211122211
11111111101111111110a1111111111111110110a01111011110111111101100111110110111010000111101011111011111101111011011111111101101111011111111011010112221011010210220
11111111111111111100a1111011111101001011a01001111000001000110111111110111111111101111011111111111111110111111110111111011111101100111011220202202002221202221201
10111111101111101110a1100111111111111111a11011000111011111111111111011111111111110111001111101111110111101110111111111101111111110111111011101212121201012110220
11101011111111111111a0111111111010011111a11111011110110111111111101011110101101111110111011111111101111111101111111101111111101111101111211021120121221122110222
11111101111110111111a1111011001111110111a11111001111111110110101111111111110110101101111011111111111110000111111101000101111110111111110221220211001211221121211
10111111100101101110a1111111111111111111a01101111111111110101111011111101011101111011111111111101111111011111111111111111010111101101010111012211011022221021122
10101111111101101011a1111111111011101101a10110101111111110101111111001111011110111111110111111111111101110111011111011101011101110110111221011210222200211211201
11111111111111101111a1010111111111111111a01111111111001111111101111101111100101111111011101110111011111111111101110111111111111111110111102211211210221022202120
11101111111111111101aaaaaaaaaaaaaaaaaaaaa01111111101111111101101011111111111111111011110111110011110111001111111111111011111111111101111221211011211012220221101
aaaaaaaaaaaaaaaaaaaaaaaaaaaaaaaaaaaaaaaaaaaaaaaaaaaaaaaaaaaaaaaaaaaaaaaaaaaaaaaaaaaaaaaaaaaaaaaaaaaaaaaaaaaaaaaaaaaaaaaaaaaaaaaaaaaaaaaabbbaabbbaaabaababaaaaaba
1011111111111111111011100111111111111101111111111111111011101100011001011000111101111111111011110101111111111110101101110111111111111110212212222212011111100121
1111111111111111111111110111110101001111011111011111111000001111011111101111111110111001111101111101111111111101101100110111011010111100222122112222121120121212
1111111111111111101110011111011111110111111111111110011111011111101111110110001101011111101110110110101111111111111111101111111111110110210121112201122220222010
1111111110101111011111111101101111110011100101101110111110111101011110111111111111101110011111111110011110111111110111111111110011111111021122201101012111100211
1111101111111101101101111111101111100111111000110111101111101111111110101110111001110111011101111111100101111111111111111011110111100111222112200211202222221212
1111110110110011111110111111111011111001111101011111101111111110111011011111111110111011111010110011110111110111111101111101100101111011101202220110211011212222
1001111111111111110111010011111011111111111111011001101111100111111111111110011111110011011111111110101111101110011111111111110111111111220212220011122222112010
1111001111010111111101111110111111101011111110111111011110111110111111111111101110111110011111111111111111000111111101111100110111011111120122021021111110200111
0111100110111111011011111011111110111111101111011111100010011011111101111110111111111111111111111111111111001111010100011111111111111111201111111111220000211022
1011111100101110111101011001011101111111111111110111111111111111110101110100101111110111011111111111111001110111110111101101101011111111112212112112200210221211
1110101101111111111111001111111001111111101101111110111110101110111111110111011011110111111111011011111101111111111111101111111101011011202020110202221011120010
1111111011101110110011111111000111110011111111111111111111111111101111111110101101111001101110101011111111111011111110111112111222212021122222222222220122212220
1111111011100001111110011111111111111111011110011001011111010100110111111111101011110101101110111111011111111111110111111120110101120011012221200222120021122220
1111110111111110011111111111110111101111010101110100111110111111111011111111111111110111110111011011011101110101111011101111122202222112022222022222022222022201
1111001111101001101011111111101111111111101111111111111101011111111111011111010111111100111001111010111111100111011101111111221201110011111221202211111121111111
aaaaaaaaaaaaaaaaaaaaaaaaaaaaaaaaaaaaaaaaa11001011111010111101101110101101001021210122120100012200112110111011111111111111122210110011121012112112221201011111110
1111111111100110101101111010001111011101a11111111111111001111111111002011212102120122202101200122220111110111001011111111122202111111020112211022221112121111000
1010111111111110110111111011111110111111a01110010110101101011110111111120111012220210121122220221121111110111110111110101120222111112011201110211221122201111110
0111101101111011011011111011101111011111a11001111101010111011101111112020212101221120222220212222221011222112222212001011121222212102211211122211112011121101110
1111111101111101100001111011010001111101a10111011001111111111111111112011021022012220102221121222022121101212202110111100112222211121111012120212022102120111110
0111101111011010011111111011011110111111a11001011001111011101111110011212211210011212222220212222102212210211001222101111102122112210222021012102021121021111010
1110111110011111111111111111101111110110a10110011111101111111111111111102221221210121220020222011022202111212211212110111110211021021000211020121220012211111101
1101110101111000111111011110111101100010a11111010101011011111111001112201122112021222122112012211221012122112210120111111021211221222021222100122221112101111101
1111111111111110111011110111111111111111a11110111110111111101101011112121122222100222221222022202222121101022011202111011112212222111212221212020220221211011111
1111001111101111111111110111111111111111a11111111101101110100111011112212201100122112022212210122221112210212111120111111012220201210222000011111220211111111111
1111101110111010111111111111011111110111a11111111011110101011110111112102112110110220222122122222222211122111111120111110121111211110210012112220201112110011111
0111010111111111111011001111111110110111a11111101111111110001111011102211212112121212220222202020221122212221100221001111121121220020101112002211121220201111111
1111111101111111111111001111011111111111a00111101111111111111011111112211111222111200211222212222211122121120122022011111122211212222111220222010111112111111101
1111111111110110111111011001111111111111a11111111111101111110001111112112122111221012222120001122201212002110011100111111102211202222010011122102112121211011111
1111011111011111111111111111111011110111a11111100111111101101111111111220201021022111202222112120022211022222222222222202110212212222212022bbbbbbbbaabaaaaaaaaaa
1111111110111111110101111110101000111111a11111110111010101110111111111120012101222122222221222222122202121222222121011220120212222211211221a20110210120021110111
0111111101011001111111110111011011111111a11110111110100000111111111102101112112211211002202020121222222200022021222121212122221222011002111b11022121022121111111
1111101111111111011110110111111111111111a11111010101011100111111101111212120102212022220120222222210112222022011202221111021212022100111110b12211122000111111111
1101011101101111111111110011011110111111a11111101001111111111111110112122011021111022002202122210220202201212222010211221110001222012102122a20112201212221111111
1111111110101111010011111111111111111111a11101110101101011111111111012212112111010112220202220002222222220012211021121211112022221221221020b20102121201101111011
1111101111111110111111011110110111010100a11111111001011101011111111110121112220020110112220001000120020202201212021202111122102001210202121b12111212221221111111
1111110111001110111110101111111110011111a11110111111111100011110111111122112210211202022102201222122202222222112212212022110212021211001010a21102212112201111100
1101110110011101111111011111111111111101a11000101111111111111111111110212100122111021102222222122222022220211212122121121221222012222200022b00010221202221111110
1011111111101111111111110111111111111111a10111111011111111111001111110012212212212202212212202212222201111010220221201211111122201211212000b10220112211121111111
1111111001011111111111111011100101111111a11111101101111111111112210112222222210212220220222000222202222221201021012211110202022221100121111a11100221122021011011
0101011111111111101111111011111110010011a11111111000011111111111222220222222212202012022202222222222022012212212012220111120202012211202222b00211012121111111110
1111111101111111001001111011110110111111a11111111111111100111102122120210022212202212212221222122102120122221222111220222122111221022220222a22110110012211111111
1111101111111011111111011011111111110011a11111100111101111011111122102022221222220122222202220222220222222222222122222222121101102111011111a01101111111110101100
0101111111110010111101101110111110111110a10011011110111101111112122112102200222202022222202022212122021022221212112221011112121002201111111a11111101111011111111
1111100101111110111111111110111011111111a10111110111110111001011210122112211200202202202222112212020220021122221102011021122011212211101101a11111111011111111111
1111011110111111001101110101111111011101a00111011110110101111101121222020222021222202210222210112221211120210202211022202220122012001111101a01110111101111100001
1011111111111111110111110111011111111001a01111111011010110111101112200111121011201212102222210002202222222211201212100122122222222000111011a11011111011111011011
1111101111101111111010101110110111111110a11110111011111111111111022122201221122011102212202021022112220112211221122120022110122200011111111a01111111110111101001
1111111111111111111111111100111111111111a11101111111110111111012110121120112201101222112120020021011022210122212122221222222111121101110111a11110111111111111011
1111111011111111110110111111111111011111a11010011111111111111111222111220121112010021110221001011111210200120101110022210020120022110110101a01111111111101111111
0110111110111111111111111111111111101101a01101111111111100101111021002201110222221121121100222111101022112010100221222212111122002111111011a11010111111101111110
0101110111111111111111011111110101101111a11110110110001110011011021021222100221121022222120022101101021212011110211202120120111021001110111a11111111110010110110
0111101111101110111110111110111110110111a11001111011101101111012021010021122202120221210012210111111111111122122111001211020121220211111011a10111111111111100111
1111010111111110111110111101101111111111a10111110111110111111111022112210012121110112121222211111111111101211001121110210201120200110010111a11100001010001110101
0101101111100100111111111010110111011101a10111011101110111110111211121122200121211111220222002100011121002022112121012110121111220111010110a11111110100111110011
aaaaaaaaaaaaaaaaaaaaaaaaaaaaaaaaaaaaaaaaa10110111111110111011112210211210101112202111212222120101111222002011211200021222121111101011110101a10111100001101111100
1011110010011001101011110111111111010011101010111101011011011111121111202001111211121221122121111100102202212101122212112110111211011111110a01111110111101111111
1111101111111111111110010011111110111110111111011010111101111011112210202222102202212202111112001011100211012012102111121011221101111011101a00111001011110111111
1111111111111011110111111111111111111111111111111010111111010112222022211020020121221220122122100011122000101201222100212220212112011110011a10111111011111111111
1111111111000111111111111111101011111011100101011110001110111112211210202220110202222220120220111011220212101110122101112010112212110011111a11010101010111100111
1111111101111111011111010101111101111111011101110110111011101011001011222122221121210002102221101111111111111101111111110111011111011111111a11111111101101111111
1111111110101111111110010011111110101101111111100111110111010111111102221221122220111022111211111110011111111111111100111111110100111111111a11110111111010001111
1111001110111101111111111101011010010010111011111111111111111112211212221101211011112112222112101110111111111111111101111111101111101110111a01111111110111111111
0101111101111111101001101011111110111011111111110111011011111111122120000110111222110021120202111111111111111111111111100111111111111011110a11111111111111111111
1110110111011111110001111110001100011110111111101111111110111112210112112111220021201211221211111111111110111011111111110101101110111011111a00011010111101111111
0111111101111111111111011111111111111111110001111110111110111110122211111211021221111120011221111110111011111101111111111111111111111100101a11111111111111111000
0000111111111111111011011111111110111111011111111111111111111111022212020210212222111100212012011101110011111110001111111111111111111111111a11111110111011110011
1111111111111101111111011001001101111110101111100111101111111111221101122222011120021122121121000111111101111011111111101111011100100111110a10111011110110111111
1111111001010011101111101111110111111111011111111101001101011101221222112201221201102220102210111011111111111111110111111011111010101011111a01000111101111001011
111111110110111110011101011011111111011aaaaaaaaaaaaaaaaaaaaaaaaabbaaabbababababaabbaababbbabaaaaaaaaaaaaaaaaaaaaaaaaaaaaaaaaaaaaaaaaaaaaaaaa11111111110111110111
111111111100110111111101010111111110111a111111101111100111110011011111111011111111110111111011101111011101110111011111111110111111111111111011101111011101111111
111110010111111101001111111111110111111a111110101111101111111110101111111111011111010111011111011100101111110101111111111010111101111111111011001111111001111010
011101111011101101111111111111110111011a111111111100111101110110111111111110001111010111011101110110011101111110111111011101101111111111111111110111110111111111
001101111111111001111111011111011111111a011111011111111001111111101111100111111101111111111100110111010111110011111101111111110111111101111111111111111111000011
111111101111111111011111111111011010111a010110011100101010111111111001110111111111110111011111111111010011111111111111111111110110111111111111111110111001001111
011110101101111110111011001111111011111a111111111110111111110111011110011111011001111110111111101111111111111111101111110111011111111011011110111100111111111111
