2 8
143 24
78 98
151 42
145 5
137 70
84 74
99 77
115 88
85 8
1111111110111011101111101111111a1110111111111111110111011111a11a011111111121002201220212101212111122211001100111010111111011111111011221a22022201221111122220212
1110010111011111100011110110111a1111110111011011111100111110a11a111111121212221212112011222211221220111111011101110111111111111001201210b10112211111212011002111
1111111100111111011111010111111a1111111111110100100110110111a11a001100111021022211111212101210011210111101111111110111111110111111120211b22211021212201222021222
1111111111111111101111010001001a1111111111111111111011011111a11a011110112012211121220122122221221100211111100111111110111101001110221110a22022111221122221020122
1011111111101111001111111111101a1111101011011111111011101111a11a111101010121202022001112211021022222111111111111111001111111111111221221a00101211210120212210111
0111011101111111110101101110101a1111111111100101110110111111a11a111111012111220212221111202111111222001111110111111111111100111010012110a11221010112102002010120
0101111111011111111110111111111a1011011110111111101110111111a11a110111201210112221112211222111012010210010110111111111111110101110200112a02212111111210012202211
1011010111100111101000111011110a1011101111011111110111111111a11a111111200221001212120010120211001222211111101100111100111111010111222211b22211020121212122121121
1011111101011111111111111111101a0111111101111110101111101101a01a011111121101021112221111121101211212201111111110111111011011111011112221a12111212110222111011001
0101101101011111101001111111101a1111010110100111011000011111a11a110011222112221122222012221221011022211110111111111110110111110011002010a21121022222021221122201
1111111101101111111111011111011a1101111111011011111011101110a10a111111210100110112111210102011112222110101111011111111111111111110121202a21201122021022120010120
1101101100111111110011111011111a1111111111111111111011111111a11a011111101211221222222211101211222020211111111111101011111110111111222212b22011121110110101211111
1111110111111111010111111111101a1011111010111110110111110111a11a110111001012121221201220021201222211211101011101101111111111111110021112a01101212201002021121210
1101111111101111111101111110111a1111111111111111111111110111a11a111111222102002112221121111112212011211100111111011110110001111111121120a11221120222112121200112
1111111110101111101101101101100a1111111111111001111101100111a11a110110121120112121111010022210221010111011100111001111111111110111222112a21111221222202100212222
1001101111011111111110011110111a1111111101111111011111111111a10a111111212002111101210222022201111222011110010111011111101001111111211120b10121210112212111210200
1110111111111111110111111101011a0100111111010011111101111011a11a100111122001000222121110211211012122111101111000001111111011011101110001a21222111011112012202112
1110111111110111111111111110111a1110111011111111111111111101a11a110111022102200211221202121211101222101011110111111111011111101001221000a22010222221021121111010
1111111101011010111100111110111a1110111111011101111001111011a11a110101101021001201212020212021211202111011111011100011111111111111011021b22202022221120002012120
1101111111101101101111101111111a1110111011011111111001111110a11a011010112021111212200021120212211122111100111101111111110010111111202121a22212221121022010021200
01110001100aaaaaaaaaaaaaaaaaaaaa0101111100111111111011111011a11a111111212220200021212211101202020202110101011011111111111110111111211120a11120211100212201120012
11011110001a101111011111111111111101111111111011111111101011a11a111101121211121012121022201121112102111111111101111111100110111111002112b01121210111101111122122
11011111110a111110011010111101011110111101101111110011111101a11a111101212221111021210122120202111222111111011111101111111110111111122012a20112211021022101111201
01101111111a111110000011111011111100001111111111011111101010a11a101111210011011121112102121122202111211111100111111111111101111101221121a22002101001210221112212
11110111100a111101111111111111101111111001111110111111111111a10a001101221011211221122112221221212011111111111011111111111111011111021111b11112210202202011211112
01111111111a110111111110111111001111111111101111001111111111a11a111111101212012122002112111211012201111111101111111111100111101111121021b12021212221212121122100
11111111110a110001001110011111111111010111111011011111111111a11a010101221021111111202222201102122011200011111111111110111111100111001110a11200220201021212121101
10110101011a111111111001110111011110010111111111111111111011a01a101001001202210121220222111021221121201100111111111110111100111111211121b22212202121012222022212
11111111111a111111111111111111110111101111111110111111011111a11a110011221002120012021110010101011101111111101100111111111111111101111222b20122222011122201220021
11011111111a111111111110110011111100111011101111110111110111a11a111110211022012122212111012221211222110111001111111101011111111101121121b10222220202122021221202
10101010101a110011111111111011111111111110111011111111011111a11a111110121120121022121112120222212222111111111011111111101111110011112011b22222212102122211102121
01101111110a111111111101111010111110111111001111111110011111a10a111110111111101111111111110111111100011010111111010111110100111111111110b21222112102111211121111
10111011011a111111111111110111111111111100111111111011111111a10a011000101111110111011111011110111111110111111111111100100101010010011110a21210001010011221021222
11111011011a011101110110110111111110110111001111101011111111a11a111111111101111110011111101111111111111011111101111111111111111111001111a22221021211212112121021
11100110110a111010010111111011111110111111111111111111111110a10a011010111110111010111110111111111111111011110111111111111101101111111010b21200222221121111120111
11101111111a111111111111110110011111100111010111111111110111a10a011111011101111111111111111111110111110111111011111011111111001110111111a11211211211122021111010
10111110111a111011111110110111001011101111011101111111111011a11a101111011111111011001110111101011111111111110111111111011101111111111110b10211022122011101222112
11101111111a110001111011011011111101101111110101110111101111a11a010110111111010111011101110111010011111100111111111110111111000110111111b01110212211010212110201
11111011011a111111100111101110111101111011111111111111111110a10a111111111111110101111111111111110111111011101111011111110011111111111101a11221011022221122220120
01011111001a011111111111111110111110111111111101000011111111a00a111111111111111011111011110111011110111111111001111111111110011111111101b01122122211222021221221
10111111111a010111011011101101011111110111111111010111011111a11a101111101111111111111011110110101111110110101101111101111110011111111111b22021201101100001012122
11011111111a110101111011111111111110111110111011110111001110a01a101010101110100111111111100101111111011101111111111111011001111110011111b02121122222221210221110
11111101101a111111111011000111110100100111101101111111111111a11a111011100111110101111110111111101101010111111110101111101110111111111100b10111221001022012220122
11111111111a111111111110010011111111101101001111111111110101a11a111111011111110111110111110111101011111111111111111111111111011111111111a12022110201122121110112
11111110101a110111110111011011111111110111111111110011000110a01a111100111011111111011111111110111001101101111110111110101101111001101011b20112111211111201220122
11101111110a110101101111011110110111101110011111111111011011a11a111111111100111111111011111111010111111001110111111111011111111111111111b21101012022122221222102
10111111110a111111111111111110111011111111111011111010110111a11a111110111011111111110111111110101111111111110010111111101111100111110011a10122120211011012022010
11001110111a110111111111111111100111111111110110111111110111a11a111111111010101101111111111111111011011111110111110111110111011111111110a22111022122111111101201
10111111011a111011111101110111101111111011111001111010111100a11a111110101111111101110101111100110111011011011101110111011011111111011110b21021000112100122002121
11111101110a010111011100111010111111011011010111111111011111a01a101011001111111110111111111101111011101111011001011111011101111111111011a11222110222212111212110
11111111011a110011111110111101111111111011110111111111011101a11a111011111111010101101111011001111001101110101110001111011111101011111001a12212011212202122211200
11111101111a111101111111110111111111111101111111101111111011a11a010111111001100111111111111111111011111110101111111111111111011010011111b12120121212212220111010
10110001111a011110111100111110101111111111110101101111110110a11a111111111101111111111111101111111111111111111011110111101111111101111101a11210202122022102220122
11111010111a111011111110011101001111011101111110111110111111a11a111111111010101111110111110101111011010011111101111101011101111111111111b02122221222002221211222
01101101111a101110111011011111111111101111111110111110001011a11a111111111111011111111101111110100111101111110111111101101101110111110110b12022102222121111011122
11101111111a011011100111101101101111111101111011111111111111a01a001111101111111110111111111111101111111011110111110000111112022021011221a11222212112222100100112
11111111111a111011011011101111111111111111100111111011111111a11a111101111000001111101011011111011101110101110111011110110122220020111112a22222202222221222102101
01100111011a111110101111110111111111011110111111110111011111a10a111101111111011101111010011011111111110111111111110111111112112220220221b21220022210011211221022
01011101111a011011111111110101111111001111110111101111111111a11a110110111011111111101111111110111111110111111111110111110102221212011101b12222012002221221001111
11101111011a100101111111101111100101111110111111101111111111a10a111110111110212022111020220112121212111111111110101001101122102211121211a20111211220122200111111
11101101111a111111111111111111111110001101111111111101111110a11a101012102222212121222201121222221111111101101111011111010121101102001100a11221211122021021111111
11111111111a011101111111111111111111011011111111111001111101a10a111112112002111210110211210112122122011111011111001111111021021221112002b21002211011221010100111
00101110001a101101111111111110111011111111111110111111111110a10a111111220121222210212022212220202200220121221202121111101111211001110202a22201020222111111110011
11111011111a111010010111010111100011000011110111001111110111a01a011102000122122210112220122100021122101002010120221111111111201121212110a11101212120002111110101
11111101100a110011111111101110111111111110011110101101111110a11a011111221112022201211222202020101200210211221111101000100122022221100212b22121111112200201001111
11111111111a011011111111111110101111111111111110111101111111a11a111011121211122211122022202001200211211110021012201111111122221022112201a22211120211001121101111
11111011000a111111110111111111111111111111111111111111111001a10a011111111120202112120201222222222221110211220222202111111121111122201222a12011021210022221110011
10011001111a110110111111111011111101110111101111011111100111a11a111111222112001102202100222212102201221112222202201101111011111101122121b10221121202221111101111
01100110010a100111111101111110111111111111111101101101111111a10a111111220220121101222022101210221220121122022220111111111101012212122112b10212122112102121011110
11111111010a111111011101111011100111010101011111111111110101a11a011112112201102110101121222022222122222112121222111111111022111021111112a12111122122212001101110
11101111101a101111101011001001111011010101111111111110111101a11a011011022122121120100211221212000022112212011111020111111112222112211110b10121222211122011101111
11111110111a011011111101110111111011110111111111111011110111a01a111111010111022002001222010202012002210110201000211111101112222222221222b21212120101100101101111
11111111011a110110100100111110110111110110111111011001010010a01a110112110222121122220021111221220101022212121021222111111121212202201100b11121020111221111011101
11101011101a011001111111111110111111111110011111110111111111a11a111112010222221221120121222022222221221202020222210222112022220220221012b21221121111101121111111
11111111101a111111011111111000111111111101110111101101101111a11a011110102211221210212212222220211022222210100201122022210102122112102220b12120122110102211111111
00111100101a111010111111111111101111111011011101111111111111a11a111112211222112122102002001202221222222222121222020012202210022220220022a21011122022202021101011
11111110101a111111111111110111111110111111111011111111110111a00a111102102021220121112010201122222220212221202210121101110220002221222211a01022101221121221101011
11101101101a011110111010111101111111111011101111111110111101a11a111110011220121202122200222022211202122222122202200012110212222022210112b22021222212111121110110
10111111111a111101111011111101111111111111101111011111100111a11a110102220101202110222222120202212202222212222022202111122122222211211011b10020102111101211111111
11111111110a011111111110111011111111111011111111111111111111a11a011111121122022001112120202022202122002212221022222112112012222221000002b21201001021211221110111
aaaaaaaaaaaa111011111101110111110111011101011001101110011101a01a111102102110012011002221202222222110202202222122221221111101112022021122b01112221022221221111111
111111111101111110111111110011111111111111110101110111111101a10a101011122122122022100002112002202210022222211212022221120122102102001211b10121121221210011111111
111101111101111111111111011111011111100011101011010100111101a10a011102221220210222210122222222200202222112220211222011012022222022011122a10021110102201211011011
010110011010111111010110011111111111111111101111110011001111a11a111211221120221122210220221222222221212222112022221111022220012211202120b10112221221122221111111
1111111101001111111101011011011111111001aaaaaaaaaaaaaaaaaaaaa11b111022122220212222102222222121222022222112220121202211011022122112011221b21210111221101201110111
1011111101000111101111001111011111111111a1111111111010111110010b112102102010111220220022122222220212122220022222211011102202201222020221a20100101221222121110111
1110101011111111001010111110100111100111a1111101010111111111111b112211222210121202220022222022222022201221220222222121210220121212001110a11101110111011110011011
1011111111111111111110111011111111111011a1111111111111111101101b100211121012020220020222221202021022020122122221022211112212120000000111a10111111111111111011111
1011111111011011111101111111111111111110a1111110011111111101111a221212220012122222200002220122222212212220211221220222122121121021011111a11000101111111111111111
1111111111111111101110010111110111111101a1110011111111111111011a112221211112202222200202002100222122201221221221220220022122202111011101a11101101001111010011111
1111111111110111110111011111110111110001a1111101100110001011111b212022111111121221001202221212212221221121221212222212110202121122001111a10111111101111011011111
0110100011011011111110111011111111001111a1001101111101011110100b110212212121112001212120012222201221220022122222022200111211211121111010a11111111111011111111011
1111110111111111111011111111111011111111a1111001111101111111111b111211212011222121222222012121111122120022112221122212111221222120211101a11111110111111111111011
0111101110111011111111111101110111111111a1111110011101010111111b121111112010222122220012021112001011111121101212202021100112110111101111a11111110111111111101110
1111010011111110111111111111011111110111a1111111111111011101101a100012211202121102101212122111111111211120202220021211122210201000210101a01101111111011001101110
0111111111101111101111111011011111100111a0111111111000111111011a200211221121002112021211020112101111011020120221222210222001221020110111a11111110011110111101111
1111111111111111111101101111111111100110a0111101111111111111111a201111020112120121222001222111110110101101222011221121100111222212001111a10110111101011111110111
0011100110111100100111000011111110111111a1111111011110111111011b012102021101121221112210210221111111212011112202112211122022020222111111a10011101110111111111011
1111011111101111111111100001101001111110a1111111101110011111111a220012221001211122122112112021101110201110211211222010211112220111210100a01110001011111101110110
1011111101011111111101111100111111011111a0111101111000011101110a102122211022211101112101221022101111221210100021112202110000211112111111a11011111011111111111101
1111001111111101111111111111110111111110a1101011111101111111001b1121101120222221201122022220211101102202122222001112bababbabbbaababaaaaaa11101111111011110110111
1011100110111111111111111111101101111110a1011111111111011110111b1222122211102211112011211110121111100001122220101121a2120020101111210111101101010111111111111111
1111111100111011111000111111111111111101a0111011011100101111110a2211211121011012201201212221201111101001012120111200a1022121111112001111111001011110111100111111
1110010011110111001100111111111101110100a1110011010111111101111b2120211111120211221112122220111111011211002121211111a2222222111222110111111111010011100111001111
aaaaaaaaaaaaaaaaaaaaaaaaaaaaaaaaaaaaaaaaa1111010010101111111111a0212120022211211210220222202221101111111111111111111a1011011011111011110111100111011111111111101
001111100111111111110111101011110111110100111000000110011011111b1022122200022122121121022211111110101110110010101011a1011111101111111011111111111111111101110011
010101111110111111111001111001100111111111111111110111101111011a1002122012121121111210220122221101111111101011100101a0110101111101111101101011111111101111010011
111110111101100011110111111101010111111100110101111101011111111a1012222111002111202122000222121111111111011111111111a1111111111011101011111110011111111111111101
110011111101111111011110111011100110101100111111011111101111111b2112112002220122201222121121111111111101001111110011a1110110111110110110111111101011111011101110
111101111111011111111111111111110010110001111111101111111100101a1122121121110200201211020221120011111111011110110101a0111111110001111101111111111111111111101111
111111011011111101110111110111111011111101011111111111111111100b2222202211001212212222222121021111101111111111111111a1111111111111011110011101111111100111110101
110111011011111111111000111101111111010001011110111101111101111b0020212120121101122112222212211101111011100111101111a1111110111111111111111111010110011111100111
011111001110010111111011111111101100110111101111111111111101111b2010121220001210221222011121221111111111111111111010a1111111101110111111111111001111001111100110
110111111111111111101111111111111111111001111100011111111110110a0211201120122211212212210122221111011111110111111111a1110110000111111111101111111111111101001111
110111111101001011101111111111111111011111111111111111111111111a1111110001101111111111111101111011110111101111111111a1111110111111011011011111110111111111111110
011111011111111111111111101101101011111111111111111111100110111a1101111010111001111111111111110000111111101111111110a1101110111111101100101111111101111111111111
111101011011011111110111111110111111111111111100110111011110111a1010111001111111111111111111101101101111111110111110a1111111111111111111101111111111110111101100
111101111111111111101110101111111111111111011110101111111111111a0111111110111011101111111111111011000010101011011111a1101111111111001111110111010111110111111111
111111011111111111110111101111001110111101111111111111111111111a1111101111010111011101101011110011111101111111001111a1111111111111111111111100111111101111111111
101111100101010101011111101011011111010111011011111111111110111a1110111011110110101101011111101111111111111000111101a0011111111111111111111111110111101110110111