155 15
1 104
78 98
151 42
145 5
137 70
84 74
99 77
115 88
85 8

1110111111010011111111111101110111111111111101010111110001011111101110222112012101221021121121022121111111101111111111011011101111121121222b22121102120010111220
0001011111111101101110101011111111111111011111111111111111101011111111110102122111012112211102021210211001111111111111111110100010112110212b21120021201010221212
1011101011111111111110011111110111111111111101111110011111111011111100210122120121211221201011011221201110111110111111111111101111101201112b20222121112112212012
1011110111111101111111110111110111110111110000110110111111111101001111201001020221112210212210211212110111111111111011011111101101222202012a22211111122212111121
1111111111111110100101111101011111110111101011111110110111100111111111222202212222221121221222221212101111001111111111111111011101121200122a20201201212122120222
1010111101011111101100101111111110100111001111111101111011111111111111111101121121211112111221212001011111110111110111111110111011212000221b22022112102212202211
1011110111110111101111100111111111111111111111110110101101111111111111111122212122112202112011111221201111011101111111111111011111022121111a12122111220112120121
1011011011111111101111001111111111111101101111011101011011111111110011221102121120102211121112221201101111001111110111111101011111210022220a21111021221120212120
0110111111111110111111111111110101110111011111111111111111111111001111201012110102012222222222112011011111111111111100111111011111210112102b20000111210220122100
1101110111101110111100101110111101010111101111101111111010010111111101121102121111012222012120121122211101111011101001101111111110222011200b21101011111112110120
1111011110111100110111111111011110010111111111111010110111011111111111222212112221212122200112211101110111111111111111111111111111021021111a02111211211102202122
0111111110011110101100111111011111111110110111110001110011110111001111110221111021112212011111211212011101001111101111111100101111102122121a02210221202112111121
1111011111111110110111111110011111101110111111011110101111111111111111102221221221121111210112112201210110101111010001110111110110100202201a12012022212120212221
1110111110111111010110100111110111100101111011010011110111111110111111122211112112111022101111112121011111111111011111011111111011211222222b11111001200112201210
1111111110101111010111110111110111111110110111110110111011111111101111222110221120221012100122100201201110011111111100111111110111112102120a20120020210200112101
1111111110111111011101011111111111100011110111111010111011011011101011020100211222110121120011002110211110000111111101110110111111222120121b022112211212012P2010
1011011001111101111111111110111110111111101101110111101100111011110111100211222011022122120101222122111111111111011110111111111011012122202a11221221222221P10201
1111111100011011011111100111101010010111101100111111011011111111111100122210020212201022010102022212011111110100111110111111101111221121221b202110102212PP221120
1111111011111111111101101111111111111111111011111111101111111111111110221112221111221212212000200012211111111111111101011101000110212200222a2101120101PP22102220
aaaaaaaaaaaaaaaaaaaaaaaaaaaaa11111110111111110111111111111011111110111111121122122121221bbPPPPPPPPPPPPPPPPPPPPPPPPPPPPPPPPPPPPPPa1221212212b202121PPPP2202210121
1111101111011111011101010111a01111111111111101111011011111111011111111110120111121110221bP22112111112011001011111111111110111101P1120101100b20202P02022101202110
1110011111111111111111110110a11111111111111101111111111101110001111101122111122012222212P122111221202111111110101010111011110111P1221202121PP2222P10201210122221
1111111011111110011100000101a01111111111100110111111111100011111010111211212011210112221P202022111201111101011111111111111100111aPP210200PPa2P2PP112111122102201
1110111111111111111111111111a11100101111011101101111110111001100110100111222102202111212P122010210121111111111111010111111110110a12PPPPPP21b00P12122012121121011
1111111111111101111111011110a11011110111010111011111011111010111111111211021122120120021P121222222202011111110111101111111111111a1101210100a12012110212202111002
1101011111111011111111111011a10111110011110111111111111101111010011001111122211212221112P212000121022011011111110111111110111111a1112221202b12111211122112101022
1011111110111110111101110111a11111111101111111100111111111101110111011222120212201122112P122101122000111111011101101111111111010a1122110222b11012202111122101211
0101101110111001110111111111a01111011111101111111110111111111101111011111112202211122121P222112001121111111011111110110111011100a1120222220b02112222001012222110
1101111011111101101111111111a11101011011110101111101011011110110110011121212011102011122P112112202021011111111111111011011110111a1012111100b20212202212211212221
1101111101001011111111111011a11111111110111111111100011110111110001111222122110221112212P111120101212111011100110111111111111011a1011100212b02020000222222212012
aaaaaaaaaaaaaaaaaaaaa1111101a11111011111111011011111001111010101111011121210121102111200P200121121212111111011110111011000111101a1110122221b02222221222122220221
11111111111111010110a1110011a11111001010111101101111110011111111101011111111010111101001P011011110111101111111111111111011001101a0111111211b22111212222202220021
01001111111111110111a1111001a11111101011101111111111111101111111111111011111111111110111P111110011011111101011111011001111111111a1111111012b22101212202112222122
11011101111111101100a1111111a11111111111111110011111011111111101111111111111111101011110P111111101110011011111101111110110111010a1010111210a22121101201202222112
10000110101011010111a1011011a11111111110110111111101011101111111011101111111111011111110P101111101111111101101011010101010111111a1111111222b12211002211121221220
11101111111111111111a1110111a10010111001111100111111111111111100011011011111111111101010P010111001110011111011111011011111101110a1011111222a21121122112111100211
11011101101010111101a1110111a11101111111110110111011110110101111010001110101110111011111P111011111111110101111111011111110011110a0101011112a20021002110112101210
11111101111100110111a1111110a11111011111101100111101010111011111111111101100111111110011P111111110011100111111101111011111001111a0011011022b12121121112022121212
11111111111111011011a1110011a01111111111111111101011010111111101101111111001010111011111P111111110100111111110110010011111011111a1111110211b12022212022212212221
11101100110011111110a1110PPPPPPPPPPPPPPPPPPPPPPPPPPPPPPPPPPPPPPPPPPPPPPPPPPPPPPPPPPPPPPPa101111111101111011011111011101111010101a1110101221b01111112011221222201
01111001001111101111aPPPP0111110111110111011110111110111101101111010101100110111101011101111111011111101101111101111111111101011a0010111122a11121011022122012120
11110111110101111101P11101101111011111111100101111111001110111111111011111111111110101110111111110111111101111111110011011111111a1111111012b21012111222220111201
01111001101101110111P01111101010110111001011101111110110111111101111111111011101101111100011111111101111011111110111111110111111a1011111221b01202002221221200200
01110111111111111111P10111111111011111111101011111111111111110111111111111110111110111110101110111111111111011111111111101101111a1101111112a02121021020011111112
11111101111111110111P11111111111100011101011111111111111111111111111110101110111111111111101111101011111111110011000111101101110a1111111112a01221111011112121202
11011110101011101011P11111111111111111110101110111001111111111111111101110011111111010111110111110011010011100011111011100111011a0111011112b01010212210102212021
10110010110101111010P11111101111111101111111111011111101111011111111101111111110101100011110111111111110001111111001111101111111a1111111120a10201121121112102221
11101101111110111101P00111111111110000101110110011111111111011111111101111101111101111011011101111111111011001100111111110111111a0101110201a01211121120022211121
01111111111101111111P11110011111111111111111111111011110110111110111111101111111111111000111111101110110111111110111101011011011a1111111121b10221012101012101211
01111111101101111110P11011010101110010111111101011111111010111111111101110111101110101111110101111110010011111001111111001111010a0111011012b11101022221221111121
11110111111110111111P11111011111111111111111111011111011111011111111011101010101101101111111111011111111111001101111011111111110a0111111200a00101122102221221102
11011010011110011111P11011111101111111110010111011111101110111100111111011110111011111111101110101111111111111111011101111111101a1111111201b01221121012112110101
01111110111110111101P11110111101110111111111111111101101111011111111111111111111111111111101111100111111111101110011111101011111a0111001111a22102101222221200122
11111110111111111001P11001111011111101111110111001011110111100111111111011111011111111110101011110111111110111111111011111010111a0111110221b21120122222002212222
11111011111101111101P01101111011011111111111111111111111111111101101111111011011101110011110111111110011011111111111100011111110a0111110022a11011010222020222221
11111111111110110111P10110111101011111111111111110111111110111010111111111110011101101011111101111100111111011111001011111002121a1221220120b10222202222122021112
11101110001101111111P01111011011000100011101101111010111111111111111111101111111111110011011011111011111101110111111110111111010b2001012122b20222201121021211212
01111111111100100111P11110101111111111111111111110111100110011111011111011101111111111111111100111111111111110111111011111221201b0112212211a12121202211221211122
11011111110111110111P01111111111110110111110001101110101111011111110101111110111100110111011101111111100100111100101001101122222b1221100221b01221211011110110111
11011111111100010110P10111111111011111010110111111011111111111110111012211112111101021012112221222100111110101111001101011212211a2022102212a21220121121011101111
11110111011100101011P11111111111111101111111110010111101111100101111111220211212112210212202011010010111111101011011111111221110b1212201122b21201211112101111011
11101111111011110111P11100011111111111111111100111111111001111010111121110012022201102120221022221101111110111101101011111121111a1002111222b11122202020201111100
01101111110011111110P10111111111111111111011110011111101111110110110121212212212221202000010021222102211212122222211111111002221a2012022012a20222101111111000101
10110110110111111001P11110111111101111101111111111111111111010011111122122211121002112212222212102212211111020121111011111111000b2122010020a11022102211111111111
11001111101111011110P10110111110111110101011111010111111111011111111022221101221022122020102000211022111212101121220101011110111b2200220222b10022121220021111111
11111110110111100110P11110111110111101111111111110111111111110111111111202102202201112021022212212210022112211021111111111120212a1222211102a10010111212211111111
11111111011111100111P01111110111111111111011110111111110111111111101102112122000121220022022210112112011020201102110011111111021a0112200111a12222101221210011111
11111010111111111111P11111011011010100111011111100111011111101111111122111012112122221222221122222222221121112212111111110201120b2021022100a12120212201220111101
00111111101111111111P10101110111011111111111101011111111111001111111001100221201201112222020020222220110010220112121011111120110b1111110201a11221122201001101111
01111101111101111111P10011111011001011111110111011101101011111101111112210211221022021212010121222211121201212122101110111221202a1121212220b22121121111121111111
11111011111111111111P11111101101111001001111111111101111111111110111111221112210212221212201212122012201122100110211101111001021a1110122111b12102022222111111101
11111011111111110001P11111111111101111111111110111111001111111101101022210111222122202221222022120221022211211111121111111021122b2211211122b20222221222011110110
11111111110011100110P11111001011111111111111011101011011111111111010101212110201001122212122222212221101022011210211111111222111a1102211110a11210202210220111111
00111110111110011110P11111100111100111111111111111111111111111011111112102122101201222022221222200222222222222022122202120012002a2122012122a10111102201021111110
11111101101111111110P11001111111111111111010011111111110011011100111121211021021221220210222222020222212201222122011022220222221a2021110112a22110021101221110100
11111111110111111101P10111101111111010111111101111101111011001101101111220122211201101202122022202121000222221222201220221222121a2121121010b22110222212221101111
11001110111111101000P11110100111101111111011111111010111111111111111120020210120120022120110111202122212221220212220021200210222b0021212211b12012001000101110010
10111111111111111111P11110111011111111001111111101000100101111111110111210022111122222202222212210122220221212122221222221210211a2222111111a22220212211201111111
11011111111111111111P11111100110101111111111110100111111111111110011121011112211221022212022021220022212101022202222211210222100b2220111112b21210111202201100110
10111001101111111001P11111101011010011011110001111111101101101110111122000010000210221020222222012222122112211122012110202120222a1201222111a12012111210220111101
11111011111110110011P10110110111111111101111111011111111111111111111122000122110202120212001200122222221201022202222211010221220a2121021111b11212211112001111111
11111100110101110111P11111111111111000101111111111100010011011011111110220212221202122220202212222212202222222211211100200221222b2112211111a11222111112021110111
11101111001111111111P11111011110011011111101111111001111110111111111122212102002220120222212112222022122222222020112112122202222b2112022222a10202201012020110101
11101101111110111110P10110111011111111101110111101111101011011111011202022222020020202222212220022222122020212122202212112120222b0210121001b11202212102201111111
11101110110111110111P11010101111011111110111110111111101111111111022121202122212212220202200222221222120002212122212112222222211b2210201222a22120122122021101111
01011001111111110111P11110111111101101011110111011111011111010121212100111222220200222202122212212220220100220212201001022022012a2112200122b12221102012221111111
10111110110011111110P11111111111111101111110111011111110111111120220021010202022122020220222020222220222122210222101121211111222a2111001101a11011111101111111111
01110011111111110011P11111101111101011111111010111111101111011112101112202212100220022220222221221022222220210202221112121202022b1101111111a11111111011111111000
11011011111111011111P10101111111111101100110111100111111111110111222221222210112122202212022221211121122212220122002122121200111b1211111111a11111111111111111001
11111111110111011110P00111101111111111111111101111111111101111122112201210022212222222221020222002102222201211221222001201221121a2111111111a11111111111111111001
00111111111011101111P11111110011101111110111111100111101111111000111202112121212012222202122012021222222122222022220222021002211a1211110111a11111110111110011010
11011110011111110111P11001110110110101110111101111110011111111122211202222111122111122200222101110211020220122221022221011022000a2111111111a11011111111111111001
01011110101110111111P00111100100111110111111111111110111101111011122210102111011202220202021202210121221122222121211212212220222b2101011111a11111011111011110111
11001111111111111111P10110011111111110111110110111111011110101002012212012221120102220120001221111111122222122102200021200121211b1111111111a00111110101100111110
10101111111111111010P11011111111110110110110101111111111111111101021221010112221112112011202011111111212210211212211211221211201b2011101111a10001111011111011110
01111111111011110111P11110111110111111111001110111110111111111112022110222212122222212100222201110002212212112222012111222111021a1101010010a11010111111010111110
11101111011111011111P11110111110111111111111011111110000111011121122222221000000212202221021201110010010212011111212221112121122a1111011111a01111111101111111111
11000111111010111111P11111110011110011110111110111101110110101122211212122111210012202121111201111100122212021221012102102121121a1111100101a10111111111101101111
11101010110111000110P11101111111110001111110111111111110111111020122212202220111121122022120121010102110121211002022011121202022b0111101011a11110110111011111101
11011001111111111011P1001101011110011011aaaaaaaaaaaaaaaaaaaaaaababbbbaababbabbbabaabbaaabababaaaaaaaaaabbabbbaabbbbabbbab2120022b2211101011a11111111111110111111
11111100010111111010P1110101111110011110a1110111101100111111111120210211121102222112022011011111111120002011211101120211a0101121b2101000111a11111101011111101111
1111PPPPPPPPPPPPPPPPa0111111111101110111a1011111011100111111111110022101210121011121211211101111111110222111211012110212b2020221a0110100111a11100011011111111111
111P1111011101101110a1111110101011011111a1101011011011111111111212011011222202222022012110200211110022122222201120122120a0122120a2111111111a11111111111111111110
11P11110111100101111a1111111111111011101a1111110111111111011111021221111200201112222020110202111111110210101220122111022b1022220b2011111111a10111101111111111111
1P011111011111111111a1111111111111111110a0110110111111011011110221220222012021011121220112102210111111011111101111110011a1011110a1111111111a11111010011101111111
11111111011100111110a1111101111111111110a1101101111101111111111212011221122111010122022110110211111100111011111110101111a1101111a1111111101a11111111011111111111
11111111011111110011a0101111100011111111a1011111111000110010111002102212011200211121112202121211100111111111111111111111a1111101a1111011111a11111111111111011111
00011110011011111011a1011110111111001110a1101111111011101011110022111222210212101021100212201011111110110111111101110101a1011111a1010101111a01110111111111111100
11111111111111101111a1101111111110011101a1010110110111001111100222122122222212221221212020121110110101111111111111110110a1111011a1011101110a11111111111111001111
11011101101011011111a1111101111111101001a1111110111110101111111101211121220112112201102121100111011111110111101111101111a1111111a0111111111a11111111110101011101
11010111111101111001a1111111100111111111a1111110101111111110111022012010211201021121102120112111111111110111110111011011a1111111a1111111111a11111111110110111001
11111110111101111111a1110111011011110110a0111111101111011111111022200011122122211121221222211011011111001111111011100111a1111111a1111111111a11110111101111011111
11110111111111101011a1001111011110111101a1111111100111111111010100222222112221221212122211110111111111110111111111111111a1100111a1111111101aaaaaaaaaaaaaaaaaaaaa
11111011111111111111a0111101111101111011a0011111110111111101111112022212111022221102221012022201111110111111111111111110a0111111a1101011110111111011001111111111
11001111111111110110a1111110110011111011a1011111010111111011110111111111111110111111011110011110011111111111110101111101a1111111a0011111111111111111101111111111
11111111011111001111a1111111011011101111a1110111011011111010011101101111111110110110111011111110101111101100111111110111a0111111a1111111111111111110010111111000
11111010101101111111a1101111110111111111a1111111011111101101111110010101111011111111101111111001101111110101110110111111a1011111a0111010111111111011011110111101
10110111111111111111a1111101100111101101a1110011111111111100011111111110111111111111111111011110111111110111111111010111a1101110a1111111010101111111111111111111
01110111011111101001a0111111111110011111a1011111110101111111111101101111011101011110111111011111101101110111110111111111a1111111a0111111010011111101011101111011
11110111101011111111a1111111111111111111a1100111111111011011011001010111110010001110111111011011110110111111111101101111a1011111a1100111010111111110111100111101
