144 103
35 4
78 98
151 42
145 5
137 70
84 74
99 77
115 88
85 8

1111110110101111101111111111011111111100a011111111111111010a11111110101122021122222110110212222220201101111110011111111a10110111a1210010211010120211b21211222121
1111111111110111011110110011011111110011a111101101111111001a01110011110211121101102111120212210121222111101111011101111a11110111a1102221122022202000b12212110001
1011111101111110111111111111111101110011a110111111111111010a11011011110212221012002222121222122221212111111101001011111a00111101a1022220002202121111a12120221122
1111111110111111111011111111101111111011a111111011111110110a01101011011210120212211122211110111121122011110111111101111a11101111a1220211222211102112a21210102221
1111110110011111111111101011101001111111a111111111111111100a11100111112121211220112102222020211011022101101111111111011a01111011a1222020220220121112a10101111020
1101111110100110111111111010011011011111a111111110111111010a11111100111222211101112122111111011011121101111111011110111a11111111a1121101122012201121b22100220210
0111101111110111100111111111011101111111a111011111011110101a11001111112021120121122211011012210101121101111011111001100a10111111a1010122001112122221a11121021021
1111111101101111111111111111111111111100a000101100001100111a01001111102212212102112012201112012011001111110111111111111a01111111a1112221122221022121a11001112212
1001110010111001011111111110111111111110a011110111111110111a11111011110112112222111021111012122212101111111001101111110a10100110a1212212212121112202a12211101212
0010011011011011111011111111111111111111a101011011111101111a11110011012220201111211122111121210201122111111111111111111a10111111a1112121111212201022b01211212121
1000101111111111011110110100111111111111a100111111011100111a11011111111112001221200001221121222102111110011111110111101a10011111a1221010212220202101b02111211121
1111111110101111011111111111111110110111a111111110011100101a11111110111012112112122122022201021120111101111000111111101a11110011a1212101211111211021b11020112121
0101110111110011111111111100111011111001a111111101111111111a11001111011212112121212201001111101212112111011111001111110a11011101a0110011102222102121b11101010022
1111111111111111101100111111111111110111a111001111111111010a01111111110110111111122222222210212212122111101110111101111a11111110a1111222222121110112b10100122110
1111110101110011011111111101111111111011a111110111111111101a01000011111112122210111200212211120121021111010101101101111a11111111a1102021022111212222a20222122022
1101111101111111101011111111011010111110a100111111111111111a00111111111111222222211010221201021022101110111111010001111a11101111a1222200210000120112b11122122102
1010111111111101111011111100110011111111a101111111111111111a11101110101111102201001101211012121112212111101101111011010a11011111a1111200122120222221b20202121100
1111111111011111111111010111010111011110a111111110111111110a10111010112111022221201121201111022021211111111111110111111a11001110a1122020121221221201b11121121122
1111001111101111011111111111111110101111a100111110111011110a11111010012222211011212011201211011212210111111111010111111a11011111a1112020120221120122a11102121120
0111001100011111101111111111111011111111a111010011111101111a11101010111222000212110221100022111201212111010111111011100a11111011a1101202211112211221b12111121110
1101111111011111111111100111011110111111a101111111001011111a00110010111122202211202101221200011012011111111111101111111a11101111a0120012112022222121b11122121112
0111001110111111111111011111111100111111a111111111111111100a01111111102212110102121221112222102211101100111111111111100a11111110a1122012211222012220a21102222102
1111100111111101111011111110111011011111a111111011111101111a01111110002121122120121221101102122202122111111111101111001a11110111a1110002112101212121a22111121222
1111010101111111111111111110101011011101a001100101110111111a11101101110221112222112201022120210221201101111111011101011a00110111a1122101201222222212b20122121121
1111011111111110101111111111110101111011a111110110111110111a11111110112120220112021112212012221001120111000111111101111a01111110a1222101112111101122a01221202020
1100111111111111101111110011111111111101a111110111111011101a11111111112011212122101221102011021122222111101111011111111a01100111a1100221112201011011a21001011212
1111111111101101111101101111100111110111a101111111001111011a11001101112221210020121110212202201220112111110111101111101a11011010a1101212102221111101b11202211211
1111011111111111110010111110101110111111a111111111111110101a01111111111120220121120121110112222221210111101111111111010a11111100a1001210222102022112a22222222110
1010111011111110101011101111110011111111a101111110111111111a01110011112222221120222120122111202111010111100101110111111a11110011a1022122212121211112b11202222221
1101101111111111111111111111011011111111a011111110111111101a11111111111202112201111111222120112012012111111101111011110a11101111a1022002222022222202a22021022212
1111101111011111111101111111111111011101a111111111111001101a11111111011211221112102102112111112202101111111101111111111a11111011a1122100221212220002a01120122222
1111111101110101111101110111111011101101a110111010111111111a11111011111110100111001111111111010110111111010111111111011a11111110a1111111200111221220a10211222011
1111111111111111110111111111101001010101a011111101111111111a11101111000110111111101111111110111111111111101111101111111a01111111a1111110111112221112b00022222212
1111101101110001101111111111010101111111a111111101110111111a11111110111111111100111101010100111111100111110111111001111a11111101a1101111022111012122a21021121112
1111110010101011101101111110101111111111a111100001101101111a11010111101001111110011110111001110111111111100110111101011a10110110a0101111221210220111b22110122212
1110111111101111111111111011111111111111a111111110111111111a01011110110111110011101011101111111100111110111111111110111a11110011a1110111000222222201b11022212122
1111111111011110111001111111111011101111a100111111011011111a0111110011001111111aaaaaaaaaaaaaaaaaaaaaaaaaaaaaaaaaaaaaaaaa01110110a1111111020202201211a10012110112
1111101111110111101100110111101111111110a111111110111010111a1011101111111111111a011111111111101111111101111111111111111011111111a1110111201111221120a01111122101
1100111111111111111111010100001111110110a111111111111101110a1011101101111101111a110111011101111011111111111111111110010011111111a0111101200220202020a22002221211
0111011111011101111111111101111111101111a111011110110000110a1111101101001111111a101110111101111111111111111111101101111111110111a1111011210002101211a22210101112
1111111101111110101101111001011111111011a111111100000111111a1111111011111111111a111111001101111111101111101101010111111001111101a0100011221220112212a21222222201
1111110111111111111011111101111011011110a101110111111111111a1111101111111111111a111111011011111111111111010111010111111110111111a0111111222111110212b01120002111
0110111101111110011011101011111001111111a011011111110110101a1111011101101101011a111010110111001110111111010101101101000110111011a1110011212102010212a20112200102
1110011111110111100111111111111111111011a100111011111101101a1111101101111111111a110100111111011100101100111111111111111101010111a1111111211202022112b22222211022
1101110100101111110100110100111111111110a011111111011111011a1111101101111111111a111110111111010011111100110111011001110111101011a1100111221022012101a22201101111
0111011111110101011101001111111110111100a101110111110111010a1011111111011110110a010111111011110111110111111111011100111011111111a0111011212221001221b10112110121
1110111111111111111111110011001011011101a111100111111110101a1111111110111101111a111111111110111111111111111010111111011111111110a1111101222112222122a12012021100
0111011001010111101011110011110111111111a011111110111100011a0111011101111110101a011011111111101111011001111001100011101111010111a0111111221211122202a10021221212
1011111110111110101111111111011111111111a111111111111011111a1011100110010111111a011110011111101111110111111111111111010110011100a1101110001022222112b02022222022
1101111111101111011111111110111011101011a111110111111110010a0101111101111011111a111011111101110011111111111101100101011111111111a0011101110222121220a01211221011
0110111111110110111011011110110011110100a101011111111011110a1111111111111110111a001111111101111111001100100111111111111111011111a1111101121121202122b12221220120
0011111111111101110110111111111111111111a011111101111101110a1011110110111111111a111111110011111111111110110111001111111101011111a1110111201201001211a11111111020
1111111111110111101111111111111011101111a110111101000111100a1111100111101111111a111110011111101011011011110111111111110110111110a1101011110111112120a12001221022
1111111101001110111111111111011100111101a111101110111110001a1111011111111111110a111111011111111111111110101110111011111111011111a1011111212011221112b02112120121
0111111111110110000111111111111101001111a111101111111101111a1101101111111111111a111110011111111111111101110110101111111111101111a1110111111122201212b22022222102
1111111110111101110111110101111111010110a111111110011110011a1111011111110111110a011100110111111111011100101101111110110111022211b2101120222212222222a12022211102
1111110111111111111111111110111011111011a110010111011111011a1101101100111111100a111010111111111111111111011111111110011111122121a1210121022102002022a02211122011
1011011111001111111111110111111111111111a101111101110011011a0100010000001111111a100111111011110111101011111111111011100111111122a2012112121222011102b20010211110
1111111111111111111111111001111011111110a010111010101111111a0011111100111111011a111101111111111111011111010101011111111110121210a2111012220222200010b10111011111
1110111111111111011101111111010111111011a111111110111111011a1111111101221012011a211200012020022122221111101111001101111111022222b0111102022222222121b21221101111
1111011011101101111111101111111011110111a111101110100101101a1110110001111102212a112212212102111111221111111101101101101111211021baabaabbbaabbbbbabbbb12121101111
1110100111011111001001101111111111111110a111111111010000111a1110101112011211221b22120121112211221221111111110011011101110120111110110121112202100211121111101110
1010110010101111011110110111011110111011a111111111101111111a1111110111120220212b20112222222221220221022120121212212111111122001210111100000121221122200111110111
1111111110001101110110111101100011111111a111100000101111111a1011001011101210011a02222022220222220222221222201011011011010112200122110121002212111200200020111111
1101101011011110110000111111101101011111a111110111111111101a1111110112021112221a21222112222212022222012211102102122111111111211212221222222221020222020101110111
0111011111111110011111111111111110101110a111111111111100100a1110111111221122111a01202212210222112102020112122200121111110011222221112121112211100210112020111111
1010011111111011111111101111110111101110a011111011111111011a0111111112220122200a12122022212020000212010222022212021101111111112120202122112011002222121001111111
1001111111111110111111100011110110111111a111101111110100111a1111111112122112001a21212211221212221212012101121100112110111112122222202221221100022011121101111001
1111100101111111111011111101111111111011a111101111011111011a1100111000201022101a22122222122220212112110201112222122101101121211211102120120100120222222121111111
0111110011110011101110111111110110110010a111101111111111011a1111111112112122122a21102022222120202022112211210122022111101011022111212021200221221102112101011110
1111111111110111110111011111011111111011a111111110101011111a0111111011121112022b01122222222022212212112221121211212111111122212122012212212111012112012221110011
0111110111100111110101111101010111111110a101111111011010101a1101110112012220222b22211221021201211112200211112121021111011102101210111101222212122221212101111001
1110111111111111111111011011111110111110a011111111111111111a1110111112212211122b21112200222202201002201110202220112111111101221100211202112011122212211211011110
1111101111111111111111101111010111110101a111101111111110101a1111111101121222112b12112211112201111222220222122221212012021200122002221210222012121011001201111111
1011111110101010010110111011111110111110a111110101101111110a1001110012212212212a21101222222122222202022202021102222012111121201120212021221022210212122021111110
1111111101111001110110011110111111111111a111011100111111101a1011011112010222121a11122222222221022222222020222012022111211022122022220222220222112202011011111111
0111110111111110110111111001011110110111a111011111111111111a1010111102112222121babbbbbbbbbbbbaaabbbbbbbabbbbbabbbbaabababbaaabaabbbabbababababaabaaaaaaabaaaaaaa
1011111011110110111101111111111011111111a110011011111101110a1111111102200021211222212222212122020211122222120222202002222122122222212002212222001211120221111110
1110011111110110101111111111001111110111a101101111011101111a1111111112222210022111012022221220122200122212221221202121111212202221211212201110221110112020110111
0111111111011101011111110111111110111111a111011011111101111a1010111110200012222122122021112211212220020201222221221200012002202022010200210212002222011211011101
aaaaaaaaaaaaaaaaaaaaaaaaaaaaaaaaaaaaaaaaa111111011101001110a1110100101102100221110210121012210221100210122220022212121201222122022100011111110211110210101111110
11111110101111111011101111110111010011111111111111111111011a1111111112121222222112222212222222222200221222222220200201211220222102221121010222211112122121100111
11010111111111111101111111111101111010110110111001101101110a1011011101002210102222111220222010102222210202122111022101212202222202221220101211020010211101101101
11111111111111111101110111110111101111101111011111110111110a1111121210121222222000222220222010021021221221011120220010020122022222210211021220120122100220011111
10111111011111111111001111010111111101111111011111111111111a0101122022012212222212112220222222102222120121221212212112222102120122022212212112021121110220010001
10111110111111111111001001111110111110111110110111011110111a1110211122002222202222212222222222210022221222212222020221112022211222220112110211222111122221110101
11011110111001111111111110110111101011111111111110101101111a1111121112222022022222220220001022012222211222002222222102120121112122211110111111111111001011111101
11111111111111111111111111111111111111111111011111010111111a1111112222221222210202212122021202222222222220212221212110121112222122011111111111111111111100111111
11111111111111100111011111110010111101111101110111110111011a1011202100110210222221212022222220221122220002222222022211122100110120001111001101101110111101111111
11111111111111011101101011111101111111011111111111111111111a1112222112022021222122212222221202212022222011212222221110221221121111111111111111011101111101101011
11111111011111111110111101111101111100111101111111111111111a1101221102101100221212021222222001112110122222000222202121012110222211201110111111111110111010111011
11101100111011111111111110010101110110101011111110101110110a0001121112202002101112012210220102122012002211222221202201122121111221101110011111111110111110101111
00011111101111100111111011111111111111110111111101111001111a0100102011112221220211022121221022210102022202202202222221211022012212011101011111111111111001111111
11111010101101111100111111111011111111111011111101111011111a1110222222200022222122011011111012111100002102111101010010111102002221211111111011011101111011111111
11111111011001101111001001110111111011101000111111011111011a1110020221002212020102122211221110111011222222110011222122221000021211211111111101111111111111111111
11111011011110110111011111011011110111111001111101111111111a1010112210022111112221102121212100011011012111220222112022010212011020110111101111110111110111011111
01111111111100101101111001111011110111111111111111110111111a0011122111222212012211012022100201111111001021111221221211222120110220111110111111111111111111111111
11111111111110111110111110111111111111111111111011111110011a1110222100122201221210111111022111110110021220212122010210212010100002111111111011110111101110111111
11111111110110111101100010111111111010011101111011000111110a1112210000200202222201122022200121111101102212212002012212022111211010210111111010111101111111101111
11111100111100111111001111111101011111111111101111110111111a0102202012222210111001120220021210111101222012110212221121210112112121011111101111111111011111111111
11111111101101111111101110111111111101111100100111111111111a0111110212110212121112211100222221111011222211120111110211210010111120210111111011111011110101011111
11101111111100100100111111111111110111111111111110110010111a1102112010112001200220220110121120111111111122120101011000012121112201001111111111101001110110111011
01110111111111111111111111011010001101010101110111111111111a1101220201220012112112212202012122101111112111102221212120211120112112101011111110011111111111010101
11111111111111101111111101111011111110111111011111111111111a1102002120202100121122202010210221001110222111222112201221212220212010201111111111101111111011101111
11111111111111001110011111111111111011110111111011101110011a1112222222211212111001111101202122111111111111111111111111111111111101111011111101111101111011100111
01111001111011011111011001111011101111111111010101111011111a1110122211002210222022221222222012111101010111111110111111111111011110101111001101111101111111010111
00111111001101001110111110111111111110111111110111111101110a1102121012212221220001012111121102111011111011111111101011111110111110111101111111110101111111011011
10111111100110111111111001111011111111111111101111111111110a1111212211021110110110222101221202100011010011111111101101111111100111111111100101010111110101011011
10111111111011101111111111111011111111111011111111100111110a1100001112221222110211021102212122110111111011111111111110111111111111111111111110011111011101101101
01010011111111111111010111110111010111110111111111111101111a1111012122121120111110112110121210111111010111101111111110111101101111001111111111101011111111100111
11111001101010011111011111111111111101111111100111101111101a1101202222200101212111212211120010111101111111101111111111100111111111110011111111100111010111111110
11111111111110111101111111110111110111111111111110001111101a1111012022021020121021022110122002111110111011110111111110110110001111111110011011111111110101110111
01111011100101111111101111111110111101111010110111111110111a0110210222121122021202021022122212111001101111111111111101010111111111111101111111111110011111011111
11111011111111111111111111011110111101111111101101101011111a1112221111101120221212211222201110111110111111111111111001110011011101010111011110111111110111111111
01111110110111111101111111111111111011111111011101001101111a1110111101101010011100011110111110111111110111111111111110111111111101111111111110111111011110110111
10101101111111010111101111111111101111111111111111111111111a1111110111110111111111000011111111111011111110111011001011010101111111111111010101111110111111111011
11011101010101111111011110111111111111110111110111101100111a1101111111101011111111101111111110111011011111111110111111111111111111100011111111111011111111101111
11110110010110111100111101110111111111101111111111111110111a1111111111111001111101110111011110100111101110111011011110011001111101111111111111011111111111110011
11111111011101110110101111110101101111011101101010111101110a1111011101101111011011111111001101101111111111011100111111111011011111011101110011111010111111011101
11011111111011101111111111111111111111001111101111111111111a1011111110010111111111111111111111111110111111111111110111101111111011010110100111111111011011011100
