155 68
7 78
78 98
151 42
145 5
137 70
84 74
99 77
115 88
85 8

1111010011111101010011101011110011111101111111111111111101111101010111211011212101200020222110202020211110101101a10100101111011111122020102021221210201012211110
0111110110110010001111110111111101110111111100111101000111111101111101221112100110001220121221222122011100111111a11111011110010011212211012201211111102210222112
1101111111111111110111100111101111111110011011111111111111011110111100121222120012202211222222100111011011010110a01101101101111111100121111122212101120111021101
1111111111111110111111101111111111111111111111010111110111110111100111212220021121222222122212121222211111111110a01101111111111111111102021221212210121102000010
1001011011111101011111111100111010111111111111111101111111111111111010212000211222201221201221102011200101111101a10101010111110111011100111212212211001021210122
1011111011111111010111111111111101001000101111111111111110111111111110111212222222022012222011122200211111111111a11111111101101110211022021121221002111210212001
0111101111110111101111101111111111011001111110111101011001101010000111112102022212201120021110111011110111111111a11101111111110111212111012122121011212221221011
1101011010111111010110111101110101111111111101111111111111111110111111211221221121211111221212210222211111100110a11110111111010111101021212012221111012202022201
1110001101011011111011111101111101111101111111111111111011011101101111222212122211121211020021212021111101110110a11111111110111111010110211022111222122212200112
1111101111111111101111111111111111000111111110111101011111101110111111112222102202220120202010121011211111100111a11101101110111000002222120122202221201112012112
1011110011111111101111111111110111111111111110111111111110100101111110122210212102201211211112201120111110111110a11111110111110111200002112102001112011212222012
0111110111011111111111011010010111111111111111111111111110111111011111122021201222222122211222012111111111111111a11111111111011111122021210012120101221221111212
1011111001011101100110101111011111011101111110101111100111111111111111121201021121102211012111122112111111111111a11110111001111010202110101111212012222011220111
1111100011011111111110111111011111111111111011111011000101111110111111110202021121212111222221122022111111110111a11111011111111111221212212012122211110012012122
1011101111111111111101001111101111111110111011111101011111111110100111211020222112121011122120212010210111111101a11111101111111111121020121102002212121210121011
1011011111011110111111110111111111001000011111111111111111101011011100202210122210220102101111112211211111011111a11111111111110011122211002221012120002202100022
1111111111111011111111111001111111111011010111011111111101111111101111220222212222221021011202022110211011101110a00111100011111111101122212212211121211120122212
1110011111101101111111011111111111111001111111111111110011011101110100012022101122222220122111222212011011110111a11110111111010111122121022121111112101210211222
1011110111110111011001111111011011111010011011111111011101111110111111212112022121002122122102201011201011111111a10111111111111111002122011122021111022021112112
1111111111111101101101101111111111111111111111111110111111001111111101121202111122122211200211222111211101111111a11111011110110011121220201101210012222211112101
1101110110101111111011111111111001110111111001101111111111101011111110101222221212121111210122221101010100111111a00101011111111111110100111100122012110022101120
1100110110111111101110111110111010111111111111111010111101011111111111211002112211122011021022112212011111111110a11001111111111111222222110101122211020012011011
1111101111010101111110111110111100100111111110111111111111111111111111111122102220111122122220101111211111111111a11101111111011110121211120111211201000222211111
1111111100111111111101100111111111111100111110111111110111111111111111100222122110122211212121220221011001111110a11110111011011111101211110111002122022222120121
1110111011111111101011111111111101100111111111101111111101111111111111200211212111121221110110201121101111010110a00111111110111111112121222112111121101121221201
1111011011111011101010111101011111111111110100111111101111111111111110022210210101120221211001211221210111111111a11111111111111111211211122002222110022211011021
1111001111111101111111111111101111011111101111101111111111110110100110222022010011111110102121222021011111111111a11101100010101101112211221121222022222122102210
1001111111101111111111111111111111010110111111111110111011111110101111000212121211111211220211121101201111111111a10110111111110111111121002122222222022102202022
1011011111101111011111101000111010101110111110101011111111010111111111221102102211201112221111121101210111111011a11011111111110011112212120122221201221022202012
1111111101111101111011111010111110111111011111010111111111111111111111121100221222212101211121210222111011111101a11111011111111111211222021110212222221222212102
1111011011111110110110111111110111111111010011111111111110111101101111021122120112221121111112022001201111110111a11100111111111011102201222212012201221202222012
1001111111111100110111110111111111111001111111111101110101111111111111011010111111101110111011010110011011111111a10111101011011111101101222211121212221222020220
1111101111111111111111110101111000111011111111111111111111111111111111111011111011111101011101111101111111011110a10010110111111111110110221122121021101121110120
1011011011010010111101101101111101111111111111101111011110111110111111100101111111111110111100111111111111011001a11100111111110111111111222011102221002102211221
1111100111100111111111111111101111111111111111111111011111110111111101101111011111110111100111111011101001011111a11111111101111110011111011200211211202020102210
1111101111011011101110111101111111111111111111111111011111111011110101110111111111111111101001110111111111011110a10101101111011011010111111102120112211212122122
1111111111111011111111111110011111011101111111111111101111110100111101111011001110011111110111101011111111110110a01001011011011011111111222211110002200101222222
1111111011110111101111110111011111011111111110111111101101111111111111110111111111011111111101110111100111111101a01111111111111111110111100222200012112021020222
0111111001101011001111011111100110111011111111111111110110111100101010111111110001111111111111111111111111111111a01111010111111011111111120001201112012002122120
1111111101011101111011111111111111101111111011111111111111111111011011011111111111110111111111111111111100111010a11110111110111111111101211112101222111121120021
aaaaaaaaaaaaaaaaaaaaaaaaaaaaaaaaaaaaaaaaaaaaaaaaaaaaaaaaaaaaa111110100111111111110111101111111101111101111110111a10110111111111111101110211102111211110102201211
111111110101111011010101110101111111101111010111111101101111a111111111111111011111111111110111111111111001111111a11111101101110111111111222202102222200121222221
111111110000111111101100110111000011010111010010110111111111a110111111111101110011011110111110011100111100111111a10011111101111111111111111110122211201211021001
111111010110110111111101110111101111111001110101111111011110a111111010110111110110100101011111111111111111001111a01111101011001101110111222210212211221210211212
111001111111110111111011111111111110110101010111011111111111a111111110010010111111011111111101111111111111111101a11111111011101111011111001211222110212111211221
101111011101111110111101101100111111111111111111111101110111a011110110110111111011010110111100001111101111011110a11110111011010101110101101221212112202221212022
111011100011111111110111111111011111001111111111111111111101a111111011110111111111111111111101111101101111111111a11101111111111111111001121122202212200221221010
011100111111100111111111101111010111111011111101111111010111a111111111011101110101110010111100110111111111110111a10011111111101100100110120112101122112112212112
101111111111101101111111010111110111111011011101111010101111a101011011011111111111111111111111011111111111111111a10001101011111110011101212011111102100020122202
011011111111111110111111110011111111011111111011111111111010a110111010101100111111111111111111111111111111100011a11111111111010111100111222101200211212122121011
111111111101101101010111001110011110111101111111111111111111a111011111111110111011111001111110111111110111101111a11111111111010111110111120221111002111210110221
111110101011111101011111111111111011111001011111110110111111a101111111111111011110110011111111111111111111111011a11110111011110111011111022121002012221222221202
110111011100101011111101111101111011111101110101111110111111a111111011110011111011111111101111101110110111111111a10111011111110111101111222121211000120212021121
111111111111111111111110111110111111011110111110110110111111a111010111111101101101011101011100111110111111111111a10111111101110111110010011211112222111211011112
111011101101101111111110111000100111101111111101101111110101a011110111111101110010111000111111011101111111111111a11111111011111111011111010220121211112122210122
111110111010110111111111011110110001101111101111101101111011a111110010111111111111110001111111111111111111111101a11011111001220211120110101200220222212010102221
011111101111111100111111111110110011110101011100111111110111a101111001110111010101101111111111111011111011111111a11111011100121221111000121022221122021212121122
101111111100101111001011111111110111011111101111011111111100a011111101111111101111111010111111111110111111101110a01111111110122121012221202220102122101222101220
110101111111111010111111111111111100111111111010111101111110a111111111001001111011111110111111111111111101111111a111110aaabbaabbbaabbbbbabaa22121221122111100111
100111110011111111110111110111101001111101111111101110110111a111111111221221110120112020121011121022111101011011a101111a1121201222222012122b21201212221221111111
aaaaaaaaaaaaaaaaaaaaa101110111111111001101110111000011111111a011110101121102102122221122002211212211101111111101a011111a0121002100110010112a00111011211111111111
01111111111111101111a011110111111001011111111111111111011111a001111110021102102202111221012121221110011111110110a011111a1111110211220010121a12212121212201010111
10010111111111001011a111010111011011011011101111111111101111a111101112101120021121201222122222122122211120021200b221111a1012120221222102201a11110021112121111111
11101111111101011011a111110111110111111111111111000111110111a110111111012012011111122222011120212222212220221110b120111a1111220221220212211a22102020110211101011
10110111111100101000a011101111011111111011101110111110111011a111111112100202221121021100012222220220212011112021b111011a0110120100210220112a12201010222120101111
11111011111111111110a111100111111111101011111101111111110111a111110012100222101200110122222201201202011221122211b011111a1102202202222011121b21112001111011111110
10111111111111111111a111101111011111101111110111101110101101a110101111222220121221112220022202120022222212101010a110110a1011222212122122212a12212212202111111111
11111111111111111111a111001011101011011101111110111111110101a111110012111222111121112122221222220122121121221112b111101a1111111211001221211a22212121021121111111
11101101111111011100a110111111111111111110011111011111111110a110111100102122021201202022220222212122211212102222b110100a1111120011222111200b22021012021221111111
11111110011010111101a111101010111111111111101111111111101111a111110111211121101212202221222201022000110210001212a211011a1122102102212112010b22012120111121101111
11111111111010111111a110110011111111111101110111111111111111a111101111122212121212121202012220022222010010112210b011111a1101111202222122102b01202122212001111101
11111011111111010111a111110011111100110111110111110011111110a010101002221220210022122220022222220122121122120112b111101a1121112220012122111a21020122120111110111
10101111111001101111a011111101001101111111110101101011110110a111111110201111211011202001202202200222202201112121a010111a0120212001211022211a22022202122111111111
11111101111101111111a111011011111011111110111111111001111110a100110111220202012112122221022022221010112212202221b221221b2111222221222122022b21222121122211111111
11111001111111111011a011111111110011111111111001111010111011a001111111212211112220002202021222202112120200010222b221020b2121021222221122012b02112121202121110111
11110111111111110111a111111111111110100111101110111001110010a101111111012222102212022222222210222222102220022212a222022b1122222222121010102b21212221102220110111
11101111110111110101a101111111110111110101110111111101111111a011111112112022221211200222020120120221102211220220b220221a0120221222022212120a21111122201211111011
11111111011101101110a111101111111100011111111110101001111111a011111112102212011002022200202122222212222022202222b201211b2121222222212101211a11022221211111001001
11001110111111011111a111101111111111101111111111111111101111a110111012202220100202222112122222220201122022221121a221212a2110210222020212111abaabbabaaabbaaaaaaaa
11101111011110110011a110111111111110101101111111101111110111aaaaaaaaaabaaabbababbaabaabbaabbbbbbbbabbb0212201221b220220b1120210201122222111122011122020021011111
01111111111011111111a0111111100011011110aaaaaaaaaaaaaaaaaaaaaa011011101122212112221121022102002112202a2002221202b222222a2002122212211222221111221002212211111111
11100101110111111111a1011111111111111101a01111111110111111111a111101112221001221100221221200102222020b2112102212b221102b2121121110011222010210202112210101111011
11110111111011111110a0101101111000101001a10111110011101100010a111111120212111212101212222101002111202b2222022021b122011b2022212022112222010122212221001101111111
11100101110111011111a1001011011111111110a01110110101111110110a101201022121121202221120002222012212020b2220020222b012011a2222221221211212211221010222112211011110
00101111011111111100a1010110011011001111a01111110110111111001a112201222021212022222122020020022212212b2220222222b222211a2122020202201221110102212201112211111101
11101011111111011111a1111111111110111110a11010111110110111011a121222200200212122221022222210022202222b2022222222a022212b1121022212222122221122100222112221111111
11101111111011110001a1010111111111101110a11111001101101111111a101220222120202120110222200222210202202b0222022212a220220b1112110110211101010111111101111111111111
01111101110111011101a0110001111101111110a11111111111011011111a101212021021021200221020220212221220222b0210221022b111021a1221122011111001111110100111001010111111
10110111111111111111a1111111111111110101a10011111111111111101a121110110222212121120120120212221202220b2220012020a201221b0222112021110111111111111111111101011111
10001111111110110111a1111110111111111101a11111111101111111111a112000222022020222010222222222222122122b0021122120b222200a2012221111111101111011110011111101101111
11111111100111101001a1110111111110110111a11111111011111001111a102110022221221112120122221121121022212b2222121021b222211a1012211211111011111111111111110111111111
11011011111101101111a1101101111111101101a10101101101101111101a112101120212121020222112122202200210211b2020020220a010202a1220011112201110100111011101101001111110
11111111101111111111a1101111111101111111a10111111011101011111a121001020100121121212100220222001221020b2221222112a021020a2212210110210110101111011110111111111111
11111001011111111101a1111011101101001111a11010111010111110101a101012012112001112011102212201121011110a1021112220a112122b1012121011111111101111010011111101101111
11111111101111011101a1010111111111111111a11110111110111110011a121222201100210122102120202022111011111a0112220202a200221b2102202222111011110111011111110111111010
10010000011101111111a1111111111101111110a00011101111101011110a110001122010122112101012001200121011100b2201220220a102021a2221001121101011001011111101101111111111
11001111111111011111a1100111110101111111a00111111111110111111a102011100121122111122112121222211111012a1012211211a121122a1211221021111111111101111111111111010111
01110001111001111011a1111110111111111101a11110011010111111110a112001122222122210121111210211111101110b2201021222b212221a1202000220101101010111111111110011011111
11100111111111111011a1111011110111111011a11111110111110110101a112102211110212210222221221022101111110a1221110122b112202a0112211222211110111111111110010010111111
01101011111011111101a1110101111001001111a11111110110101111111a111112212002121122020022011122111111101b0121111121a211221a2222120222211111011100111111101110111111
11011101111111111011aaaaaaaaaaaaaaaaaaaaa11111111101111101111a102221100021011222100012112111121111111a2102110122b011212b2111112112111011101111010110111111110111
1111111111111011110110011111111111111111100101111111111101110a121121021201202021111210012021121011110b2111120022a201112a2221111121111010111101111111111110110111
1111111011110101001010111100111111010111110111111110111100111a111122020012221212122021011221201101112b0102211111a222211a1102120222101110111111111111111001111111
1101111111111011111111100101111101111101111111111111110111101a012122212122200222212222020101201100100b1212021011b010212b2121222101101110111001110111110001111111
1010111111111110111111111111111111001111111111111111111111111a121122102111022112211221110110211111111a1111111111a101111a1101100001110111111011111101111111111111
1111111100111011110111111111111111101101111010110101011101111a112212112121110112120100122212011111111a1010110111a110111a1111111111101011111111011111111011110111
1011011001100010110111111101111111111011111100011110011111101a112211212211011201112012112121220111110a1010101111a111111a1101111111101111011000101101111111110110
1111100111111101111001111111111010111011111111110111111110101a110221202212112111111101120212211011111a0110011101a111111a0111111110111111101111011010111110110111
0001111111101111111011111101110011111110111101111110111101111a112200012222000202012022100122201101111a0000101101a111011a1110010111001011111111001111101110111110
0111111111111111111011111111111111111111111111111101111111000a111211021221112221020021212220011111011a1101111111a011111a1111101000111001111101111111111110111110
0011111111011011111111011110111111101011001111101111111011010a101111010121102221200212221210111011111a1111010100a111111a1111010111111011110110001111111111011101
0110111110111111101111000111111110111101110111111101011011011a112211021122220212211222122211211010110a0101111111a111100a1111101111110001011111111111011011111110
1111010111111111111111111100101110111111100111101101011010111a120210111212212212110121202121211011111a1111111111a011100a1111111111111100111000111111111101111111
1011011010111110110101111011101111111111111111111111111101111a112222201202112112211022122212121101111a1011011111a111101a1111110000011111111111111111111111111111
0101110001111111111001011111011111101111101010011110011111111a111111111111001111111111100111110111111a1011011111a111111a1111111001111101111101111111111111111011
1111111111111110110110111111011111101001111011111110111111111a111111111111011111111101011111101011111a0111010111a101111a1111111010111111111110101111111111111111
1111110011111111111111111111101110101111101101110111110111110a111111111111101011111111111010110111101a0111011111a111111a0101101101111111111010111111111111101111
1111011110110111110011111001110101110110101111101111111111110a111010111111101111011111111100011111111a0111101011a110111a1111101110111101111011011111101011111111
1110111011011101111011111011011110100111111110111010100111111a111111101101011111010110111001111001110a1001111011a101111a1101110111111111101010101111111011111011
1101111111111111010111111111101101111111111111001111011110110a111101111011110111000100110110111111111a1101011101a011111a1010110111111111110100101101001011111111
