143 90
0 49
78 98
151 42
145 5
137 70
84 74
99 77
115 88
85 8

111101a0111111110111111110011111111101111111111111110111101a1110111110000011212212120122121200220111011101011111111011111111111111021121021001011221212202121201
111111a1111111111111110110001111010110111010100111111111111a1001111111112222212221210201212002122111100101111110111101111101111111111020122121102112112221222220
111010a1101111101010101111111111011110111111101111010011111a1111100111121222112211122120120010212211111111111111011101111110110111221222002111211222121211120121
111111a1101111010111101111111111011100011111110111110011011a1000111111200122202011212211222112211221111111001101100111111111111011122112222102010221220220101121
101111a1011101111110100111111111111111101101111111111111101aaaaaaaaaaaaaabbabbbbbbbaabbbbbbbbbbaabbabaaaaaaaaaaaaaaaaaaaaaaaaaaaaabbbbbbbbabbaabbabaababbabaaaba
011111a111111101111010101110110000110111011110111111011110111111111100221110121110112221111110121112211011011111111110100111111111112211212210111211121121200220
111111a111111111111011111111111111011011101111101111111111111111110111110122002112222111212220112110011111111111111111111111110111121121111122101121221222222201
111111a111101001111111111111111111111011011111111111011011101111100011001122122101201022022011111111211111111111110011111101111011022111010121111210111201001220
111110a111111101111110111111111111101011111111111111100100110111111111211221121011211110210210011012211101111110001111111111100111221110122011212111101221101201
111101a111111110011111011101111101111111111010111011111101111111110110111222111211202121122101222121111001101111011111110111011110212001121111000002112010212012
111111a111111111101111111111111011111101111111111110111110011101111111102102220212211220021020120121111111101110111111111110111111221202222201211111021122212222
010011a111100101111011111100011111111111111111110101111111011111010110222202210100212121120211121020111110111101111111101101111111221001111122012222002111022122
101111a111100111011111111110011100111110001111101111111111111111111111102122221102211111002110222110010111111011011111111111110111211002221211002111101100111222
011011a111110111111011111111111111111111110101111111111101111011111111122010002221221001210112122222201001111011111111111100111110001011102102212211222212012122
111111a001110110111111111011111101011010011101111111110111111011111111120212201221021202111100201122211111111110111111111101000011221211111121212120122020221112
111110a010110011101000111111111111110111111011111111110111101111111111122201221221101200122110201211010011100110111110111001111010222220122012101112112222122221
101111a110111011111100111111111011111111101111011111111101010110111110112212210122212121112221120111001111111000111111010101111111222120202100222122020022122002
010111a011100111001111011111111111111101111011110100111111111101111010102110222111221212211010200100111111111111100111101011111011221111212122112202212112211010
101111a111111101111111111011111111101111111111111110111111111111011111212211112012022201111110222121111111111111111111111101001111121112120012122111212221212222
111111aaaaaaaaaaaaaaaaaaaaa11110111111010101001111111111001111111111102112100021002222abbbabbbaaaababaaaaaaaaaaaaaaaaaaaaaaaaaaaaababbabbbbbabaaaaa0102212211111
11101110110111011100111011a11111110101110101001011011111111111111111102102012222201221a11211222022020111011110111110011101111111102221011112000002b1102021022221
11001111111110110111011111a11111111111011111011101110011111111111010011120012210112021a22111011122212111111111111111111111001011010221121121201121a2120102020211
11101111111100111111111111a11010110111111101111011010110111111111110112212021112111101a20202102121212011111110101111111111111111111222221011211122b0212212112121
10111111101111010010110101a01001111111111010111111111011101111101111110011111122210201a21011111011110111111101111100111111111011110120220202211121b1212221212111
11111111110110111101111111a11101001110111111100011110111010111111111111112221211012022b12022221012022111111111111101101011111010112122102221220221a2211011112222
10111101111101111011111101a11111111111111110100111111110111111111111112102121210002122a21201111011111111101111111011111110111101111111212011202211a1112011122221
11111011111111101111110101a11110111110111111111111011111111001101110110202122012222211a21211212201220111111111000111110011110111111012122201102012a0001201022012
10011100011111111011111111a11101111111110011111101011101101011111111110101111112222120b21101111212110010111011111111110101111111111021212122201221b2221222210212
11111001110101110111101111a01011001111111110111101101011110101011100012211022012120220b01222110102202111110111111110111011111110112110022122202222a2002222210221
10110111111011111111111111a01111111111111010111110111011101111111011012112111221101101a01111022122102110001110111111110010101101011222012122202200b2202221122022
11110111111111111101001111a10011100111110100010101101111110011010110112111120011112022b11202202020112111111111111111111111010111100102112222022222a2222021211222
11111111111111010110101111a01111110011111111111110011111111011111110111111111111010111a11111011111110010111001100110011111100101111111100012111211a1212211111111
11011111111101111111111100a11111111111011111011111111111011111011111110110110111110101a11111011111111011111011111111111010011111111111112011122211a2120221212111
11111010110011111111111110a11110111111111011011111111011101101111001111111110011101111a11111011110111110110111111111111111001111111011112001122112b2110212110020
01111101111011011011111111a11101111101111110101110110111111110110010000111101111111111a01111111011111010111011111111111100100011000111111211002211a0020100011012
11111101111111111110111101a11111011101111011011111111111111101110111111011111111110111a11111111011110110111101110011111111111111101111112022111221b1020111100110
11110111011111101001011100a11111110111001111111010101111111111111111111111110111111111a11101111111111110101111101110111100011110111111110121222121b0122122210201
11010101111111111111101111a11111111110111101011111110111111100101101111010111001111010a11111110011111011111111111001011101010111111111100211110202b0122210112222
10111111111111111001111111a11111111111111110111110110111111100111011011111101111011111a01111011101111011111101101110111111011110111110111101202012a0012222201011
11111110111110111101101110a11101011111101101111111111011010011111111101101111011110110a11101111101111101111101111111100111111011111110111121120221a2121120221022
11111111111101111111111101a11101101111101011101100111001111011111111110111111110011111a11111111110110011111111111101111111011001111011112110102222a0221202110221
10110111010111011011111110a11111100101001111011111111011000111111011001110011110101101a11111111111110101111101101111101111111011111110101221121200b2012111001211
11110110101111111010001111a11011111111011011111011110111111101001111111111111111110111a11111111011110111101101111101101111111011101111001222222212b2211212011011
11111101111111111111101110a11001011011101111101001010011011111111100011100011111111101a11111011101011101010111101011100111111011111001012202112021a0212002222121
11111001011111011011111111a10101111001111111101111101101111110111111111111111111011111a11111101011101100111111101111111111111011000101110202222021a1201121102211
01110011110011111111110001a11111111111111111011111111001111011101101111111111111111111a11110011111110111111101111101110110111111101111112212012212b0112211120201
11011111100111111111101100a11111111011001111111001110111111100011110101111111111011111a11110111110011111111011111111011110111110011111111011212122a1011212200201
11111101111110111111001101a10100111101010101101111011111101111110111110111011111111011a11111111111111011111110110111010111110101111111111120002121a1100211120220
10101101101101110111101101a11011011110111111111111111111111010101111101100011111111111a11111101101011011111111011010001110111111110111112022102112a2200222202120
11011101111100111111011001a11111111111110011101111111011110111010011111001111101111101a11110111011110111011110111101111111101001111001112020020120a1122012021221
00111110010111111011101111a11111101111011111111001010111111111011111101011111111111010a11011111111100111111111111111011100111111110110111210222222a1221211101122
11101111101111111011111111a11111111101001111110111111111011111111001111101011101001111a11110111011111111011111110100110111110011110111110210022210a1202221222020
01111111110111111110011111a11111111011111111111111110101111011101111011111110111111101a11111101111111111110111111010111101111101111111112211222221a2100221122011
11011011111010011111101111a11111001001111110011111111001111101111111111100101111111101a11111100011111111111111010011011111110111110111110201122111b2221201222021
11110011111011111111111111a11111110111111110001101111111110110111111010111111110111111a11011111111111111110111111110111111111111111111111020022211b0222002220112
11111011111111110111111111a10100110111111100011111010111111111101011101011011111110111a11111011111100010111111100111111111121112210200122212222022b2221210011202
11011110111111101111111011a11111011110111110101010111011010111101111011110111110111111a11101111010111111110110100101110111122212221222021211202211b2220112212111
11111111011111111010111011a11111101110110111111001111111111111111111011111111110010111a11101111111111011111101111111100110021121101121202002221222b2121211122210
11011111101111111101111011a11101111111111001111111111110011011101111110111111111111101a11111111111111111011001111111010100022221101012221102012221b2122220111111
01110110111111111001111111aaaaaaaaaaaaaaaaaaaaaaaaaaaaaaaaaaaaaaaaaaaabbbbabbbbbaabaabb12012022211211111101111110111001111111101221201012012022010b2021110011111
11011110111000011110011101101111111111001011111111111111111110110111122221210211111122221212221112220011111111111111011011221222112220012110121001a1220210111111
11100111101111011111100111111100011111101110010011111001100111111111102011122012212111110222111201101111111111101111111101221201022111211112102102b1212001110111
11101011011011111001110111111001011111101111111111111111101011011111120210121020210011212202220112222021011012102201110111111222110121001222102212a1122011101111
10111111111101111111101110110101011111101111111111001111111111111101122120212022022221212222202212122112120121002120100110121111022102210211221201a2000111011110
01111111011110111111111010101101110111001111011110010111101011111111120210101212121102221201020222002212222101221001111011002222022111211011001222a1221111110110
11111100111010101011101111111110111011011101111111110111110111111010111210000211021222222022222122120121212012120220101010201122021012211211221212a1222211001110
11111110110111010111110011101101111111010101101001110111010011111111112210211022221122222222222222022101011100210121101111022212111122211221200122b2211011111100
11111111111101111111111101100110101001111111011111111110101111011111021111211211021222212022022120211011211221022221110111211212221201001101210210b1122221111001
01011111111101111011011111111001101111111111111011111110011011010111112122010202012102211200120220001212020221002101111010021211012212121112222111b2121121111110
10111111101110011111111111110011011101101011111111010110100111101111020011010122220112020101222222221201112121220111100111122120210012012210212102b2112210001101
11111110111111111110111101111111111011111110111111010110111111111111121121112122222102220222002012121201120121221211011111221221202210201221210111b1222120111111
11011111111111111110111111111111110111111110101111111110101101110111122221101111011122002212222212021212101012012020111111210221222121112111122220b2120111011110
11001010111010110111111111111101111110110011111110111111011111111110120221220120100122212222202122221120021121121211110011121221021021122021201112b1112101101110
11001111110111010111111111101011011110011101111111111101111111111111112222211211021222210222201110201212111100201211222002202022222212012110122111a2120211001110
10111111111111110110111101111111101100111101011001001000111111111001111021202122000021021102122212211122212202221101122211202221222111220202121211a2111221110110
11111111100101111111011111111101111111111101111111101011111110101110120121012202110020002222222222220222220221002020211211002222121201102201022101b1112201110101
11110111111101111111011111111100111100001101111111011111101101111101121011120112222120102220202110202222201012202122121221212112210102122221112001a2021210001110
11110010110101110111111011111110111111111101111011001110010011111111101212221122021000220202122222201222212221222222011101211121211102022022212011a0012210110111
11101110111101111110001101111111110101001111111101011110111100111111102020110221202122221222022222211021122100022001101221121102222210212222220202a0202121111101
aaaaaaaaaaaaaaaaaaaaaaaaaaaaaaaaaaaaaaaaaaaaaaaaaaaaaaaaaaaaaaaaaaaaaaaabaaaaaabbbbabbaaabbbbbbbbabbbbbbbbabbbb20212200121202222222102222122220120a1221211111111
11111111110111110001001011101011111001001011100011001011111110110111110202122111121212220020212222102200022222b02000012011001121122111120002212222a2111221110111
11010110111111111101111111001011011111101111111110111111011111110111122122111220201220122022212122122210212221a22221201021220202022110212112111121b1112101111111
11101111111011111111100111111111110101111111110101010111011111111111111111212112122122202222212221220111212222b00200020212202002222021201122212211b2102210111111
11110111110111101101111110100111111111111111101111101111111011122010221022122201222212222210122112222111120222b22201202200221020221001222122011100b2221221111011
11111111111011111111111111111111111111011110111111111110110100121121122221222212012120222020022222222201200201b02220101212222222112212222111120010b2122110011111
11110111111111111111110101111000011111110101111111011110100111112202110222121222212002012020121222221220112022a01200211211020220200111212222221112b1202111010011
01111111111101111010110101111111001111111111111011101011110110022212022002212122221022022212221102020102221202a01220212122122011002110111111111111a1111110111111
01111111001100111001110110111111111001111111110111011111011111102211122022112221220022110222220201120112002222b22021221222011112111111101111111100a1101111111011
10111111110111111111111101111011011011110111111011111111011011121112222221212222110222222020211212212222100210b02101011011222022111111110111111111a1111111111011
11111001011111111111110110111111101110000111111111010111111111022002111011220222122122100122122202220222022220b12201211210122122222111101011111111a1111101111011
11111111111111110111111111011111011111101110101111111110111111001212010120112110212122002220021221121122222021b20202002122202221111111101111110111a1101111111011
11111111111111000101101011111111111110110110110111111111111111112011021001121012112022120222222112110220221222b20211202212100211210111001101110011a1111111111101
01111111111111111111111101111111101011001011111101111111001111122211110211121211121222212201220112122212222112b11212011211211212011110111111111111a1111101111010
11111111110111110101111111111111110111110110011001111101111011111211200222200112101201202020221111011211221122b20211201120210202211111111101111111a1111111111111
00111111110011111101111111110111111011111010110111100111011001121012120110212110221111222202001110111100010111b12211112112210212211111111111111111a1110111101101
10111111011111011110110111111111111011111111101101111111110110020221022222110222101212122110121111112022221101a21201212101012210012111011111111110a1110111001011
11111111011110001111111111111010010110111111010110110111111111102010121110121200212101212211121011110221022021b22210021200122121112111111111011111a0101110101111
11111111011111111111010111011110111111011011111100111111001111122201211112012220212111001111121001112011212002b22112122001222212111111111111111111a1111101101101
11110111110101111111101011111110001111010111111111100111101011111221121011111121221012222221211111111221112010b12120011112211222122110101110111101a1101111101111
11101110100011111110110111111111110100111111110111010011100111122121200120222212111222111120210110112021201212a00221002101020010100101111111011111a1111110111100
10011111111111111110111010110110101110111111111101011011111111102222112112022021211012111110021111112210202212b21212122221111110122110111011111101a1010111110111
11111111111101111101111111111110111011111111111000011111101111122102010220222222012011210021221111111222202111b21120212012112222100111111111111111a1110111111111
11111111110101111011111111111001111111111111111100101111111111112202101111110022121200111120120111102122120021b12000112211211122020111111111111111a1110011011101
11111111111111111111110111111011111111111111111101111001111011111121121222020010002212111012211011111111011211b12112211122011212111101101111111111a1111110000111
10011111111110011110100111111111111011111011011111111111111111121101121211022222010122002222011101111111111111a11111111111111101001111111110111111a0101111111110
aaaaaaaaaaaaaaaaaaaaaaaaaaaaaaaaaaaaaaaaaaaaaaaaaaaaaaaaaaaaaaabababaaabbbbabbbbabbaababababbbaaaaaaa111011110a11110001111111111101001011101111111a1111111101101
0111100111011011111111000111111011111111111111101101111111110111111120111112002010111121121012000010a111111111a11111111111010111111101111110111110a1110111111001
1111011010111111111111111111101111011111111111111101001111111112212010112102210022202122001211111111a111010101a11111111111111011011111101111111101a1011111111001
0111110111111111000111111010110111001110111011111111011011110010120001221020112002101021101121110011a111111010a10111110111111111111111101111111101a1111111111111
1111110011100111101111111111101101001101110011111101110111010112001220021011101201211221002112011111a111111111a01011111110111010111110111111111111a1111111110111
0111111111111110011111110010111111111111010100101111011111111111121211111121201011212022010201111111a111111111a01101111101111111111111111110111101a1111111111100
1101111111111111111111111111111110001111110001111111011111111111210212121222120021110222121221110111a111111111a10111111010111011111111011111011110a1111110101101
1111011011001110011101111111111110111101011111111111101111101110212211112212212111111011212212101111a111111110a11011101011101111111111111111111011a1111111110110
1010111111111101111010111111101111111111101101111111011111011112200210100112022022111101112010110011a111111111a10111111111111011111101111110011111a1011101011011
1111111111011111101111111001111111111111110111011110001111100110011111110011111110010011111110111000a111111100a10111111101111011010111111011111111a1111100111101
1111111111110101111101011011111011000111110111101111011111111001111101011110111111001101101111111111a111101111a10111111111111111101111010111111111a1100011111011
1010111101111110111110111111110111111110111101111101101111111111011101011111000011110111111111101110a111111111a11010111011111111111111011111101011a1111111101011
1111111111111111110111001001011011111111110111101011111111011000111110010101111101111111101111101011a111011111a10110101111010101011111001011100111a0011111111111
0111111101111101110111111011101011101111110110011111011111101001111111111111101001111101111111111111a111111100a11111101011110011111101111110011100a1111111100110
0111001011111001111111010111001101111111101111111011101001100111111111101101111101110110111011001111a111101111a01110010111011111111101111101010111a0111111111111
