2 75
143 55
78 98
151 42
145 5
137 70
84 74
99 77
115 88
85 8

111011111111111111101111111111111111111111101111111111011111111111111101110122122210121121111222122101111111100111011a11101111111022101a221211202212210002120121
100101100111111010111101111100111011011101010111011101111010011111011100102110021201112211111111211111110111111111111a10111111111112011a201021021012121001121122
110111001111100011111111111111111110101011111001111100101001111101111100222201222212112112110212222111011001110111111a11111110111012212a112022212212202102211202
011111111110111111110111111111001011111111111111110111111011111110111121200120111212101120022221211211111111110111111a10111111111020212b122021110212120122212012
110110111101111111111111101100111111110111111111111101111110110110110111112212221222021200112222211211111110110111111a10100111111022112b102021101122121212222221
111111111101011111101110100011111011101110011110111111111100110100110122210111210221101012111212112111001101101111101a11111011111121212a220212221220101002011121
111111100011110111110010110111110111101111111110111110111011111111111121120212111020102221111020212011011111111111101a10011110111122112a122200102222211022122011
011110111111110111111111111010111011111111111111111111111001111111111122221211201121121111011221012211110111111111110a11111111111110012a112221110211010112011120
110011110111111010101111111111111111011111111111110101111111101110110122011121102021221111210220222221111111011111111a11111010111111122a221110221120121211112102
011011110101111111111111110011111000101111110111101001101101111111101111120202122101221121021121110121101111011111111a11111111111112221a101222021221212000012021
011111110111111111111111111010101110101110111110111100111111110111110111010220221112112102112201000121111101011101111a11111110110112210b112120122221122002211211
101011110111111111111110111111111110111111110111111111110011111011101122011220121121221122122001220211111111001111110a11101001111122212a122111121201220111202102
111110011111111101111111000010111111111111111101101101011101111111111121210222221012111110221111211101111111111111010a01100110011020111a201220211210121220111101
100101111111111111111110111111111101110111011111111111011110111011110120101102010222121112201222101001111111111111111a11001111001101121b011000011201102211222022
011011011111111011111110011011101111111111111111111111111111111000111120211012121221212221110102202201010111111011111a11111111011021211b111211202110122020111122
101111110011101110011111011011110011111011101101011101111111100111110111212220012111121121022221210221111111101111111a11110011111111121a110122121022202112011000
000110110111111011111101111111011111101110110111110111111111101111101021212102100122122210212221020121011111001111111a11111111111122222a122120221111221202122100
111111111111101011011111101111011010111111111111111111111111111011101112010212111222202002210211111121011110111111111a11110110110121222b001202202121121112222021
101111111010111111111111111111101110011111111111111011100111101111110110202111121011212221122012122221011110010011111a11111111111012111a122121022200212010001211
aaaaaaaaaaaaaaaaaaaaaaa1111111111110111001011111111111101111111101111112112220220221222011212110021111101110111011111a11011111010120102b201221211022211012120211
1101111111111111111011a1100111111111111011011111110111111111111111111002202112202211102021212121122211111111100111101a10011111111122101a212112211212012112200112
1111101111110111001111a0111111111110111110111011110100110101111110111112221102220022211102002020021221111111111110111a11011111101120111a100122222011101101000110
0111111111111111111111a1111111011111111111111111111010111111111111101102101121120111211221201222212010111100111111010a11111111011120021b021212212111121221112121
1011011111101110011111a1111111111011011111010110111111111111111111011122201220222121120110122222101021101111011111111a10000101111111121a122211022020112210020121
1101011111111111111111a1111111111110101111111111111111110111111111101122212000222101210121001122011011011110111110111a11111111101111212a000100211212101221102210
1111111101111111011101a1111110101111111111111111111110111111111111111120221022221210111101122211221010111111011111110a11111111111112211b011101010110100021222102
1111011101101110110110a1111111011111110011111101110111111101111101110110111111202221211201210221021211111101111101111a11011111111111122b012112021221122221111122
1110111011111111010111a1111001011111011111110011110011111110111111111101201121121100221112112022121101101011110111111a10110111111110202a022222220222222211220022
1111111111011101111000a1111111110011011111111110111101010111111111101012122122222112222221011212022011111111110101011a11111010111121212a022121022202222220220021
1111111111111111111101a1100110110111111111111111100111111111110110111011110111012101212221021201211221111010110111011a11110101111121011a222222202020102222001222
1111110101111111001111a1110111110111111111011111111111111111101110011120202221111222211211210102112210110111111011101a10111111110102000a002200222222222020220201
1011111111111101010111a1100110111111111110111101101111111111011111101110110111011101111111001011111111111111111111101a11111111100111111a000110021211112110122111
1101111011011011111111a1111111111111011111111111110001111011011100111111001111011111111101101111010101111111101111111a11111110101111111a111210201021222210121012
1111111101111011101110a0111111101111111111111101111101111010101111110001111110111111111111011111111001011111111110111a11101111011111011a122112111121021220122121
1111011011111111111110a1111001111111101111111011111011010111111101101110111110111110111110111111101111001100011010111a11100111110111100a122202021120212122101112
1111111111111011110110a1111101110111111110111110100010111111100111011111011011011101101111111110111111111001111101110a10011101111010111a110102112201220101111122
0111011111011111101111a1111011110110111111101111111010010110110101011111101111111111111111101111111111100111111111111a11111110111011100a110020221120101022202222
1011111111101011111101a1101110101111111111111111010101111101011111011111111111111001111111110111111111101001111101111a11111110110010111a022112202202202121112222
1111111110011111111110a1001111111111111111101111100000111111111111111111111111111111111111111111101111100101101111111a11111011100110110a121221221111111212220020
1111011101111111111111a1111110010110111011111111111111110101111011111101111111111101011111001111111111100110001110011a11111101110111110a101222222121012102111212
1110011101111111111011a0100100110101111111110101011111101111111111110111011111110111111110111101111110111111111111111a11111100111111111a010222022122121212001121
1010101100110101111111a1011011010111101111101111111011101011010111011111111110111111111100011110101111111111101111111a11011111011101101a102101120212120200101122
1111110101010111100111a1111111111111001111111111101101111010001111110111111111111111111101111010111111110111111111111a11011111111010111a012111012111122020001011
1111111011010111101111a1111010111111010111111111111011011011101011001010101111111011100011111101111110110111111111111a11111111101111111a201121100122122112010201
0111100111011100101111a1101101111111001011001111111111011101111111110101010111101111100011110111111111011111101111110a11111101001101111a002122202122212122110121
1111101100011101110011a1101101111011111001000101111110111111111111010111101111011101111111011001111011111111111011110a10111111111110111a111211210100212201110122
0111110111010011111111a1111111111101111111110111100111111111111111110000110010011010101111111110100101111111111011111a01011111100111111a110101112021021211001210
1111111111111111111110a0110011011001101111111111101111101111111110111011111110011111111101101011011101101111111111111a10111111101111111a210102110220121110200022
1111110101110101101101a1111001111011101111011101100111111111111111110111011110110111111101111110101111101011011111111a11111111101111111a120120212101220011122112
0101101111101111111111a0011011101110111111111111111111011110111111111111111011011111111111011101101101001111101110011a11101101111111111a012201121221110101221011
1101110111110111111111a1111100111111001111111011111111101111111101011111111101111111111111111011111110111111000011111a11111111111111111a221212102221110221121120
0101111111101111111110a1111110111000001011111110111111011110110011101111110111111101101110111111011011001110111011111a11111111111011011a202222120121212211222112
1101111111111011111001a1111111111010111111110111111110111111011110111111110111111110101111111111111111110100111111111a01111111111111111a002012112221122220111012
0101101111110111100011a1111110111111111101101101110011111110101100111111010111001011111101110111011110101111111111011a11111111110011111a121001222212212222201120
1110011111111101011101a0101111110111010111111101011111111111110111111111101111111111111011111100111111101101111011110a11111101111111111a221221002222020212110101
1111010111111111100111a1111111111111111111101111111111111111011101101011111110111101111111111101011111111111111011011a01110212112120212a121222110022022212222211
0111111011111111111011a0110111010111111110111100101110111111001111110111101111101111111111011111111001111110101111101a10112200112212011a212212211222222221221211
1111111011111110111111a0001111111110000110111111110110110111110011111111001111011111111011110111011011111101111111111a11011112220222102a221022012112200222220202
1101100111111111111111a0110011011111111111101111111101111011101011111111101111111111011111100111110111011111111111100a11112012020022002b011222101121221201111111
0111101010100111111111a111aaaaaaaaaaaaaaaaaaaaaaaaaaaaaaaaaaaaaaaaaaaaaaaaaabbaaaababaa111012101102011111101101111111a11111122011102122a211220212112102121110111
0111110111111111101111a001a11011100011110111111111101110111111100101111112120120001212a222210220020211011111111111111a11110020221221112b122001021200201021111101
0111111111101011111101a111a11011111111111110100110111111110001101111101212202222022122a022021221012211110111110111100a11101102122211220b120110021111211211110110
1110101111111110111110a111a10101011111011111111111111111111101011100100121002221211121a202222222122021021222112001111a10101112220120211a022002122212220021110111
1111011111111111111010a111a11111110110111111110100111111111111011011121011220011112021b210220222202122011102111111101a11011222212021112b121222202112010101110111
1110011110111111111110a101a11101111111111110111111011101111101110110121221002211210220b102222122010222120010211112011a11012021221201000a012111011212022201111101
1101110010111111011111a011a11111111111101110101111111111010111011011100001101021211022b000122120211122111211211012210a11112202122011212b210200121211221221100111
1011111111111111110011a010a11111110101110111000111111111111111011111002000020222022022a001120102222211212211222212101a11110211210221222a111022121122112111111110
1111011111111111111110a111a11011011111101011110011111101111011111001100111222112111000b001102022220211011212112022111a11110221102212220a022211110122212211100101
1111111111011111111111a111a10111111111111011111111110110110111111011022112112022211102b022222222112201212222012221011a11110102112212121b210101021021221110101111
1111110110111111111111a010a10100111111111111110110011111011110111110022012102122012121b211220100222201021222022111111a11112212121222121b222210021001112211101111
0111101111111111111011a101a10011111111111111111101010111111111111111102112021120210201a220220100220211102220122122210a11111112212220111a200221211020212111111111
0100001101111111111101a110a11111101101011101111110010011111111111111122102111221100112a212222222222012120120012212211a01011120120222221b211211210211220121111101
1110111110111111100101a011a01010111111111111111111101011111111011101120202222000212222b122122012102101021212221120201a11110110202211201b122011121221212111111110
1111100111111010111111a011a11111110111111111101111111111111111111110111220221112221220b211002122112222220222022202112a02122022202221222a002012200001212121111111
1110101111111101111001a111a11111111111111111111011111111101101010111012112012212221102b122220022222122022210221122021a21122100211000212b222222112220111121110110
1111101101111111110111a111a11101001110011101111011111111111101101111002121211221112022b222221210211220220212000022211a12211021202121111b111202211121211121111111
1001011111011101011111a111a11111111101110111111111111110111110101101111220210102202122b220210210220220102222222012222b20220000220211221b121211012222011110111111
1011111111111101111111a101a10111111111101111110001001111101111111001111022211011121212b020120120212112212222222111221a01112111002011210a212222221112202201111110
1110011111111111101111a110a11111111011011110111110011000011111111011022210021122120122b212222220222221222201121122222a11012222021222110a211111202211211220111111
0110111111011101111111a111a11111001111111110111111011100111111111111112100112221211222b222222022222121212120222221222a22020002122202212b212021222222000121111001
1001111111101111111111a110a01111111111011111111011111111001110111010122001221011211222b222020120112222222220022122112a11022110222201012a221011111112121201011111
1111110111111111110111a111a11111110101110101111111111110000101110101122222112110010120a211122202022221222210222222211b02222222210212121a100212121202111211011001
1111001111101101110111a111a10111011110111111111110111111011011011111012111101011210221a200002102212022122020222020211b02111022021222011a102021021121111211101111
1011111111111100111110a111a11111110100111110101111011111111111011121021222222200122222b022022221012211221212002201211a12112221202121210b110111021112212021111111
1111011011110101011010a111a11111111110110001111111011011101101012201122120121202020002b221222200212112200201222100211b12222012022212112b120212212110200110111111
1101001101111111111011a111a01101111111110111111111111111111111121112122212212201212021b221202222102002022222022020002b21122121202022012b110121222110011201101110
1100101110110101111110a111a10111111111001111101111010011011101102121222222222210220022b222000011222020222022022112021b02221222000221111a111111101111111111111110
1110101110111101011111a110a10111110011111110111111110101111111122012122211102221221021b222022111202122120012202212222a11212101010221110a110111111111011001110110
1101000111111011111111a111a11111110101011110111111111011101111020210122021222022220020b222010202012202222122222212102b10221210221111111a011111111011101111111011
1111111011111011111111a111a11111011111101111010111111111111011112121022112220022201022b222222222000200022202121222112b21102202111221111a110111111011101110110111
0011101101111101111111a101a11111010101111101111111000111111110022121102210110200210011b102002200112122022202021200012a01001211212010110a111111110011001110110111
0111111110010001111111a111a01001111111011111111101001111011111110220201001102220111222b112001210222212212020212110021a21121210222221101a111000110111111101110111
1011111001111111111000a011a10101110111111111111110111111001011121222012121122111101120b122220012001120122022222220211a22211112102200111a111110011100111011111110
1110111010111011111101a101a11011110001101101111010110111101011120100222122222212212211b212210210111111020012122110121a21220121110011101a111101101111110111010111
0101011101111110111111a101a11111111110110111001001111110111010110021022120111212122121b211121010111111221111001202120a11211210221221101a001111010111111111111111
1101101110111110101111a100a01111111110001011111100110101010011101002010221221222211011a112011011111112012122001100211b21200011210211110a111101111111111111111111
0111111000011101111101a111a11111011100111011111111110101011111022000202211112220111211b001021101111112011111102122222b12111221011001011a111111011111101111111111
0111111111111111111111a111a01100011111110011111110101111110111120221121011110100112211b122122011111110022222122110110b21211121220121111a110111111101111111111111
1101111101111011111111a111a01111110111111101101111101111111110111221100111112121202110a020112210111120211001111111210a10111221102221011a111101111111101111111111
11aaaaaaaaaaaaaaaaaaaaa110a11111011111111111111111011111110111111212212010202120100221b022212201111101122100210011201b10221212121211011a100111111111111111111111
11a11010111111011110001110a11110111111101100010111111011111111111122111222021212102210b101212111111112122110021111200a20110102212201111a101110111111011111101111
10a11111111111111110111111a11111111110111111111111111111111111120110011122221002020221b122202111110110022012012211111b21111212220021010a101111111101110010101001
10a11111111011111111111010a11011111111111000111111111111111111121221001221200112222112b221212111010111002121220221221b22010221200011011a111001011101001111010111
11a11111111111011101011111a11001111111101101011111111110111100022010201122110122211120a112102111001112121221111002112a21222220220210101a110110011111011111111111
11a11111111011011101111011a01111111101111010101111011011010110110022112201212221111221b120122000111110101110101001111a11111111101111110a101111111111111011111111
11a11100001111111111111111a11111100011110111111111011111011111101110122212100002202011b022221201111011011011111110110a01111111111101101a111110111111110110111111
10a11110101111111111101011a11111111100111101111001110111111101122121100221121221121111b021101101110100111101111110011a10110111011110111a111111111101111111111110
11a11011111111111111111111a11111110100111111111111111101001111001112122202212102112221b221021011110110001011011111111a11101111111110111a000111011111111011101110
01a11110101111111111011100a10100110110111011111111111111111111111001111102021101212100b110122010111111111111111011111a11011110011011110a111111111111001111111111
10a10111101110011111100111a01101111111111101111010111111111111022222010102111222212211a212002201111111111110111011101a01010100111111100a111011111111111101010111
00a11110111111111111101111a11011110111100011011110101101111111121122222112121102101101a212120111111111001111101011111a10010101101101111a111111011110011110111110
11a11111111101111001011101a11110111111110101111111111111111111121220111022110212112211b212202000111111101111110011111a11101011111110110a110100011111111010110111
01a11111111110111011011110a11100111111011111111111111110110111100122111122021221022211b220021011101110111111011000111a00101010111101111a111111011100111111111111
01a11111111111101010111101a11111111111110100111111001111111110021212122201112001200001b212210211001011110110011101101a11110111111101110a010111111111111101111111
11a11100110111111100000111a11111111101111111111111111111010101111111001111011111111111a000111111111111111111001110111a11111111101111110a110110111111101001110111
11a11111111111011111110111a10111111111110111111111011111111101111011011111111110111111a111111111111101111111110111111a10111111111101111a111111010010101111111001
11a11111111111000111111101a11110101001111111100011111100111011111110111111111111011111a111111011111111101000111011111a10111111111111111a101111011101011111111110
11a11101010111111011111011a11111011110111111111100011111111011110110110111111111111011a100111101110011101110101111111a01111111101111111a111011111111101111111110
10a00111111111110111011111a11111111111111110111111011101001101110101111111111011101101a111111111100011111111100111111a01110011111001110a110111111111111111111110
11a10111110011110101011011a11111111111110111111101111011011101101101101011011110110111a101111111111011111111111011111a11011100111000101a011011111111111111111011
