2 8
143 24
78 98
151 42
145 5
137 70
84 74
99 77
115 88
85 8

11111111101011111111111111111101110110111111110111011011111101110010110102001112100111212121210220011111111110111111111110111111011210011202b1101122112122221110
01110111110111111001111101101111111110101011111100101111111111111100112021102012111110101122000122021011111110111101111010111111011220110221b2022120022212002102
01111111110111101011111111100011110110111111111111101101011111111111111201221001110110122212021020212101111011111111011011111011111202110111b0102120202200012021
aaaPPPPPPPPPPPPPPPPPPPPPPPPPPPPPPPPPPPPPPPPPPPPPPPPPPPPPPPPPPPPPPPPPPPPPPPPPPPPPPPPPPPPPPPPPPPPPPPPPPPPPPPPPPPPPPPPPPPPPPPPPPPPPPPPPPPPPPPPaa2211112102110212111
10P1110111111010111011111111111110110111111111111111111111111111111011210021121011102210211211121112100101011110111111101111100101221110102P11111122102212002211
01P1111110110111111111110111111111111111110111110111110100111111111111221102201202212121020210101001200110110111101101111111101011222202210P20101121121212022121
11P0111111101111111110101111111111111111110111101111011111111010101111022202012012221121011001211211211111111111111011111111111111022112021P21022112110121112221
11P11111101111111001110011111011011111100111111111001111111110111011100122220200212121111021011111221101111110011100111110111111110201000222P1112121111011112212
11P111101111111111111011110011000110111101010011011010111111111101011122122212112112201012020121212110111111111111111110111101111122012221022P200121111201212211
1111110011111101111010001111111110011001001100111011111101111101011111122200212111101111020121120121211111110111111010111111110011102122101020P02221100100120222
1011110111101101111111011111111100110111111111111111101111111111111111011212121121212221121210010122211111110001110111000111110111211211212212P10122111221000221
11110100011111110111111111111111111011110010111111011111111111111110111110112202011210122110100222221111111101011111111111101111112222121222220P2012022212011001
11110111110101101111111111011100111111110110011111100111101111111011112000211111001121202212122122111100111111111111111110111111111121221222212P2212221221211212
111111111001011110111101111100110111100111110011110111011010111010111122102102020211121212022212022220111111111111110111110110110101222111222112P212221021012221
111010010110110111111111111101111111111101000111110111011110011111111101222222221122112122121211120211011111011011010101011100111120110222012222P201102112112211
111111111110101110111101101111001101111111111111111111011111111110111121122211210111112221012211121211111001111111100101101111101121121111112221P012011221111221
101011011011010110111111111111110111100111111111011111111111011111111001120110220212121220102112211121111110011111111110101110110110210122221021P021121111222010
11111001111111101011111010111101110111011011101101111111111111111111012001201221212212211222101012021111101111111111111111111101111221211112202P0001221112201200
11011000101101011111101111101001111101110010111111011111101001110111011122212212122110200122010221021110111110110111111110111100111122101222201P0222200222022102
11111111110011011011111111011111110011011111101011111111111111111111011121122212011012121120012221122111111101111111011111111111110121122112112P0222121022002111
11101111111111011010111011110111110111111111111111101101111111111111112122201212122212211002112202000111000111011100111100110010110121111112121P2222212112110111
11111111100111111111111111111111111110010111111111111111111111101111112111011211111212012111222012120101101011101111101111111111112102112120202P2222221012122210
01111011011010110111010010111111111111111011111111101101111011110111112221122121121220222012112111222111000101111110111011111011111202220212110P2021221110211222
01101110111111111111111111111111111111111111111000111111101111111001111011222121202011121222222210121111110001111011111110111111010121221222220P2012020121102211
11110111111111111110111111111111110111111110000100111111111111111111112112012111001111120112112112112111001111111011111110100111101121222210022P1201122001002120
0101111111011111111110110111111001111111111100111011101011111111101101201220211210200001221002012120011111110111111011001111111110112120212221212202222121212110
1110111111111011100111111111111111111110111110010111110110111111101101100111201222212122101121211220210100010111110001001111111011112112112201222021212210022112
1111001111111000011111111110111110101001110110111010101111111111001111221222022211121011221121020110111111111110111111100111011101111222111002211202202222001220
0111111100111011111111111111011111111110111101111111101110100011011101221220220102202021201100011122211111011111110111100111111110112111102212112200220122211220
1111111110111111111111011111110011111110101111001011101101111100111101120121122211111022111201112111011110111110010011011111111110102112200102221211211222222022
1000011111101011110001110111111111111011111111101111101101010111101111220220121022222121212121101012211111111011101111110110101101110222222121201221222201221022
aaaaaaaaaaaaaaaaaaaaaaaaaaaaaaaaaaaaaaaaa10110111010001110111111111111111000111101111111110111111111111011111111011111111101011111111110101120222012102102021112
1111111111101111111110101111101111111111a11111101111111111111111111111111111100111101111110001001011111101111101111111111111111110111111111001021211221112120012
0010111001111111011111011011111111111111a11101110010011111111111111111100111110111111111100001110111111111111001101111110101101110011111002021101222202201012111
1101011100110111111110111011001111010111a11111111111111101011111111101111101111111111111101111111111101100111111111111111111111111101111112210100012210221212102
0111110010001111111001111111011111011110a11101111101110111101111111111111001111111011011111111110111111000011111101111011101011011110101122220100122210122201222
1101111111111110011011101011111111111111a11010111011101111111111111101101110111111111111111111101111101011011111111111111101111101110111222010121101222122221122
1011111111111111111010010110010111001111a10011111111111101111110111111011111101111011111111110011111011101011111111100011111111111111111011201212200220022201112
0000101111111111111111111111111011111011a11111111111111101011111101110111011111111111111110111010111001111111111000111111011111111111111212212122110211112101221
1110111111110111111101111101101111111111a10111111110001111111111111111111111111111110111111110111100101111111111111111100101111111100111202101000010200101120202
1111111111111111101111111111111110111110a11111111101111110111111110111111111010101011111111101100111110111111111111101100111111111110111110222211021121200212221
1111111011011111011111011011101111111111a10111111111011011101101111110011110111011001111110011101110011111111101111110111110001111111111222011020212122222022122
1111111011011101110111111101111111111111a01001101110011111111111110111101111111110110111011101110110110110101111111111111111110111111111102122100121211111222221
1111010111011111011111101101111101001111a01011011110111111111110111111111111011101111101110101101111110111111011111111101110111110111111011110112111211122100100
1111111111111110011111111101111111011110a01111111100011111110011111100111111110111101001111111111111101111111101111111011111100110111111122111222110220220122021
1011111111000011100011011110000011100111a10110010110101111111110111111010111100010111111011111111111111110111111001111111100010011110101111222220122210011221112
1101111111111111000111111001111101101111a10111011011111101111101110111011111011110111111111111111011111110110111111010111111011110110111111212012221211200111222
1101101111111111011111111011111101011111a01111110101011110111100111111111111111111111111100110111110111101111111011101111110100011101111021221121101122021012111
1110111111011100111111111111101010111111a01111011011111111111111010110011111111111111011111101001100111111111111111010110111011101101111221220212021211110111200
1110111111111111101111111111111101011111a111111111011111111111101110101101110101110110011011011111001111111111111101111aaaaaaaaaaaaaaaaababbabaababbbbaaaababbab
1011111110111101111011111101101111111011a111111111011111100111111111111110111111111111111101111111111111011111110001110a0011110001111111221112012212020121212210
0101101110111111011111101011111111011111a101111011011101111111111111110011111111001011111010101111111110111111111111101a1111111111111011110022002122200210021211
1110011111111111011111111110001111111011a111000011110101111111111110101110111111101111111000111111111111111111010001010a1011111111111111012210212120221022120222
1111110111111101011111110011110111111011a011111111111011011111111100000111011101111011110111101011111111111001100011111a1111111110111110210010111011112212202122
1111111111111111111111101111111111101101a101111111111110110110011110100111011111111101101111111101110000111011010111101a1011101110111111101100100120121210111121
1011110110111111111111111001110100001111a111111111111111011111001111011001011011111010111111111101111111111111111001111a1011012112100122222222122221110021000000
1110110111111111101110111111111111111111a111110111001111111111111111110101011101111111111110111110111111100011101110000a1100102012222121121202122222222221112122
1111110000111011011011111111011111011111a111101111101011111111111101111111111110111111101111111111111100111111101111101a1111112120212102222222222212220122110210
1101110111111111111011111110100110111101a110011111111111111110101110111101011111111111111100010111111101111111110111111a1011222200011011221211100020022221110111
1111111011101011111110111101100111110101a101111011111011111101011111122112220201221221212012001122011101111111111111111a1110221222202101202211010112221211011111
0101110111001110101111110101110111111111a110011111111101011101011111111212112112111200211001012122220110111110101111111a0001121220211100221121100111021221011111
1101111111101111010111110011111011101110a110111101101011001101110111110120112121112122210021122012211011111111000111111a1102102222102020001201121011112021111011
1100111001111101111011011101111111011010a011111101111101101111111101011211021111102002222212021221202122222212121211100a0122222012000210111122111110022121111110
1110111001011011111111110111100111111111a100111100101100110001111111111011212122110002222222212220021121212210122221011a1112222122221111112212112211101120111111
0111101111100101111111111111111110111111a010110111110111111010001111121122212121202102220222222122221221111122102110011a1011212221112221211011121200201021111111
1110011110110111111101111101111111111111a111110101111111110101110110122102000202022112212101201201222222210211201121101a1122221021111021122210200212112221111111
1111011110111011010111111011111110111111a111111011111111010101111111121001122112010220211022222221122111112222220211111a1111201121122021222111101222201111101111
1111111111111111111101111111111011110010a111111001101010111111101011020211112210111112021022020211122022221122212001111a1021121011222221000212110001002221011111
0111111011111111111111111111111111111111a111111101111110111111111011112211102200222121221012222122122111200021212121110a0112022120221212221010112121200221111111
1001101111110111111000001111111111111011a111111101111111110111111111022110120010221220221121222022200211112111121221011a1012211111212222111201020021222121111011
1111100110111010110011111110111111101111a001111011110110001100011111101022112001220001101221222022211221100122220201110a1102110122221220112221222220021101111110
1111101111011111101101011111111111001111a111111011111111011111101111020201221102202022022012120122221121112022122201111a1112111122022211210211002202212111100111
1111101100111011111111101111111110111111a011010111111110111101111111011020212122222212022121222102222212120011022221111a1020222202220111220021112222010121111111
1111011011111101111011111100100011010111a101111111111111011101111011102122120121120202221122222212222222221202211221212a1222222002021112221012211222101111101111
1001111011111110011110111111011110111111a111111111111111111011011110110010222111202102222211012222202221211222222201112a0222121222201121120101120211202111111111
1111111111110110111110111111011111111111a111110010111111111111111011021202000022221122201222002000120212122122211102202a2121222222222221221212111122012001011101
1101101111111111111111110111101111110111a110111001111010101111111110121110111211022002201222111020102222002220022202001b1121220100021201210102111121111220011110
0111001111100011011101111010110011011110a101111111111111011111100111021220102122102122221220101122122222211022012220102a1112220102201222102211112212121111111111
1011111011011111101111011111101111111101a111011011111111001111111011010200000122201002210212220221202212222122122201210b2022221212222210202122112101112101111011
1100111011111100111110111111101111111111a11111111111101101111011011012210110112211212202022abbbaabbbabbbbabbbbbb0000111b0122002222121202221102002212211211101111
1101011111111111111111111011111111011011a00111111111111101101111111112110101212211112222102b2102222222222220222b2222211a2222202012200101110102222121222101111111
1110110110010110010111101110111101011011a11101101111110111111101011100101221122122022220122a2222220022112122112b0222010a2220122222222212100112021102210111011001
1111111111001101001111111110111101111111a11111011111111011101011101112202102021201012202022b2121202221022202122a0221202a2111012222122121211102212112111011101111
1001011111111111111111111111101111101110a01011111100111111111111102122222222222222220122222b2220112201222221021a1201121b1122222222212221221122211011122111111110
1111111111111111110011101111001111111111a11111001011001110110111122221022120101220222222021b0222222222222222212a2002020a2121221002012021112121220011121021110111
1111111111111111111101111101101110111111a01011100111110111110001212202122122001022222122222b1222221122222202222a0220222b1121121221221222211010121122110111111111
1110101111110010111101111111111101111111a10111100110111111100112010121112020012222110222202b2222222122022122220a2222102a2112120221211110111111110111101101111111
1110110111111101111111111111111111011111a11011111101111101011112012120212122111222222202200b2220122222222222012b0121022a2120112101110011010111111111111101111001
1011111101001111110111011011101111111011a01111010101111111101112210112220100122222200221222b2211022210121201110b1221222b2010222212111111111110111110110111111011
1111011011111111110011111111011111111111a10111111111111101111111000212211212111201221122020b0200202022202102202b2202200b2121222202111110111aaaaaaaaaaaaaaaaaaaaa
1100101110111110111111101111111111111110a01111111111001111101011221112111222111102202121222b0202212212020222210a2121201a2121112121111111111a10111101111111111010
1111111111010111111011111111101110110110a01101011011011111111111102211110201221202021200222b2211212222112102222b0221120a2212121201101111010a00011101111110111110
1101111111110111111110111001111111111111a10010111011110110001111201111111101121121221222120a2222022112112221012b2121122b0122221020111011110a11100010111111011111
1110111011111111010101111110001111111000a11000111111101011110111210102211222112022211121211a0211111011112112022a1220211a1210021112111111111a11111111111101111011
0111111111010100101011111100111011110011a10111101011111111111010211112111110020221212121110b1101011112012111102a2021201a1112201120111111111a11110011101111101111
1011111110010110101110110111111111111011a11111111101110111111111022012022010201022010211011a2211111122201200122a0121121a2121000021211111001a11001111001110110111
1111111101111111011001111110101111111111a11101111001111110111110202020221021111200201211201a2211111121212121001a1021221a1021211111011111111a01111111111111111111
1011011110110110111111111011111101101111a11101111111011110011112112012122210022111122022111a2211111111211021121b2122121b2022012212001111110a11011111111111011111
1111110111111110111110110101111111111101a11111111100101111111111122100111212011201121222111a0001101121121210120b0211112a0210111211111101111a10111111111101111111
1111001111111111101111101101111100111110a111111111100011011111011020222bbaaababbbabbbbbbbbab2211111121201122222b2220012a1021022120201111111a10111111111100111101
1101100001101111011101111101101100111111a110011011011101111111112122112b201221120220210120102210111112012212111a1101012a1222010201110101111a11101111111111111111
1011111011111101111110111111110110110111a111010111010111111111000220202a112200121122111202102001111012102221112a1210221b2212002211111110111a01111110100111011111
1111101111111111011011111110011111111010a010111111111111110111120211211b100021020212010212221201111000101110111a2222212b2122211212211110011a11010110011011111111
1111011111010111111110011111111111011011a111111101110111011111112122111b212102111022211221110111101122121220211b2121120a1212212112111010101a10001100110111110111
1101111011011111011111101001111111111111a110101111111111111111020201211a111110112101122021121100100111110011101a1111111a1111111111111111111a11101101011111111011
1111101110101111111110111111111111111101a011111111111111111010012211212b011112002022122112120111101111110111111a1110111a0011101111111100001a11101111111011011111
1111110111111011111111101111111001111011a011110111101111111100102122101b110101211222212112221010100110111111111a1110110a1101011111011110111a11111111111110111001
1111100111011111110111011011011111111111a011000011111111111111001212221b102220001101112010122011111111111110111a1110011a1010110110111110101a11101111101110111010
1111010111111111111011110101010010111111a111110010011111111011122102021b211220102012121110112111110011111011111a0101011a0100001001111001101a11111111111111111011
0011111111111111101111111111110001011011a111101111111111010110120011222a210101202100022220212211110111101111111a1011111aaaaaaaaaaaaaaaaaaaaa11111101111011101110
1011111010110111101111111011111110111100a101111111111101101111121222201a101212220121221011012011111011011001110a101111111111111010110111111111110111110111111101
1011100111111110011101101111111101111111a101111011110111111101111110122b211021201121222112010101000111110011111a111111101110111111011111111101111111111111101111
1011111011101110111111110111011111011011a101111101111110011101110112210a222202220100122110010111111110110010100a101111010101011100011111110100111111111111110010
1111011100111110111111111010100111111011a011101111011110111110122122121b202100110001122211211101111111111111101a101001111010010111111111110111110001111111111011
1111111111111011111111010111001111101111a010111001111111110110001111110a111101111011111111001110111011110011011a111001111111101111111111101011110111110110101111
1111110110000111011101111111101111111110a001111111111111110111101101111a111111111111101111111111011111011001111a111111111111111111011010111111111111111111110111
1101111111111111011111111111111110111111a110111111111011111101101110101a111010111010110111101110101100111111111a100111111111111111101110101101110110101111001101
1111111101111111011010101111111101111110a111110011111111101110111101111a111111011111111111100111111111100111111a100111011011011011111110101111111111111010011111
1111111111001111011111111111111111111111a011111011111111101011111111111a111100110001111110111111111101110011111a101111111110101111111111001111011101111100111111
1101100111111111111111111111011010111111a011111111111111111111110101110a111111111111001010111111111111111101010a101101111111011111111111111110111111110111011101
