155 68
7 78
78 98
151 42
145 5
137 70
84 74
99 77
115 88
85 8

1111100111011011101111110111111111111001111101111101100111011111101111112001112112102021111112022111101111111101001111111111101001101221110120001102021222012121
1101100111110011110111111111111110111110101111011111111111111111111101110202221210121111210222020111210101111111111111111111111111211110111211201222202002120002
1011011111110011111111101111111111111111101011011011011101111110111111110211212110211212101212120222011111111111010101110011011111112112111222122111112110211211
1111011011111101011110110111111111111101110111011110110101110111111001220011211211021110011111112220111101111011111111111111101111211221121211221211222201122110
1111111011111111011011111111011010111011001111111111110101101101111111021221101220211221222120012212201111110111101011110110011101221022122010122222122222112111
1110111101101111101111110100111111111111101111111111111110100100111101222212110202110212210111112011211010111101111111101110111111122010222202122111002202111011
aaaaaaaaaaaaaaaaaaaaaaaaaaaaaaaaaaaaaaaaaaaaaaaaaaaaaaaaaaaaa111111110020211100222222100112211212212011110101011101100111010111111021120112122112221001110211112
011011010111001111100101110111110111111111110111111011111111a110111111212122211022111002210011220211111110111010111011111101100001010101221220011110021120222221
111110011111111111100011111111010111111111111111111111110100a111111101222111200121211221021101212111211111011111111111111111111010212221011222211211012121120201
100110111111111001111111111011011111111110100111011111111111a111111110102220121120121021102112111221211101011111111100111001111011022022110121211122111211022220
111001100001011111111100000111111111101111111110111101111111a011111111210100121221102102120211201112111101111100111110111111111111001122111122022211222200212112
111101111111111111110011101100111110001110111110011111110011a101111111222102120221110221222010211221111011101111001110111111111011121101111011222221222100012211
011111111111111111111111111101111111111111111110111100111111a011111101112120220111220102222102111212010111111101111111011100111111211202110111101200112120220211
111111011111111111100101111111111111110001111000111101111111a111011111111222221221211200221201102221111111101101011111111111111111101212012201122001122210121212
111011010101111111111101111111010111111111110111111111101111a111111110112120012110200101111002210212211101110101101111001011111111212022121211012021021222111021
111111111111111111101110100111010111011111001111111011111111a101111100022102202220020001111220211112011001111100111111101111110111121211211111121121121020120221
101001011100111111111110111011011010011111111111011011111111a011111101122121122102220001122002212112211011111010110111101110001011222221111101021002010221002011
111101101111111111111111010011111111111111111010110011111110a101110111011221122220112101220221022020011111111111111110110111111010212101211101212210122122122110
111111011000111111111111101100011111111111011101111111111111a111111111221112221121001220111210201112111111101101111111101101111111101221101221000101211202212210
101111011111111011110111011011101111111111111111111111101011a110101111001222022222222112121022111212011111011111011101011101110011112211012020212221202122222200
111111100111011111111110110111010101111111010111110011111001a101110011121022021121211220222211002120111110111110010011111111111111121210112121211022012110222212
101111111100111110111111100110111110111111001000011101001101a111111111211112022111111211111221111120101011001111111111101111111011211112220112011211012021122202
111101110111111011110111011111011011101111110100111011110011a111111101112122221120112220200010022120201111011101011111011111111111021100112121122121111002101111
011111011101011110111111111111011111111111001111111110011111a111111111022220222121211022212111200222001111011111000111110011111111220212212202212100210012220111
110111101101101111111010111111111111111110101011111011111111a111111011021201111110101201021101022002211111101111111111111110011111001211212110222021120112122222
110110111101001111111111111111111111101111110111111001111011a111011111222221011111122012120010212202211110111101110111101110101100210011210212111111110211212121
111111111111101110110111111011011011011011111111101101100111a111011101021111012210210112111022021212001111111001111011111011111011022212221212221112121201111122
111101111111111011101111111111111111111111110100010111101011a111111111121221111102221011001122112202011111001111110111101111110110112221200022202102202122222220
111011111011111111000111111111101111100111011110011111111001a111111111220112011212202122100111111212111101001010111110110011111110012112010122012122222202210122
101111011011111111111111110111111111000100110111110111110110a111110111022112222121000212022202110211211111111110111111111101010111000022222122200212201211121202
111111001101111110111111111110111111111111111000111110111111a111111010212212212222011222110121102011211111111111111111111010011110122201220201122122002212222000
110111111111111101111111111110101101110111101111111011011111a111111110100011111111111011111101111111110011111111110011011110000110111101202222200021122011212111
111111111111110110110111111110110110111111111101111101111101a101111111111110111011111011111111001111101111111111111001111011100111111100121102211220121211111110
110100011011011111111111011101111100010111101111101111111011a101111111011001101111111000011101111111111111111001111111111111111010100011001101211221121112122120
110111111111111101111111111110011111111011111111000101111101a101111111110011111101101111111111111011110111100110011011101010111110110111121211122212221212102101
111110111111010111111101111111101100001111110111111011111101a111111111111111111111111101111011100101010110111101011011111110100111111111112112022212122212202120
111010011111111101111111111111111101111111111100100100100110a011111101111100111101101111101111111110111111111111111011011111111101011100002101012221211002110100
011110111011011011111001111111111111011010101101111110111111a010011101110111001101101011111111110010111111110110111111111101111111011100222010221102111210222012
111101111111110111111111110111110110100011101110111111111111a111111111101011111101011111101111101111111011111111111111111111100101111111101210212210121212211212
111111111001000110010011111111111111111111101111111110111111a111111111111110101111001101111011111101101101110111111111111111111111111111022110011122012210112210
111111100111111011101110111101000111111111111111111111111110a111111111111110000111111111111111111011110111110111101111111111111111111100122212211222111222002221
111111111010011101000111011111111111011111111001111101111111a111011011111110111110111111111111111111101111111011011101111110001011111110222122102122112120112111
011011010100111111110101110111001110011111111110111101101111a111111111101111111111111111011111111111101011011011111101111111101110111010020200221220222211122122
101111011111111111111111101000101111111111100111100011111111a111101111010101011111111011110110111101110010111111110111001010111111101111111112122112111211211121
011111011100011111110111111011111111110111110101011101111111a111111110110111111111011101111111011111111110111011011011111011101111101111012220122202011112012220
111111111111110111110111011101111111101110101111010011111110a111101111111111110111111101111111101110101101111111110110111101101011011101201211121212202121100120
111111111011111111111111111010111110111111101110011011111111a111110101110111111011111111111100011100101111101111111100011111111011111111200121012122212102110112
111111111111111111111111111111101010101111111011011011110111a110111101111111011111111001111111111101011111111111111111011111111011111111012121000121110212102210
111011111101111101011111111111111111101111111011101101111011a101111100111110110111111101111111011111101110111111110110101111011101111111111102222211110112112221
001111111010110100011111111111110111111111111011111111111111a110011101110111111111110011011011111111110111101111111101110111111011110111222202202222222212001210
111101001011011111110111111111111000101111011111111001111100a111111101111101011011111111110110111101101110111100111111111111101101011111022210201111220011111010
111111111111111111110111011110111111101110111011111111111101a110110011111101011111111010001111111110101010111101111111100111011011101111001122002202221101120001
111111011111001111111111111111111111111111101101111111111110a111111111101101110111110101111111111101111101011101101111011111111111111111222222102112112122112212
111001010111110111011101111110001110110111111111010110111011a111011111011111101110011111111111111110110110110111110111111111011011111101001212010120100121122022
001101111111011111111111011111010111111111011110100110111111a110111011010111011111100111010111111011101111110111110111110110111111101111210111121222212102111110
010101011111111111011011111111111111111111101111010110111111a111111111111111111111111111111011111111111001011111111111101111221121211212122021222221222222211112
101111000010111000111011111111111111101101111101111011010110a111111111111101101111000111101111101111011101110101111110101102222021121222200212022220212022201112
111111111111111101111111110111111111110101111101111111101111a101111111110111111111111111011111111111111111111101111111111011220221112111212222212222122021210122
111011111111111111111010111111110111110110111111101111111011a111101111111111111111010111011011100111111111100111111100111102122121120002222202121221211121111111
111111101111011101111111110011111111111111111111001111111111a111111101022122011111112002212211122011111111110111111101111111201222200221011211201202020121101111
011110001010011101101111101111111111101111111111111100111110a100001102112010212212102212001121011002011111110000110111011101201102111021012112221221021121111101
111101111111110111111111111110111111101101111111011011111110a011111112010100122110221212112122012110111110001111101110111122121021002101101201222022221220111111
111111111111111110111110111011111110011111111111101101111011a111111101010122222011012122000210102020222212121221012110101101221221111202212221112221101211001011
111111111011010111101111111101011111111101110110110111111110a101111110221112010111201222202022100212202102220122212111111122112212211221122020102112120211110011
011111110111011110111000100111111111111111100001111111101111a111110111111100102221001122022222222211101211201121020111010110020221111011211222120022101201111110
011111110111111111111111101011111100111011111011111111101101a110111110121200222022002122122022212102211220202111221011101111120111012112210120122211212121101110
aaaaaaaaPPPPPPPPPPPPPPPPPPPPPPPPPPPPPPaaaaaaaaaaaaaaaaaaaaaaa111011011120002211121211212222022222012110120002101122010111121111011000112211111122010221111111111
0111111P111010101111101101111110111101P1101101011101110111111110011110101110021002021222222222020222101222201122121111111121011210121201001122122111210021111111
1011111P111111101110111111111111110111P01101110101111101111111101110121221112211121201221020012212222121012122120010111111112122222222101010021111000012010P1101
1111101P111001110111011111111111111111P1011111101101110011111111111111211211101111011212022221112122122021121120011111111022221022222211221222121212111211P01111
0110011P011110111101111111101101111111P1111111111111111100101111111112020211201000100112202122002011122001200202211101101122201110112222112012012212211111P11110
1110111P111111111100111111111011011111P111000110111111101110001100111220220112220112102221211222122212021121220111111111111211212202121220102102101112212P011111
1111101P100110111110001110111111111011P01111111111011101110101110010121121122112212120122202222222210221211211122211101011221220110202121201122202012022P0101101
1111111P111111111111111111101111111111P11111111011010111111111100110111201112212122201212212212122122222202212120222201122220012012222212111120111221111P1111111
1100111P1111011010111110001111111111101PPPPPPPPPPPPPPPPPPPPPPPPPPPPPPPPPPPPPPPPPPPPPPPPPPPPPPPPPPPPPPPPPPPPPPPPPPPPPPPPPPPPPPPPPPPPPPPPPPPPPPPPPPPPPPPPPaaaaaaaa
1111111P0110110111011110111011100011111a111111011111001110110111111110210011212211221211202102221012221222020102221121010220001200111121002022112220112111111111
0111111P1011110101111111101101101111110a011111101100111110111101011112102210002222110221222220222222201012211200222222221222112221202110210121201102121011111111
1101011P1100111101101111111111011110110a111111111011111111111001111111112100122222112122222221020022202221212222122012220200222122222222111222010221120111111111
1111111P1111111111111111110111111111111a011101111101111111110110111112202121211110212202200220120222202221002022111121222212222020012211222122222112122221011011
011101111010100101111111101111110110111a101011111110011111101111111111122bbbaabaabbbabbbbbbbbaabbbbbbabbbbbbbbabbabaaabbabbbbbbabbabaabaabaabbabaaabbbbabaaaaaaa
111111101111101111111111101111111010110a101111111101111110101011111010211a02211121012221102212122122120212100222220202212210222202220120222220222222112111111111
011110111111011111101111111111111101111a110101111100101101111111111101211a01110111112012122222012222012222002121020221122222122211221201202021121111122220101111
111111011111101111111111111001100101110a011101111111100111011111110111101a21200212022220000022202021122122022022022121111112122102202012122112101201122021111111
111111011111011011111111111101011010111a111101111110101110111101221021002a20000222012222020222222022222011120222120012121121022222122022102122102122011021111001
011110101111001101101111101111101111111a111011101011101101011010220012200b20202002100220222022212222222022222221220221111122201221212021200200102012022121111111
001011111111111011101110011111101001111a111111111110110111001111212112200a12021122222122222200222222200201022221221011211122222222222221110010222221111001111101
111011111110110011111111111111111100111a101111111110101011111111212102201b12222221200202222222220002222222021020222122221112212120101111111111011110010111111111
111111111111011111111111111111101111011a101110111111111111111012110022222b02222222022202222212012222222102121222022121211201201001011101011011110011111110110101
101111111011101111110111111111001111111a111111011111000001110111021112222b02210222112222202002221202222222221021222200022002021021011111110101011111111110111111
101011111001101111110111111111011111011a111101111011101111111102112210222b10201121221222121221221022122202212021222012122021211020211111110101111111101111101111
111011111011111110111011111110111011111a111111111111111111111100210012112a21111211102221201222122112200100222222011022011210222022211101101111111111110111011111
011111111110101110101110111111111111101a111001011110100111111111111101211a21100111210202022212222222200212212202122101102012110202210101111111111011110111011111
111101101111101011110100111110110111101a111101111111101011111012111121022b21000222121122222022201220222222222202222111101111102101211100111110111111111101111111
101111111111101011100111111111110111111a111111111101111111111111122210221a0110111010011120000211010aaaabbbaabbbaaabaababbbaababaabaaaaaaaaaaaaaaaaaaaaaaaaaaaaaa
111111010101011100110011111110100111111a111110111111100111111102112122120a1120112221220121121110111a022221002211200201222012122220211011111101011111100111110101
011001110111110111111101101111110111100a111011110111100111111102201001112b1021012112022211121201111a021211011021121222101220102121010111111011111011110111111111
011100111110110111100100011110101101111a101111101011111001101112111210222b2022011112022011100101001a212101110022011102121122011211011111100011110011111101110111
111111111111101111011111110110111110111a110111010111111010111111110121121b2012111202212122101111110a221112202122121121221110221102100111111011111011110110111111
110111111101111011110101111101101111110a111111001111110111001111111222112b2112111201202112220211111a122020212201011100112112111112211111111111111111111011100111
010011111110101011101111111110111101101a011111101111111011111111122212211b1201211021112202201200011a001121202122220221112010122112111111011110111111110111111111
110111111011111111111101111111110110011a111111111111111110011111012221110a2222121111101221121111011a201221121222112101212221011020010010011111111101111110101011
110111110101011111111111101111101111101a110001110111010011111011211111201b1111011112221121100211111a220111011011221012222120102222211110011001110110001011111111
111011110110111011111011001111110111111a111110111101111011111112200202122b2222122012112211022111101a222120210122221011101211120201111111111011110011111111011100
111111011111010111111110011110110111111a111110111010111011110111102001222b1220021202102211112010111a221221120211220221222012101110201011011111011111111111111011
111110101111111111101011101111111011110a111111110111101101011110002212121b2021222112222001202211111a101101111111101111010111111000111110111111101111111111111111
111111101111111111111111011011001111111a111110111101111110111112002122222a1222122202221121210211110a001111111111100111100111111101111011111101011101001111100111
110111111111111111111111101101111111111a011001110100111111101012111200012b1110122122012221201011011a111111111101111010111111101111011110111011111111111101111011
111001111001011110111111111111111110101a111011111111111101110102021122200b2211211101111111121211111a010111010111101111111111111111111111111111101111111111111101
001111100101001011111101101111111111111a011111111110011110111112212201201a0202112211022101102211111a011111111111111011111101011111110101110110111111111111111111
111110111111111111111101010111111101101a001110011101111110011100112122122b2212101022222122011011111a111111010111101111111111111100111111110001110111010111111001
111001111001111111111110111010010110111a011111111111111110010101022121111b1102221112220101000110011a111111110111011111100111111111101011011111111111111111011111
111111110111111111101111011110101101111a101011001100111111101110111101002b2212012101022222022111111a100111111111000111011110111101111111111111011111010111101101
111111100100101111111111110111111111011a111101111101011110101110201212202b2211220120120121022111101a111101000111111111111110111111111110110111110111111111011111
110011011101111100110111011111111011111a011110111110111111101101201122210a1221122021110011201211101aaaaaaaaaaaaaaaaaaaaaaaaaaaaaaaaaaaaaaaaaaaaaaaaaaaaaaaaaaaaa
111111110111111111111111010111110111111a111111111101111110111001111011101a11100110111111101111111111110111111111100111111111111110101011101111100001011110111111
101111111111110011111111111101111101110a111111111011111011111111111101111a11111111111010011100111111111011110111101111111011011011001101111010111111111111110110
101111111011111001110011101010110011111a011111110111111110110111101001111a11101111011111001110111110110111101111110110101101111011011011111101111111111011101100
111110111010111111110111111100111111110a111101111111111111011111111111111a01100101100111110011111011110111110111111110111110111111111111011111100101111010101111
011111110111111110110111111111001011101a111111111111011110110101101110111a11111111011111111011111111111111111110111111111111011011101111111011111011111011111111
111111111111101101111111111111111111101a111111110110111011111111001011111a01110101111111001110101110011110101010111101110110011101111101101111111111011111111111
