85 16
107 109
78 98
151 42
145 5
137 70
84 74
99 77
115 88
85 8

1000111110111100a1111011111111111111111101111111011111010011011011111101111112012211112001122022a202b1111101110011111a001111110111111101210110211211112211210212
0111111111111111a1110011111111111111111010111111111101111111111101111122110111110202221021121211a120b1111011111111111a110111100111110212112201112200021201222121
1010111111111111a0101110011101011011111011011011110011111111011111101112110200212212111221211000b210b0111101011110111a111111010101220222112211022220102021202212
1111111111111111a1111100111101111110110111111111111100101111101011111111012210122211122101220221b020a1111111011001111a111111110110020122022222011201000111211020
1111010111011101a0111111111111011111111111011010111010011111111111111120112022211022121120202121a202a0111111111111011a111111110111020011210120121222120101202110
1111011111111110a1011111001101111111111111111111101111101111111111101112222120011212102102222111a212b1111101111111101a111011101111101111221221110201102122101200
0100100101111111a1011011011111111011110111111111000011110101001111111120212211112020121202112120a112a1111111001111110a111001110111222001010112202122112102212102
1110011111001110a0101110011011111101011101011101011111111011111101111022212112111112001111110122b110b1111111110101000a011111111101121021110111021122121120120221
1101111111111110a1110010111111101111111011100111110111111111011111111112110111020122212112212111a121b1000101111111111a110111111111222212112101011212212012110020
1111111101011101a0111111111111111011110111111011111111101001011111111111002122210012021211101022b210b0111111011111111a101111111011202222122200112022020111222221
1110101011111111a1111011101110111011111111111111101110101111110100111120121111121200201010111102b112b1011111110111111a111111111111122122212212222021212201101211
1111111101001101a1101111011110111111011010111110011010111111111111111112221120012120201201121201a222b1111111111111101a111111101111220012100220121211221212022010
0011111111101111a1010101111011111101111111111111110111111110101001101121221211120211020221111201b010a0011111111110110a111111011011211001221220122011210122122201
0111111010111111a1100110111111110111011011001111110111011011011111110111221202110122110101201200a202a1111101111111111a011111111111211122002222120112112221011122
1101111111111111a1111111110111111011101111011111111110111111111111011100021221012211122122111121a221b0111110111011111a111011101111211211210011121122112021112201
1111111110111111a0110010110111011110100110111111111010011101111110111120212121222221001201000111b112a1111111111111111a111111111111222002222102121211122221021021
0000110111111111a01101111101101111111111111011010101111011111110010111001122110211120P0100112221b112a1101011101011001a1aaaaaaaaaaababbabbaabaabbabaaaaaaabbaabab
1111101010111111a100011111111111111000111111111111101101111110111111110211202212122122PP22102101a112b1111101110101111a0a1111111111012112222222021112100210211102
1111000110110100a11011101111111100111111110110011011111111111111101111201211122210020022P2122222a211b1110111011011111a1a1101111111110121222111221012121022021022
1011101011111110a01111111111111101111110011101111011111111111011111111212212102101112002P2020111a020a1111111011111111a1a1111111111202222021210222220120111211221
1110011111110011aaaaaaaaaaaaaaaaaaaaaaaaaaaaaaaaaaaaaaaaaaaaaaaaaaaaaabbabaaabbabbaaaababPPPPPPPPPPPa1100111111101111a1a1101011111111221220222112111111010110102
1111111110110111111011110101111110111111111111110111110111110110111111012222212201211112220021122211P1111111110111011a0a1111101011221121010001222202112111222111
1111111111010110111100010111111111100110111111110111011111111110111011012200012211111020010121112111P0111101111100101a1a1111101101112120212212221112221122112110
1011011110111110111111110111001111101111111011110111101101111111111011211112010020121122111212220102P1010101110111111a1a1111110101120112121222100021212210210112
1111110111010101111101110111111111111101110111111111011011111110110111122110211121021202201211121120P1111111101111110a0a1100101111210220011111110101020121021220
1111111111110001111100011110011111111101111110111111101111000111011101111112111100212102212110012211P1111111111111011a1a1111110101221120012222222102212121122100
0101101111011110111101101111011101111111110111011111111011110101111111111211012121112211211202221200P1111011111111111a1a1011111111121111212011110012111102201211
1011001111110111101111111100111111110111011100011111111111111001110111221201000202102122211022221102P1110111110111010a1a1111011110211112121212222211002202100220
1011111100110111011111111111111101110110111011100001111010100011111011011212211221111201120221211121P1111111011000011a0a1101101011211210202122221222122200202222
1111111110111111111111111111001101111011111111101110010110111111110111112212122212111200021012211111P1111011110111100a0a1101111111022012110220222212212210221122
0111111111110110111110101011111110001110111111111111111111111111001111011222102121211102112210112201P0111111111111111a1a1100111111122002222222122121222221212212
1111111111111111111111011111010101111011111110110101111111101111011110011110111111110010101011111011P1011111101111111a1a1110111111111110011221221122202210120211
aaaaaaaaaaaaaaaaaaaaa1110001111011110111aaaaaaaaaaaaaaaaaaaaa111111111111111110111101011111110111011P1111111111111111a1a0101111011101111201020222022021120202022
10011101101111111111a1110111111101010001a1111111110011101111a111001111111111111111111110111111111111P1111001001111111a1a1110111010100110102121221111222112121222
10111111110111111111a0110111101111111001a1011111011010110111a101111110011101001011100110110110110011P1101011100111111a0a0111111111111111102001222221022022221111
11101111011111110111a1111111010110110011a1101100111111110111a110111110111111001111011111110111011110P1111011111111111a1a1100111111111111202221122101201002222002
11101111111011110111a0111111111111101110a1011111111111110111a011110101111110011111011111111111111111P1111111100111111a1a0110110100001011100221120222021121011221
11111111111111111011a1111101101111110111a1110111101011111110a101110101111101111111111001110011111111P1101100011111111a1a1111111111110111221112121211112202011221
10110111110111111101a1100110111111111101a0111011011111111111a100100010111010101110111111111111100111P0111111111111010a1a0110110111101011122012220101101221221121
11111110110111111011a0111111010111111111a1011111011111111111a001111111111111111110010111111110100101P1111111111110111a1a0011111111111011210120222221110122212222
11011011111111111111a1111101111111110111a1101110010100101111a111110111111101110010001111111111110111P1111101111011111a1a0111101101111111201212221122122221121112
11111111111111110111a0111011110111011111a1111011111011110100a111011111111111011111111111101111111111P1111111101111101a1a1111111000111101201112202101210201112100
11011101111101101111a1011111111101110111a1010111101111001011a111111111010110111011101111001101111010P1111111111111111a1a0111111111111111022220220201211010221122
01111011111101000111a1111111101111111111a1000101101111011111a111111010110111100111111111111111011011P1111011011011001a0a1111110100111111022121112111201001102222
11110101111111011110a1101111111111111111a1001111110101101011a111111111100111111111110011111111110101P1110111111101111a0a1101111011101111120202222112211102221010
11110001111101101111a1001111011111011011a1101111110110111110a111111111111111001111111111110111111111P0011001111111011a1a1111111111111001010121121122102222221012
11111010011011110111a0111011100111011100a1000011011101111111a111111101111111111111111111111111111111P1011111111101111a1a1111101111101011102121201120201001202110
11110111011111100001a1111101111111111111a1101111010111101111a111011111111111111101001101111001111111P0111111111110111a1a1000101111011111101110201011212101202212
10111100111010101111a1111111111101111111a1111011011111111111a111110111011001111110111011111111110011P1101111110111111a1a1111111111111111202211120221220220012211
11110101111111111001a1110110111111111101a0110111111111011110a011001111011111111100111011110111111111P1110101111111111a1a1010111101101101012110112220120012110011
11001100110111101011a1011110111010110111a1111111111111111100a111111111111011111101111111110110111011P0111111110001111a1a1111111111011111222102222221111112211120
11111101111111111101a1110111101111011111a1101111111111111111a111111111011011111111111101011111111111P1101111011110111a0a1100111111110101211110202102120220120121
11101111111111111110a1111111111111101111a1111101110100111111a110101101101011111101010111011111111111P1100110111111111a1a1101011111110111212100212101122121111122
11011110111110111111a1111101011111101111a1111011001011111110a111111111011101110111111111100110111111P1111111011111111a0a0100111111101011121212001122121022222121
11101010111111111111a0011111011111011101a1101111111011111111a010111010011111111111110101110111011111P1101111101110011a1a1111011111101111010211221112122221122202
01111110011111111111a1111111001111101111a0111111011111100111a111111111101110111111111111110111101110P1111110110110101a1a1112121002210011222121011201022000011011
11111111111011011111a1111100010111111011a1111101101111111110a101111101111111111111111111111111111101P1111111101010001a1a1102212222112222220221201222220121120222
11010100101101111110a1111011110111111001a1101101111011101110a110111101111001011111111111101111011111P1011111111010101a1a1101102200012220202221200012222221011110
01111111111101111101a1111111111011111011a0010111111111111111a111101111111111000111111011111011101111P1111111010111111a1a1111221221012121100222111122212001101111
01011110101110111111a1111111101111111011a1111111110110111111a110111112212122112110110211212211221111P1111111110110111a1a1121101021202222111001022210220100010111
11111111011111111110a1111111111100100111a1110111111111111111a101111011112020022222212122122101021222P1111110111111011a1a1112221222222112120002112012202121111111
01111010111111111100a1011111110111101001a0111111111100101110a110110112101001122211210221211112021021P1110111111111111a1a1121012010121102010221210220101121011011
10101011101011101111a1111110101111111111a1111011111110111010a111111112100121201120212022112222122222P1121112110011211a1a0120001011112121212112222122121021110011
11101110111111111111a1001111000111110110a0011111111011101111a110111111212112211211110211022222201002P1012112211112210a1a1122202120011011210212001222120121001111
11111001011100111110a1111011111111111101a1111111101111111111a001111112222211102210000211201222022200P0001100221221211a0a0102122112112211101000112000112201111011
01011111101101011111a0111111110111111111a0001111111100111011a111111101212122012210200202222120122202P1201101122121201a1a1122221010000212011110112001221111110111
11111111111111111011a0111111011111011011a1011110101110110111a111011011110212211212212121122202222122P1112121222122011a1a1121120120121221210121112120012120111111
11111110110111111110a1101111001101101111a1111101101111111100a011111100121111001101202220002010122222P0111112121100011a1a1122221222021201221222110102221021111111
11110110001111111111a1101111011111110111a0111111101111111011a101110011012212022112121122220221202110P1202022201122210a1a1100211222222121122100211221222101011111
11101101111101111011a1111111111011111011a1010010101111101111a111011110122112212201122222011102022202P2012101202220011a1a1022212101212011112111110221221211111111
11111111101100111001a1101111111010111111a1110110111111111111a011110112111211221212012212212102202222P1111211122212200a1a1121212221212202111102222122111201111100
11110101111110001111a1100111111111111111a1111111111111111111a111011012212112111202000220122202211220P1112222121102111a0a0102102222211221212212121221211221111111
11111111011110110110a1011110011111111111a1111111101010111111aaaaaaaaaaaaaabbbabab2210222122111120122P2222101012201011a1a1002211011101202210112211210220201101111
11101011111111110011a1111110111010110111a011111011111111011100011010010202221212a1102222221222200222P0222121210212202b2a0102212212221210221121200112120221101101
11111011100111111010a0111101111111111101a111001111011111101110110111112111021010a2211022120122121220P2220120222210221a2b0121221011211221211111111212122101111001
11111111011111100111a1100111100110111111a111110101010111100111111111122020102012b2012202202120211202P2212222122121211a2a2122202222210001100101102001212221111111
11111111011111110111a1110011001111111011a011111111010111111011111111121110110102a0211202212221222212P2201221220122211b2a0122222022222122022221202210221121010101
11111101111110111111a1111011110111110110a111101000110110100001011101120012010102b1112220122220222120P1110021202202110b1b1122222022102122211212221221201211111101
01010001111101111111a0100111111011011001a111111101101110111111110111102212212011b2102222222122200222P2021010212221001a2b2222122000121221112120222221101201111111
10101101101111011110a0001101011111111111a001101111110111111111111101102212121022b1212210212221222022P2222122202221211a2a1120222222202112100122112121111211111111
10111111111101111101a1111101111110100011a111101011111111100111111111010220111110b1210102220121120022P2121222222201221a0a1212222201020021120202011222222121001111
11111110010111001111a1111111011100111111a111111110111111011111111111112210212111b1210120202222002222P2212222222222100a1b1102222222220022212102221211121200111110
11101110111111111111a1011101111000111111a111111101011111111101111101101212211020a2211122222212102012P2100221220000200a2a2212222210102022112101110101121221111111
01111111111111111111a1111011111111011011a001110110110010011011100202222122212222b1222202210002022022P2222112222222222a2a2122112122210102110221221111200220111011
11000110111111101100a1011111111111111111a110111011111111110011120100100110121211b2120022202220011222P1121212022002121b1a0222002202221102111002011121222221111011
11111011111111111111a1111111111111101111a010110111111111111111121121222212222222b2210200022202020221P1122222002201212a1b0202211122221201202201001112001011101111
11111111111111101011a1011001111111011111a111111101111110111101110211222011212220b1222202221202102222P2220222222221100b1a1211101211211100101111111101111111011111
11111011101111011110a1111111111111111111a100110110111110101111121222222222210001b2222222222222222022P0121222022212121a2a2211102221001111111111101111111111101101
11111111111111111101a1100010111111111110a111101111101111111111112220022221022222b2220212222122112220P2200221121200111b1b1111200210210011111111111011111111101111
01111111110111111111a1111111100111011011a100001111111111110011101212122220221221b2202222222202121020P1022011212112211b0a0220221200111111001011111111111110111111
11111011111011111101a1111111111111110111a111011111101100111111020202220212101221b1212222200222111111P2221012022222012a1b2121112111201110111111011111111111111110
11111110101011111111a1000111111111111111a111011011111111011111101112111222011000a2210221202022111211P0211222212122211b2a0012020120011111111011100011111111111101
01111111011011011011a0111010110101110111a111111111110111101101110202121101220211babbabbbabbbbaaaabbPb2100222122211221a2b1122112201111101111011111111110111111010
01111111101110111111a0011001001101111111a1101111011111111001110001122221210202002211111222220211011P12221112122102121b0b1222212212211111101111111110111101111111
01011110101111111011a1111111111011101111a0100100110111111100111121012202221222122011112112120111011P21122011221202120a0b0221222121201111110111111000111101001111
11111101110100110110a0111011011111111001a0111100101111110111001112001210111211201221122212121110101P02002102011222221b2a1011111110211111010111111111111111101111
11111011111111100101a1111110001001010111a0111011011111111011001111000201110202121102222111211111101P21211110211221121a0b1212201111111111101111000111111111111111
11111001011111111111a1011011010111111000a1101111111110111001111201110211012202122211020120222200111P21022220121100111b2b2021012121111111110101111011111101111001
01110011111111111111a1111011111111111111a01100110101100010011111112122221012020201220111221201111010P2011212001021212a1a1102120112011111111111111011111110100001
11111011101111011111a1011111111101111110a11111111010111011101012122022020211200021110101211210111aaaPPPPababaaabaaabba0a1211122121211111111111111111101111011101
11111111111011110101a1011110111111010101a10000011111110100100110211112121201122110211200222211111a112011P22211120222110a2211120212211111111111111101111111111111
11011101011111111011a1111000111111101111a00011111011111111111110102112001102110211222101222211011a101012P10102222110221b1012211112111111110111101100101011101011
11111110011010111010a1101111110011111110a10011011110011011111111112122221100102012122112122220101a1102200P2111211202022a0220212122211011111111111011110110110101
11111111111111111111a1101111111101111101a10111110001111110110112111112122002221202222112101000011a01201012P012220220210a1102100211111101111111111111101111011111
01111111111111101111a0111111111010010011a11111100011010011111112112101122212112002000021112111011a111111110P11011111111a1001111111000111111110001110111110101111
11111001100110011011a1111101111101111100a11111011111011011111102210021012211011102221221112222001a011110011P11011101111a1100111011101111010011110010111011111001
11111000111111111111a1101111101101110011a10100110011101110111112112000020011202122022022210222000a011101111P10111110111a0011111111111111111101111011101111101111
10111010100110111110a1111101111111111011a11110111101111111101111020112220111212021221222012102110a111111111P01111111111a1010101001110101111111110111101111111110
11110100011111111111a1111111111111111110a11111001101101011111100121212221012120222212020120212100a101111111P11101111111a1111001111111100111111001111101111110111
11111111111011011111a1111110110001111110a00011111111011111010102120112212220020111202121222022011a100111101P11111101111a1111111011111111101101111101010111011010
11011010110111111111a1100111111111110110a10111110111011011111010022122112222121022221212121112111a011111111110101101111a1000111110111111111111111011111111111111
11011010101111101111a0111111111101111110a11111011011100111010100100121221111222222101102110110111a111111110110111111111a1111101111011101111101111011101110111111
11011111111111111111aaaaaaaaaaaaaaaaaaaaa11110111111111111101111002222222011122221112211211012110a111110111010111101011a1111100111111011111111111111111111110111
1101111111101110001101111111100111111101001110011110101111011101121220222110011121122122102210111a011001111110111111011a0111111111110011111111110111111111111101
1011101111011111111111110100001111111111111100111011110111111101010111001111101111101110011101001a101100111111101110111a1101011111101111111001101011110001111111
1101011111101111110101111110111111111101110110111010101111111111001110111111111111111110111110111a001111111111111111111a1101110110111110111110111011111111111110
0111011100111101110101101111001101011101111111111111011111001110111011101110111111001111101101111a111111111111111111110aaaaaaaaaaaaaaaaaaaaaaaaaaaaaaaaaaaaaaaaa
1100111111111011111111111111111101011101111010101111111111111111110111101110111111011111111101111a11111111011101111111111111111111011110111100111111111101101111
1111111101101111111100100111111100111111111111011111111111110110011101111111111011111011110111111a00010111101110111111011111110101111101111011110011100010110011
0111010111010111111111111111011111111110111011111100101111011110110101111111111111111101111111101a11011010111111111111111011111111111111111110011111111111101101
