66 2
42 101
78 98
151 42
145 5
137 70
84 74
99 77
115 88
85 8

111111111101111011111111101101110111011011011111111111111100a1011111112111220101a12212212122021021012101111111011111011111111111112211b2112221211211121222011211
111101011111011111111111111111111110111111010110101111111111a1111111111120112120a01120111220111012220111011111101111011011011111100222a1221111221212120200211121
101111111001110001110101111011110010101110110111111111111110a1110111110011212101b12112211022022221220111001110001111111111111101111221a2212212121001221222021022
110011110011111110111101111111110111101101111111110111101111a0101011111011112222a20121200222101211221111111010111011111101111111111100b2211211220122201122020211
111001010111111111111111111110010110110101101010111101110100a0111010112222102202b12112121211102121211011011011101101101101100111112221b2110211121002122122202121
110111111011101110111000111111110011111111111010111111110111a0011111102001012122a21021210012110010201011001110011111010111111111111120b1112222220121122220010010
111101111001111111111111011010011110111110111110011111011001a1101101112220221112b02112012222111221110101111111111111110111111111111202b0122201112112110201111021
111111011111111110111001111101111111011111111100111011110101a1011101112200001222a22122101120101120112011011110110111111101011111001201a1121222121120112222001010
111101110111110011111111011110111101111111110011011111011111a1101100111111112212b12121111121101121112110111111011110111110111111112102a2110021112221212122210122
001011110001111111111111111110011111111100000111111111111111a1101101111221111101b00212111002222012212100111111111111111111101111112012a2011122211210110101111201
111111111111011101111111111111111111011111111111111110111111a1110111111221211001a22011212001111221202101101111011001111101101111111221a2121212022000110122221210
111111100111111111111110011111111111111110011111001111010101a1111111112200201120a22212122111101022111111101101111011011111110110110222b2201121021210210221211222
011101011011111111111011111011110101110101111111101111111111a1110111102122211212a22122210102011010022101111101101011111111111011102212b1212110122022212211201111
aaaaaaaaaaaaaaaaaaaaa101111111110111111001111111111111111111a1110111100021112122b02111220110112221212110111111011011111011001110112012a1121211111121221020201212
11111011111111111111a111011101101111011011111111111111101111a1111111012102120112b21222121212112212220111110111111111111011011111002122a0112220220111220111122011
11111100111111111101a111111111101011101011011101111101111111a1111111011111122002a02202202200101201212111111111011011101111110101112112a2211112121101211101122112
10111111011110111111a011011011111111111101101111101110111111a1101111102112210222b11111112111110212020110001111011111100111110101111121b2122221111222022111122122
00111111111111101101a111101011101111111111111010111111110101a1110101111121202222b21022102010021222121111111011101111011111111011112112a1210112202100112011220211
11111111011011110111a110111111011111110110111111111111101101a1110111111111111202a01021222222112211012010111011111111110111011110101212b2211220221111101202200011
11110011111111111110a110101111100111101111111111111111100110a0011110112201111210b22022100010222212121011111111111111110010011111111001a2201212021220112211222202
01111011101101011111a110011111011101011111011011111111110111a1110110102011102111a01212101222221110221110010101011100111110111101111111a1210111012102121112121112
10011111111111110110a111100101111111101101111110111010011111a1111100100021201010b02121121211201112120111111101111011111111110111111002b1222221022120222221021102
11111111111111111111a111111111111011111111111101111101111101a1111111111112220100b11001111100122102011111111111101111101101011001110222a2100022001221012222212022
11111010110111011011a111110110111111101111111101111111111011a1011001110021222112b21022021101222002121110001110100111110111111111010111a1021222011122110212112021
11110111110111110011a111111111111111111111111111111111111111a1011101111111121212b22211121120210002122011110011111111011111110111111222a2210121120122220020122201
11011111110111111101a101111011111110111011111111111111110011a1111101101221221111b02110001112220222112110111111010101111110111111110212b2210111221112200222111120
11110110101111111011a011100111111111110011110111101111101111a1111011112022222220a11212220202200211112111111111111110011011111111111101b1202101112111211100122110
10111111110111110111a111111111111111110111011111111111110111a1111111111012212220a21012122120201121211111111111111111111111010011010010a2212201121022210222111220
11111101111111101011a011111111111011111111011111101001111111a1111101112201011111a01012112101212112012110111100011111111111111011111211a2022222212120002122110220
11101101011111101000a111111111011101110101111111010111111111a1111011011122122122b21112220212210112120111100111111111010100011110112102b1212212222012122011212111
11111110111011111001a111111111111110101111101111111111101110a1111110101202021222a10112021221011020112101111111001011110111010111012212b2122112222222221211122021
10100111111110111111a111111111100111111111111001111111111011a1101111111110101101a11110111111101100111111111111101111111010111111101111a1221101112122112120222121
11111111111110101111a111111101111110111111111111111011111111a1111111111110111111a11111110110110111110111111111111011111110101110011110a1122202200202212112021111
01111100111101111011aaaaaaaaaaaaaaaaaaaaaaaaaaaaaaaaaaaaaaaaa1111111101111111110a11111111110111001110111001111111111111111011111101111a1121222122122222121001221
11111111111111011111110111110111111111111110111111111111111111111101111111111111a00011111111111110011101110011111110111111101101101011a0010010221210221102101111
11001011111011111111011111101111111111101111111111101101011111100101111111111101a11111110111111001111111111111010111111001111110111111a1012210000011212110100001
01110111111110101110110111111011111101110111100010111010011111011111101110111111a11110111111111101101111010111111111110111100101111111a1021101112122112121120202
11110111111111111111101001110111101110111011111111111010110101111111111011011111a11111101111111111101111000111110110111111111111111111a1221122100202112202120011
11011101011101111111111111111111011111111011111111111101001100110110011111101110a01111110111011111111111111111111101111001101111111111a1202212111211111011121111
11110111110011011011111111111011111111111111111111110111010010111110101000111111a01111110100011011011000111011110111111111111111111111a0120021010122212221120221
11110011100111111101111101111111101111111111111111111111111110111110111111011110a11111111110111110111111011110111111111111111111011010a1222102212112121122101222
11011101111101001111111111101110111111101101111111111111101101111001111111101111a11111110111111111111110111100001111110111111101001111a1101002011222122010122112
10111111011111111111100111111111111111111111111111100111111011111101111110011111a11111111111101001101111101010111111001111111011111011a1210011210021120210121222
11111110111110111111111111110111111110111110111111111111101110111111111111011111a11110101111111111111111111110111000111111111111111111a1101020122122121022222021
01111111111011111111111011111110111111101101111101111010111011111111011111111111a11110111111001111111111111111000111110111110011101111a1211212102220121021120211
aaaaaaaaaaaaaaaaaaaaaaaaaaaaaaaaaaaaaaaaaaaaaaaaaaaaaaaaaaaaaaaaaaaaaaaaaaaaaaaaa11100111111111001110111011101111111011101101110101011a1202101221020121121110212
1011110101110111001110111111011011001111aaaaaaaaaaaaaaaaaaaaaaaaaaaaaaaaaaaaaaaaaaaaaaaaaaaaaaaaaaaaa111011111111110011111110011111111a1102212122102122121021020
1101111011101010111111101101101111111111a00111101111110111111011111011111111111110101111111101011111a110011001111111011111111111011111a1120021011212021022112222
0111111111111111110111101011110111110111a11111011111110111111111111110101111111011110111100111001110a011111011111011111111111111101111a1012222012121111201121222
1111110011111111111111100011100111100101a01101111111111111111110110111111111011110101111111011101011a111011000110111111111111111111101a1212212220220001122201121
1111111011010111111110111101100101111111a11111101111111111110011011101111111011111111111101011110111a110111111101110111111110111101111a1100212221222222111121112
1011100111011111101111011111111111111110a01111110011001111100101010110110101111011110010111010011101a111111111111111111001111111111011a1022211121112222202120112
1011111111111110110101111001111111111000a11110111111111110111100110111011111111111111111111110111010a111101011111101111101011101111101a1010111121112021111212222
1111110110011001110010110110111111110101a01111101111010111111110110111111101110111011101111111101111a111110110101111110110111111111111a1221202210220102120122122
0111011101111001111111010111111101010101a10111111111101110111111110101111111011111011001111111111101a111100000111111001101111111011111a0012222100122212111112221
1101111101011111111011111111111011111010a01111001110111111111101011111111011011011011111011111111011a101111111111111001101021122220211a2211212120122212220122102
1111111101011111000101110111011100111011a11001100011011111000111111001111110111110111111111111101111a111111011111100111111112100000221a1222210212022212221012111
1111110100111111011111110110111111111111a01111111101011110010111111011111010111110100111111100111111a101111111111111111010210121211221a1012222212220022020122200
1011111111110101111111101101001111111100a11010101111111111111111101111111111010111111111111001111110a111110111111001011011111110111211b1212222211111002121111111
1011101111111001111000111111111111100111a11111111111111101111011010012020202202100221221212211012122a110110011011110101001210112112011a2111122101202110221100101
1111111111111100101110101111111011100111a10110111101101111110011111112112211222220121111220121201202a111111101111011110111111211101011b1111210112012002121011100
1001111111110110111100010111011110010111a11111101111100110110101011112111111111101102121102211122212a111100111101111111110122122220202a0112101111102112221111101
1010101111111011101111101111100111100110a10111111101110011111111111110112200212212221212222210222222a210212120221120111111222222200212b2221111201010211000011101
1111001111111111111110011001111111111111a10011111111111111101010110012212121212201122112121221022011a112212111022021011111220210011121a2200022112021210221100111
1111101111110111111011111011011110111111a11101111111110101111111010111121222222221210002210222112002a120111221212021111111102112212210b1222112102222121011111111
1111111111111111111111111101111111111111a11111001011111111011111110101212021212220121210122122121122a100222102102111110101022102010222a2022022021122222120111111
1111110111001101111011111110101011111011a110111111011110110111111010121110122211baabbbaabbbabbabbbaab221112111110011101111211101211011a1222121121222212001111111
1111010001111111100101011000011110111111a111111111101010111110101110121200211122b22221212221122122220221121001011201110111222102220202b1111211122120122111111110
0110111110101111001101101111111011110111a101111111111110010111111111011111201002a22102222222102021212121001111202011111111122001200012a1022122212002002210011100
1110111111111110111111111111111110111111a011111110010101101111101010011221000110a10222200122122122221112221102012200101110122011221201a2122211121201012101110111
1111110101110111111111111101111110111011a111110111110111011011111110121111102002b12102220122122222221101100112210011111111022201111222b1201220112222112210010111
1111111110010111101010111111011110111111a101111101111011011101111111122102121121b01212202022102210211221110211220211111111112122222220a1020120102122222221010111
0111111111101110111111111111111110111111a001111111111110111111110110002011210222a20121120012212212012100102221212121011111112200120211b0200020100001111111111111
0111111001111110111101110111000111110010a001101011111001100111110010012211222212b12210200002022222212212122001022021111102221120210222b0121101022100002220111111
0111011100011101111111110111111111111111a101111111111111111111111101002211122021b10212202022121212202222220222220022121221200202222220a0012021210022011111110111
0111010111111111111111111011110110111111a111110111111101111111111111121102221020b11220202222212201001122121022112121112012122222222121b1022122111201120110101011
0101111111111011101101011101111011011110a111011111110111111011111111122112121122b21222010212222220220021202020222221201210122100220121a2121222212022122111011111
1111011111111101011111111110111111111111a011101101011111011001111111120112102222b20221011022202120222120211102201222222122112222212222a1121122001120111011010111
1111101110111111111110111010111111110111a110011111110101111111111111122200211122a12120112021221122121220212210221122101121202121202011a1111102221111211221011001
1111110101111011010111011111011110111111a101111101101110110011111111120211201110b01212222222220210222220201210002002112221222222021021a1200200211111211020110111
0011111111011111011111111111001100001101a101101010111110110111111111121222101011b20220012121222221110222102121201202202121212122221001a1011221111221220101111001
1111111101111111111101101111111111001111a111111011111011011111111110021110121111a11121212121101222220212012122222002220122202022202021b1102221012112222000111111
1111101111111111011001111111101100111110a111111101111100111011111011112011102212b11002222010101002201211222202120221111221222112212211b0222212121220010211101111
1111111011111111111011110111111100011111a101111111110110111111120111011020222210b22122222222221122101211221202222102021021200121210012b2220002212110202220101110
1110110010111101100011101111111111110011a101011110111011011111121212022222202222a12122222202200212222212002221200201222112011200212112b2022200110101121121111111
0111111011111101111101111111001111110111a111101101111111011111122011122222012022b02222122222021122222022021022221221012121121020221222a2012210022011210110101111
aaaaaaaaaaaaaaaaaaaaaaaaaaaaaaaaaaaaaaaaa011011111010110111111120121122100220202a22122222220121120222122222120222121122211022111201101a1111011011111110111110111
01111111110111011111111111111101111111111111101111101011101110122202221222222022b22021212222020122222022222022111220111022012211010111a1101111111111101101110111
11111100111111101001111111111110111111111100111110101111111111110100120222022112b01020222222222212212112221220220100211122212200212001a1111111111111111111110111
11111111011111111011111111010111111011111110111001111111010110110002222222012002b02102201220202222121202011120121211122111111211110111a1111111111011011111001111
00111011111001111100011101101011011101111011001111111110011111112212021210211002b11221222220210221222122022112200100101021122222022101a1111111011110010111111101
11100110111101111111111000011110111111101101111101101100111111011101020211211111b21220202220222220102221212222212220002010100202012111a0111111110111111110101110
11111111111011000111111011111010111111111111110111110111001111100111101011220010a21222220221202211202202122222202220111120212212112011a1111001111011011110111111
11101011111101111111011011101111111111111101010111111111111111111222020022202211a21222022222010111111021121222212211121201122001011111a1001011111111111010111011
10011110101011110011011111111111111111101101101111101101111111111112220222202121b11221120012011111112211211020110110222212121100010011a1101110111111011110011010
11011111010111111101111011111111111010111011111111111111111011122011010120221122b11110202112101011112122202001102111122120222211102011a1111111101110111011101111
11111110111111111101111111111011110111111111101111110111011110121001201222222110a11002101102101101011220002122120210122112220112112000a0111101111111111111111111
11111111010001101101111110111111111110111110111110111101110111000200100102122101b10220221222211100110121201102011221222200222122011111a0111111001000111111011110
10111111110110111111111111111111111101111111111111100101101110110200102212122112a10101021222111011110212021200022112110221212122211100a1111100111110111101111111
10011010111110110110111101001111101101111111111111011110111111111022122202021021b21112212122221111111220121102122211011112211220112011a1111111101111111010011111
01111110111111010010111010011111111101111011111101111111111111122122220110121221a10120212121101111112211111021222022101100221011211111aaaaaaaaaaaaaaaaaaaaaaaaaa
11101101111111110111111011100111010011100111110101111111111111122111212021110211a1011210212021111111221220202212111210102222202202111001111111111111111111110111
01101111000110111101110000111110111111111111111111111110011111111122012112121010b2112122021021111111111120201020211022120011120111111111100011111101110111111111
01001111110011110111011110111111111110101111101111111111101101102120122222112011b2221122201112110011210101111221211211111011001210111101111111111111101111111111
10110110111111111101111011111101111111111111110100101110111111022111102210011121b2221211012222111101110111110110111010111111110111111111111111111111101100111010
00111110111110111111011011011111111110001011111111111111101111101222212200222110a1120222022121110111110111101111111110011111101110110111011110111011110001011111
11111111111101000111011110111101111111111011111111100111111111102210112221121210a2102111210121111111111110111111111000100011110011111111101111101110111101111100
11110111011110100111101101100111111111101111111111011011111111011122111122111222a1012120122112110111111111111111101111110101111101101111011101011111111111011111
10111111001111111111010111111111110111010111011101111111111111111222211212212102a2212202122210111101110111111111110011111111101001110110111111111111100111111110
11111111110111101111101111101001111101101001110110111111111111122101210111211202a1222110211111111101110101111111101011110111001111110101111111111111110111101111
11101101010111111111111110111001101011111111111010001110111011021221122020211121b2110102011120111111111111001111001111111111111001110101111101111101101110011010
11010000111111111111001101101111011111111100110101111111110111112211112212120212b2221210212111011101001111111110011111111111011011111111111111001101111111111111
11101101100011011011011111111110111111111110111111111111111010112111111022112222b0201212111212111111111110111111111110111111110110111111110100011101011111111011
11110111100111011011111111111111111011111111111101111101101111101000012122211102a2122102111110100110001011111111111111111111111101111111111100110111111111111111
11111111111110101111110111110111001011101001111111111111111111011111110111101101a1111111111111111110010110111100101011101110111000111000111111110111101101110001
01111011110111000110111011111100011101110011111011101111111111111111111101111001a1010011111111111110110101011111011110110101111100111100110111111101011011111111
11111111011111110111110111110111111011011101111101001110001111111101111110111111a1111110111111111011100111111011110111111111111111110111011100100101111111111110
11111111111101011110111011010111111101111111101111111111110111010111110110010110a1111111011011100111011001110101111111110101010111101111111111101101111010111101
11110111111111011111101111011011110111100110100111110011111110100101101111011111a1110110011100111101111011010100111111111011110110111111111110111111111010111010
11111111101011111111111111010111111111111111110111111111111011111001011111101111a1111011101111111111111111111110011111001101101001111111100111010111111011111111
