155 15
1 104
78 98
151 42
145 5
137 70
84 74
99 77
115 88
85 8

101111111110111111111111111111111011011111100111011110111111a1110111111122221ba120012212111212111201210110111110111011a11101111101212121111b12121220221122122122
111111111011010110111111111101111110011111010001101111111101a0011110111122212bb021211221121222221212211011110111110101a11101111111222022110a12222111210210022020
111011110111111101101111100101100111010111111011010111110111a1101111111112121aa211011221221222001101201110101101110111a11111111111110211122b12222122201111122100
111011101111111111111111100111111101010111111101111111011011a1111111112112201ba121212010212211111121011111110011011101a11111111111222101122b20212212220111112212
011110110111011111111011011111001011101111111101111111110111a0111110112101121aa221021211121021201120011111001111110111a11111111011012201011a21200212111221022121
111111001111111111111111010111111011111101111110011000011011a1111011001012001ba021122021120010022021101111101111101111a01101011101210112021b21111012211112221120
111111111011101011111111011011011111111111111111111011111100a1111001112021202ab220112010112001112122101111111111111111a11111101011202211102a11012220112012222110
111011111101111101100101011011111111111011111111111011111111a1111111101220011ab220222111221220222112211111111111111111a01100111101112012122b01011010211112102121
010111010101111111111111001001110111111111110110101111111111a1111100112221212bb212120022111122022220111101110011111110a11011111111222112112b01011121011211102122
101011101111100011111011111111011101111111101111111111111100a1001001111210211ab001121102222211111102211111111111111111a11111111111011011111b12022122121120012012
110111111111111111011101111111111011111111111110101101011011a1111111011121200ba020220220201212220122011001111010111111a10111111111122221202a12112111022122100211
111111111111111111011111001110111111111111111111111111111111a1101101102110202aa120112212122111110221000001001101101111a11101110111212201101b22111200110210101121
000011111111001111111111111111111101101111111111111010111111a0110111111121210aa011222221011012201211011111011111110011a11111111110111121211a21222110212202112221
011111111101111011110111111101010111011111111111101111110111a1111011112002211aa201121021212122220200010011101011111101a11111111111111200221b122002202P2121120120
110011111011111011011111111111110110101100101111111111111110a1001111111112121bb212111221221110120021211111111111111111a11110111111111122101a12PPPPPPP2PP22012212
101111111110111110101110111111111111101110111110100111001111a1111011110011021ba222112020111111212121111111001111111101a00110010011010122110aPP1200222002PPPP1122
011111111111101111111101111110111110111111101111111111111101a1111011110111201ba001212101110122212121201101111111111111a11111101111021200112P11001220122222101212
001111111011111111110111111110101111111111111001111101111100a0011011111121200bb210111112222211120111111111111111011101a11000111111120221001P12122001211102011121
111111111110111111111111111111111111100111011111111111101111a1010111110121112ab022101111120002211121011111110110101111a11011111111122111120P21112220202112211111
111111110011111111111111111111111111111010110111111111111110a1111110111101122aa212120221222201120221211110111111001111a01111010101212120011P01202011101211001221
111110111111111001011101101111111111101111011111111101111110a1111111012112100ba211102210121110120212111111101101111011a11111111111222102120P10111110102001212221
010111010010111101101111111111111111011110111101111111010011a1111111111111001ab021202121102212212210201111110110111111a11111101100222101210P00212111222212201211
101111101101111111101111011010111101111110111111111111101111a1111111012220112ab121111010112122001201111001111111011111a11111111111121121012P22100020102211221211
101111101111111011111011111111110011111101111111111101110111a1111101111110102bb212210222101100221010211100111101111100a11111100000222202112P12221102012102101122
110101111111111111011111111001111111011101111111111011111111a1111110011112221aa121211021211110201201111101011110111101a11111111111012222102P22112111210020222120
111111101110111111101111111111101011011011101111110111111110a1111011112101100ba222222112112202111221111011111111111111a00111101110212111110P11010112021211122001
111101111110111011011111111111111010101101111111111001000111a0111111100122212aa112121012211212122221211111101111101111a11111111011211201202P11122222022222222112
111110111101101111111111101101111111110101101011111101111011a1010111111221100ab121112221212112211102101011111010111011a11011111111120212222P02202222222222222212
111110111111111111110110111111111011111111011110100011110111a1111110112112122ba222111211202020000212001111001111011101a11101111111022012202P22202002112011222202
111111111010110111111111011011111110011111011011111111011111a1101111111121212ab211122210112211221122201111111001110001a11111111111220110012P02022002212220201200
111110001111111111111111010111111011111111111111101111101101a0110111012200101ba211221120221122202211101101111110011110a01111011111121220220P22221010222020202122
101110111101111110110111111011111001100110111111011111001111a1111110110111101aa011010111111111111110111111111111101101a11111100000011110222P02120112212122222101
111111111111011111111111011101111110001111111111110111111111a1111111111110110aa111111111101111111101111111111101011111a10001110111010100221P11211222012210011111
101111111011111111111110110101111111111011100111110110111111a1011011110111110aa111011110011111111111100110110111000001a11101101111011111221P12211121110212111212
010110111111011111111111101111111111111110110101011110111111a0111110110111010aa101011111101111111011111111111111110110a01101010011111111120P22110001002212220111
101101011111111110011111111111010111010111101111110110111111a1011101110111101aa110111111111101101010111011111111101111a11110111110111111222P20012211110221221221
111101110101011011111111111111111111101111111111111111111111a1111111101111011aa111111111110111111101011101111101111111a11110111111111011221P10121112212212221221
010110011111100101111110111110111111111111101111111101111111a0111110110010111aa101111111111111111110100111101011111111a11011011011101110021P00100202021110201110
111111111111111010110011111111011111101110101101011111001111a1111101111111111aa111111111011011111111011101111111111111a11111011111111111202P21111220021002220110
111001111011110110110111111110101110111111011111110101111011a1110110011111101aa110111111101111111111111111111111011110a11111010101010110011P21122011022012200102
100001111010111110001101111111111110110111011111111111110111a1111111101100111aPPPPPPPPPPPPPPPPPPPPPPPPPPPPPPPPPPPPPPPPP01101111011011101211P00111212211001001121
101111111111111101111111111111111110001010111111101111100011a1111110111111111P11111101111001010110111110111111111111111P1111111111011111021P22222112221211110010
111111101111110101110010011011110101110111111010010111110110a1111101111001111P01111100111101111011011011111111110111101P1101011111101111121P20200012102120120201
011111101111111111101100111111111011111101111111011111011001a0111111011111111P11111101110111111111101111111111111111101P1111010101111111122P11222021012210222112
111111011111011011100111111111101011011110111111111111101011a1110111111111111P11111111111111111111111101111110110111111P0101111111011111011P11101221101210102210
110101011111111111101111101110111111111110111110011111111111a1011111111111011P01111110011100111111011011101110111100111P1111001111111111111P11010212002022221022
111111111111111011111111111001111111111111101011111110111111a1111111111101111P11010011110011011111100011101111111001100P0110111011011111122P22212111021211021120
111110010101011111011010111111111111101100100111111111110011a0101111111001010P11111111111111111001110111111111111110011P0011111101011111211P21112222102212222111
111011111111111111101111101111110001011111101011110111111111a1110111111110111P111110101001011111111100110001011011111111P111111111111110222P20111121222022112021
111110111101111011111011111111111111111011011111111000111101a1111111010101111P101011111010100111111011110111110011111110P111111110011110100P21021101011101112002
110111111011111011110111111111011111111100000101101111111111a0110111111111011P110111111110110011100111101111101101111111P101110111111101121P01122121101221111012
101110110101011100001011110111011111111110111011001111110011a1101111011111011P11110001011100111111111011101110111101111aaPPPPPPPPPPPPPPPPPPa00102102111212111220
111011111110111111110110011110111111110001111010111111011111a1111101110111111P01111110111110110111111111011011100111111a1101111111101000100012221211021020112020
111111101111010001111111110110111101100111111101111111111001a1011111101001111P11101111111110010110101111111101111111011a1111101110111111212220011211201112100101
111011111111101011110011011111011100011010111111111111111111a1110110111101110P01111010111110111110111101111101111101110a1111111110111101220202110021211110102212
101100111011011011111101111111111111111010011110111010111010a1111111010111111P10111111111011111111110011111110011111111a1021120101212222220222000221220102121112
111111110111111110111111110101101110111111111110111111111111a1001100100111110P11111111111110110111111011111111110111001a1121120220221111212222211221200020221021
111011111111111111100101111101110111111101011011111011111110a101100100PPPPPPPa11111011010111101111001001101101111001100a1112111122212221202012100220221221121220
111110111101111011100111111111111110111110101011111111111110a110PPPPPP1011011a10111111111111111111111100010111111110011a1101111221222210022021120212111021111111
100010111101101011100111110111111111010111101111011111111001aPPP1111012220211a22111012101221011211121111111111111110011a0022101211012110111101222021212210011010
111111111111101101011110011010111111110111111111111101011111P1011111122220001b22212212121101112210011111111111110111111a0112010121201112120222110021120121001101
111111111011111111001111111010110111110111110111111111111111P1111101112100121b21101202222121000121111111111111011110101a1111122121212221222221121000022211111111
101101101101101111110111001000111110110101111111111111101111P1111101121101222a22012102221220200022020102121111021221101a1020021111212111210211121201011111111010
111011101111111111111111111110111001001101100111110111101111P1100011011212201b22112022222220222222211221122102112121011a1101121010021122021221212001121221101101
111111111110011111111111011111100111111111011111101111111101P0011100120110220a21121122022201202222222222022112012100111a0111110212110212102212111202011001111111
111111101111011111111111111110110111110101011100011111100111P1100101122112122a00212222222202222222221110211211011211111a1120220120102212112022222211010021110011
111111111011101111111111111011110111110111111111111110111000P1111111101111101b02202110210122210222102021112121221211011a1120202121200221122122221211222121111101
110101111111011011101111101111110111011011111111101011111111P1101111111201122a10211222221202222121022121222102122120011a1100112212212012202102211111101210111101
010111011111111111111111111111110111111101010011111111111111P1111101121201002b10101202212202222122211201111210222211001a0111221122121212111220210010211111101111
111011111001111011111011110110100010111111111000111111111111P1111111010200100a10111011212221112220220022201212212200011a1010021212210002012222112122110211011111
111111010011010011111110110111101001010111111111111001110111P0111111122122102a12011222222122002222122011121021212220111a0120122110110222222201121112211211111111
101111011000111111111111101111010111101111101111111111111111P0111111112222120a11121202122122222222012121210221112201001a1101210221211111100bbaaaaaaaaaaabaaaaaaa
111111011101010111110011111011111111010111110111101111111111P1111110122112212a21012212220200110112020212222110212220111a1121012222211120122b00222122011110111101
110110111111101111111101111111101101101110111011011111111111P1011111121001200a00222210202022120222112121021222222121011a0220211202212210002a01212121101201101111
101111111111011111110101111111110111111110111101111111111111P1111110122222221b22112202120012102002220002000122201020112b0120222121201112112a10220010110221111001
aaaaaaaaaPPPPPPPPPPPPPPPPPPPPPPPPPPPPPPPPPPPPPPPPPPPPPPPPPPPa1111010102001110a22002122122220220012222220012120222220110a2102221112212222112b22211012222221101011
10111111P11011111110111111111111101111011111111110111010110111111111102121211b11121222222222202102212220212202222021121b1111202022222220222b12200012121101111101
11101111P10111001011111111101110110011111011001101111111111100111011111220110b10121221201222222222120212222022211221121a1122201120211020122b00200221201111110110
11111101P11111100110011111111011101010101101111111111101111011111101101111220b21110020200222211202220202022222210220200a1020022202211020212b10222212220111111111
01110101P01000111111110111111111111111001111111001111110111101111101120122100a11122102121122201012202210222202102202201a2122222202201121011a10211112121121011011
11011111P10111111101011011100111011111011111111011111111110111111011120111100b20212222222012112112222022221102102122212b1112210200220102011a11221022222221111111
11100101P11111111111111101111111111111111011010011110110111111110111020211000a20220112110220022221211211220012101122001b1222222112200220212a02221012121111001111
10111111P01111111111111111111111001111111101111111111111001110111111011202111b22122020011222222222202220221222001201212a1122222210110102122a22122211210121110111
11111111P11011011110011111111110111101111111111111011100011111122000122001220b12202222222222221120202220202222022222122a2021220022212112111b10202212202211011111
01101111P01011011111111111111101111111111111111111111111011111122222022212211b22122222202220222122202222222222210210021a2222220101211121211a21111212122211010111
11111111P01101110100111111001110110011111111111101111111110111121212202211212b10222222122121222122100221222022022122212b2122221102211011201a11110121201121111111
11111111P10110101111110111111110111111111111110010110010101011011112211021212b21221202222221122122020122021222222111002b2002012222211111111a11111111101111111111
10111110P11111111111010101101100111111010111110010111111101110110202202002221a11122222022222210221022221022220001222010a2221112202011110111a10111111110110111111
11101110P11101111110110101010110111111111011111111111111110111102201122221222b12221102222222200222002020220222022022020a2010021211211101111a11110111111110100110
11011111P11000111111101101110111111110111111001011010110111101112010122222212b21122212221222122210220212002211022221122a1112012022211111101a11111111010111100011
10111111P00111111111111111110011101101111111111011110111000111100120002221212a12221122002222200002210222222222221122000a2211212012011111110a10110101111111111111
00110100P10110110111000111111011111111110111111001110101111110121222122000222b20111002102022221201212022122020201211001b2212200021201111101a01111110110011111111
11011111P11111111111111011110111110111111011110110111011111101101212210121012b01001222120222222212202122022122201211121b1201022210211111101a01111101100110010110
10110011P11111101111111111101111111000100111111011101011101001120122121200222a12222110020211211110111222112221221011211a2122212222010010111a11010101111111111011
10101111P11101101111111101011111111111110111111111110111111111101011112120212a11201110221212221111111202200101112112210a0110122111011100111a11110111111011111110
11011111P01111100101011111111000111111011100111111111111111111102210021012201b12200002120012100111111102222122112102012b1202012211210111111a11111011111111110111
1111101P111111111110101111101111111111110111110111111011110111100121201221111a11101012212211100111110210220212112120012a2022000011001101111a11110111111111110010
110111P0111011110111011111101111111111111111010011111011101110001221220001221b22121021222122101011112222121011221022111a0021100102011110101a01101111111011101101
111111P1110001110110001111011011110100111110111111111111101111122201201011122b21021211022101021100012022220110211112111b2202221012211110011a11011111101011101111
11110P11111111110111111011111001111111111111100111110111111011111212121222022a10121222221201021110102210102111012212220b0221112111210101111a11111111011110110101
1010P011111111111100111111011101111111111111111101111011111111021121222220000a22222111212212100011111211110201011220112b2221112112101111001a11110111111111001111
1110P111111011111001001111101111111111011111111011110001101111101111211111111a22211222221221101111110012111222110100122b1212112111200110110a11111011111111111111
101P1111111011111110110111110111111111111101011110111111111111120120100101101a12211120121211110011112101121220021221102a0201212120211110011a11011101111111111110
10P10111101001111010111101111111110011101101110111111101111111121212222122022a10011211221100210110112212121101111011110b0021012211111011011a11111111111111111000
1P110101101100111111111111011111111101110011011111011010111111122222121211220b12212210020110221011111111011101001111111a1111101111011111111a11111101101111011111
11101111111110111111111111101111110011111101111001111111111111112102122101012b12210211211121221101111100011011111110111a1111101101111111111a01111111111111010001
11111111111110111111111001110011011010101111111110111110111111101112012110112a10121222122021210111111111111110011110111a1011100111011111110a11111110110100111001
11010101111001111111101111111111111111111110111111111001011111100221011220221a22210222211102210111101011111111111111101a1011101111101110011a01110110111110001011
11100111111010111011111111100111100111011111111111110101111110112201212222122b22211102122010021110111111011101101111101a1101111011111111111a11111111111101111101
10101101111111101011011110111110111111011101111110011111111100112112211022121b20111202111111221111111111101111110111111a1101011111011111010a11111111111111111010
11111111111111111101110011010011110111011101001111101111111011111201121122112b21121112201102110111111111111101111110101a1111001111110111110a11111111101111111101
11111111111111111111110110111101111011010111111111011101111001012110121201111a22220200221022110111111111111101011100111aaaaaaaaaaaaaaaaaaaaa11110111110111011011
01101101110111001001111111110111111111111110011110110111111011112221012220122a0120121221111121011110011111110111110110101110011011111110111111111111011111111111
11111111101111101111111000101111111111100111011111101111111101111011101121110b2222211121122111110111101110111111011111111111001011110111101110111010110011111001
11101011111111111111110111111111110101010101110101101111111111101111011111011a1101111111111111110111111101011111111010111111111011011111111101101011101101101101
01111101001111011111111111111111111111101111101111010111111011111101010110111a1110111111111000101011111111110111110101110111111101011011111101111101111111011111
11010110111111101011111011111111110111011111111111101111011111010111011001010a1111111111110111111111111111111110111100111110110111111111001111111101101111111111
11110111110101111111111111111110111110111111110110110111111011011111110110110a1001111100111101111111101111100000111111110110111011111011111111011111111111111011
11110111100111111111111100101111111111100101101011111111110111010111111011111a1111110111101111111111111001111111111111011111011010111111011101011111100111011111
11111111111101111110101100111010111100111001111011100011111111111111101111010a1111111100011101011100111100011111111111111101111101110111111111000111111111011011
