66 2
42 101
78 98
151 42
145 5
137 70
84 74
99 77
115 88
85 8

1111111001101111111010001111011111111110a10111011101111111011111111111221022121022212221121101121121210010100100111110111111011111122101122010121121201221220222
1111001111101101111011111110101110101101a10111011111111100110101011011022101112212220221021021121102201110111011001111111010111101212122111122121220110222201201
1100100111111111111001111101011111011111a1111101111011111111111110P011111112222212220010101022210021211111111111011111111011010011221001121101211221121120021222
1111101111111101010111010111110110001111a1111100101001011001111111P111121111220020210101021112202211101111101101111110111111111001200222222121110222121211112112
1111111111111111011111010101011111101010a0111110111101011010110101P111122001011112221210211122010112011111110100111111010101101111110010102120212221102120020012
1111111101110000011111011111111110101111a0111111101110101110111111P010102102222122010122112022211020201010110101110111110111111111202021120220221121120102021211
1111111101111011101110111001111111111111a101111101101101101110101P1111120211211122202112100100111212000111111111101111101111111010222220111220112110022001101202
1111111101111010111100110111101111110111a00101111011111111111011P11110111121011112220222022121202122111111111111010111111101101111122221212101221110210102212212
1011111111111111010010111111111011111111a1111111101111101101111P100101201012221112112221112020121112211111101111111111110110111111101222211201211111102000112212
1111000110111111111111111011111101111111a1110110110111111110111P101010111122011121222222112122001110201011101101111111111110111111211111122112010202012111122021
1110111111011100101111111101111011011111a1101111010010111111110P111101222120102022121111212212221121110111111111111111101011010001212111102212011212021022012111
1111111101111111011111111111111101111110a1110000110110111111100P011110202022222121021122221121212110111011111101111011101011110101110021220101221221110222121012
1111100111011111111001001110101101111111a1011111110111111111111P111101020201110121121110122011211121111111111011101111110111111011121221002212211112112122210212
0111111011110111101111110111111011001111a1110011111011111011111P110011222001122222002121221211222022111110110101111110101111101111101222211112111221102211011011
1011111111111111111111111111111110111110a1111111101111011111101P011111221122012100221001221221211220001101010011101110111111111111102222202002121221212211022012
1111110001111010111111011111001111111111a111111111101111100111P1011111001002112212110012111012202122211111111111111111111111111110112212001121211020122210121121
0111011101111111111111010011011001110111a11111111111011111101P11111111221220212111211022201112222022001011110011101101111111111111220122100221121221222111222212
1111111101111110111111111010101011111111aaaaaaaaaaaaaaaaaaaaP111101010210212221211102121020211212111210011010101101111111101111011121022200212221210110211212022
101101001111111101110111101111011101110111111111111111111101P111111110121211212222211110011120010221211110111011111111001111100111211022222121220212110122212022
011101111110111111110101111111110110111111101010001111111101P101101111101222110110201211222111120211111011111101111111101011001111221211112212021121122101012210
111111111111011110011111111110101111111111111110110110111110P111111101122220211101121220210021220021211111111110111111111101111111111222222100021001212022210122
110101111101111111111010111111111110111111010010001111011111P111111111201221011212221112222211211122011011100111001111111011110111111022111211222222220102112011
101111111111111111111011111111101111111101011111110011011101P111111111111102221212120220020121020111101110010111111111110011110110102112220122122010121122121112
111000111011001111111011111101110111111111001011111111111110P111100110210112222121012121122211212212110011111111101111111011101101022211220012110011210122100211
111111110110110011111101111111110111111111011111001111111111P101101111202212122221121100110221112221111101110110011111111101111111220211122100110220210110121111
111011111101010111111111111011011111101111111101001111111110P111011110011212211221211122111020212021111011111111111011111101010011121121010201122122210121221202
111011101110101111111111001011111111111011111011110101111111P111111111122102021111122201212212221212210110100101001111111011101111011022220211001122122122201211
101101101111110111111101111111111011101011111011111111111101P001101011220212221222121121221200111210111111111111111111111011111111012202022ababbbbbbbbbbbabbabbb
011101010011110110110111111110111100111111101100110110101101P111111111222011011002211010012120111121111111011111111111001011111111221201212b02122122202212122222
111011111111111011111111111100111011111111101110110111111100P111111110211111022221121100221122112112211111100101101111110111111010120021202b22202221112202120122
111111111111111111111110110111011010011011111011101111111111P011111011212122201122120212200121100110101011010011011100111101111111102022201b20222110210210220221
111110110111011111100110111111111111111001111111111111101111P111000111101011110111001111111111011111101111111001111111011111011011011111022b11012111112200222101
111011111111111111101111010111100111111111001110011101110010P110011101111101111101011111111101111111100111111011111111101111111111111011100a20121020211202110012
011110111010111110111111111111011111101011111101111111011111P111011110011111111101111110111111001111111111010101111111111101010111111111112b01201121111101121221
111011110110111101111011101101111011111011111110111001111111P010111111110011111111111111101111111110111110111111111110010111111100110111121b11211120200121222221
111111111111001111111011010011111011110110101111111111111101P011001010111010110110111100110111011111111111011011101111111011011111111011221b00022102221011110011
111111011011101111111001101111011011111100110111011111110111P111111111110111111010110011111111111001011100111111111111111110111101111111201b01122202111211121211
aaaaaaaaaaaaaaaaaaaaaaaaaaaaaaaaaaaaaaaaaaaaaaaaaaaPPPPPPPPPa111010110101111101111111110101111111001111111110001101111100111111111111110211b12102000002022212122
10101111111110101111111101110110111111101001111111P1011111011101011111111110111101101100111111111111111111011110111111111011111111110111202a11121111012122120202
aaaaaaaaaaaaaaaaaaaaaaaaaaaaaaaaaaaaaaaaaaaaaaaaaP11111101111001111011101111111011111100111111111011111011111111111111111111011111111111122a20112201102011112122
1111010110111111111110110111111111111011111110010P01001110110111110101111111011011011111001111111111011011111101111111101111111010011110222a11112120112112122112
1101111111111110101101111111111010111111111011011P11111010111110001111111111001101010111110011101101001111111111011011011111011111101011121b11211012010111201222
1101110100111110111001111111110100101111101111111P10111110110111000111111101011101111111111011111111010110100101001011001111011101111010111a11222112101112101212
1111110111011011111011011110111110011101111001010P11111011111111011111110111011111111100101111011111111111111110010110111101001111111111200b21022211001101221110
0010111101010111101110111111101111111111010100011P11111111111111111111011111010111111101111110111111100111101111001010110111011111111101202a21110112221122110022
1110010111111011100111111011111111111101101010111P11111111101111111101111101011111101111111101011111111111110011111101111111111011110110222b22022122211122201202
1101101111111111101111000111111111111011101111111P11110110011111011110101111011111110111111000111110001111001001101010111101101011111110211a20212112121101122100
1011111110101111111111111111111101111101111101101P001111011aaaaaaaaaaaaaaaaaaaaaaaaaaaaaaaaaaaaaaaaaaaaaaaaaaaaaaaaaaaaa1111111001110011021b01211202101112222122
1111110111110111111111111111111111111111111111111P011111011a01101110101011001111101110110111101110111001111111110110111a1111111101111011222a12212121012111112221
1111111111111111011011111111111110111110111111110P111111111a01111101111111110101111111111111111111101011011011111011101a1111100110101101111a11211222221201111202
1111110011100101111011111111111010111110111111111P111111000a01101111110111110111111111111111111111110110110111101011101a1111100111111010202a21212112022221211111
1010011111111011111111111110111111111010111111011P110111111a11101101011101111011101111111111111011111111111101111111111a1111111111111001102b11111000220212120211
0111111111111110011111110001111010110101010111111P111101011a11111111110111111111111111110111101111111110011111111110100a1111110111111111210b21121121221111101111
0000111111100100101111101111101100011010111111111P110010111a01111111101111110111001101010110101101110110111100101111111a1111111111111111121b11022201112122011102
1111110001111101101110011111111110111111111111110P110111101a01011010111111111101111111111111011011111111101011111001111a1011111110101110002b21020222212012021122
1001101110000111111111111011111111100011011110101P111101011a11010101111011111111111111111111100011011111111011111101101a1121222112120212212b02210221111210011111
1011001101101111001110101111011111101010111111111P011111111a10110111111111011111011110111111111111111010110111111111110a1021220100022111122b20222100202222222022
0111111011101011111111111111011111101111101110101P110110111a11111111100111111000110111111011011111111111111111011011111a1122212212221111220b02102201222001001221
1111110111110010011110110111100111110111101111111P011011111a11001111101110111111111111110111111111100011111111110101001a1111102102121111111b12222221021221111111
1111111010111111011110011111011111111011110011011P111111001a10110001122022201111012012012112202201221111111110000111111a1121211212202202212a12101110010101111111
1110111111111111111111101111101111101111111101111P101111101a10101111121211112212222122201212122121001011111111001001010a1002120212220222222a11220211012020101101
1111111111111101111111011101111110101111101011111P101110111a11110111120211022211101222002221111120211011101101111011001a1001211110121121221a01210021022211111111
1011111010100111111111111111011011111111100110111P111111111a11111111010111212211122022021222121212102211011212222201111a1112201221001122121b01212220201221111111
1111111011111111001111111110101111101111111010011P101111101a11111011120200220222101122222222122021221012120101002211111a1122102021212221112b21111202201111110111
1111111011110111101111011111111110111100111111110P110111111a11111010111201121221111220222021120222221112122121021211111a1110102011212110222a22211111111121111100
1111110111011011011111101111111111101111111110111P101111011a01110001122102012110221202212012222211121122001212121010111a1121210212221121200b20102212211221111110
0111001111111011111111111011111111111011111111110P111101011a10110111112022122122120222222201120220202022202122210011111a1110212121101100120a22120222121121111101
1111110101111101111111111111001011011101011111111P011111101a11110110120112110102022000221222121202212220020012012211111aaabbbbaaaaaababababa22122221020101111111
0111110110111011111101100111111111111011110110111P101110110a1001101100012122022021111222221220120220122111220122222111111112221201200101210101120202120211111111
0111111011100011101111101111111010111010001110111P011111101a0111111111110220000202211202220002002001021110112212222011010110021122121221122221020111211101001111
1101101111111101011111111111111011011111101110111P011111111a1011111112001221200111222022120122202122111012110221102111110021202122202100101222212212211021110010
1111111111111111111111111011110010011111011110001P111111111a111000111221212222121220122212222211202bbabaaabbbaabbbbaaaaaaaaaabbbbaabbaabbabbaaaaabaaaababaaaaaaa
1111101111111111011111111111111101011111111100111P111101101a111110111220222122112012021122222220212b111012111001102101011110212121222222102222021201111111111111
1111111111110111110111111110111111111111111100111P110111110a101110011221212020212200121022112202211a220212222220021111102122212221222200011222210101012101011101
1111111111010111110111110111111011011111011111111P110111111a111110110200212121010112021222022202102b222221222221122122000222222222212211101201212011002020101011
1111101111111001111101011100111110111101011110101P110011110a111110101211011112102020220022122121222b212222222201222221122002202122112121011210011102111221110111
0111101111011111111001110110111111111001111111101P110111111a111110101002110110021212022222021222122b221222120022201211221020221202011012001000211120112021011011
1111111001011111110111001011011111110110111111111P111010110a111101111212111212121112220222202222211b122201210222020000212020221120110222120202011211210211111111
1110011111111000111011001000111110011101111110101P101111011a011101111200122011122212222120202011201a122112122212112220110001102222211111120122021122211211111111
1001111011111111111111111111101111011111111111111P011111111a110100111022221212121120202112100202222b002221202222211002111011222122202022002122211001221201001111
1111101111101011111111001111111111100111111110111P111111111a111111111211200221010011220102102202222b022222200212022212110220112012222211222012202110212111111101
1111111111111111110111111111111101101110011110111P111111001a111110111212211222211001222200221021022b102220222022121102122202102222222022220121112212121221111111
1111111011011101111101111110111111111111101011011P111111111a101011010221012222121201010202222222212b221202222212022201020222112012221102101112212122122220111111
1101110111111100011111011111111110111011011101101P111111111a111120212212112212010210202222202222221a120221212122222102222121221220210001102111222112221201111110
1111111101111101101100101111110111111111110111011P110011110a011100121201221222202212202222222210112b022222002021222211210211220222212222121221211110221111111111
1101111111111111111111101111111011111111111111101P110111111a111221202222120222221000222221112222211b001221222222222112111112220210221220111112112021122011111111
1011111111111111101111111001111010111111011110110P111011111a110022120122222202021221222222122022211b222210122222222011112112010201011110011111111111101011111001
1011111101111110111011011010111100010001001110111P111111111a101121211212200021220002222222222222201b212122221012002002111211220022011111111011110111101011111111
1111011011111111111111010110110111111111110010111P011111101a101212211220222202122122220221221022220b222002222010201120102021211100110111111011110110110111011011
1011111111111111100111110101111111110111001111101P111010001a111111012101120222122222222002212222222b222112001010222211020121112121111101110110111111111110111101
1110111011111111101111011101011110010111111111111P110111110a111221110122221221122112222112202212122a222212010022222212221122022221010110111111011101111111111111
1111111110101111010110111001111111101110110110011P101111101a011211021022011212112210222111222021211abbbbbbabbabbabbbaaababaaaaabbabaaaaaaaaaaaaaaaaaaaaaaaaaaaaa
1110111100101011111111010111011110111110011111001P111011100a1111021212011122122221102222122202012111222102022222210200211222112212210111001111010101011111110011
1111011111101111111011111111110111101010111111100P100010101a1112121111221011222112021020210210011111211202110222221112110120001011111101111111111101111011110011
1111111111101111101111110011111011111111101111110P110001111a0101101122122200011220211101121101011111112221121102212221212102112221211010001111110101111001101111
1111111101111111111011111111101111111111011111011P111111011a0100221212110212222202212221102221011100211101121202221200011120112112111101111111111111101101001101
1101111011011011010100000111111111111101111111101P110111111a1112210001201220100112211101101121101101211101222212020112210111220111111110110011110111010101111111
1111100111111011111111000111111011111011111111110P111011110a1112020021011212102011021110220221101111122021112121202212121221112222111111101111111111111111011101
1110101111111011111011110011101011101011100111011P001111111a1112111012110210120201212022012102111111211120012022020111121211212022211111111010111111111111111111
101011111aaaaaaaaaaaaaaaaaaaaaaaaaaaaaaaaaaPPPPPPa111111110a1111222211102112212222120011221100101011102112222121220220211102121210211110100110011111101110111111
111111011a00111111101011111011010001011111P1101111011111011a1110222122121012210121112212122110111001210111202121211121212110112012211011111111101111111101111101
111111011a01111011101110111111111111001111P1110111111101101a1012000211010211112211012122212101110110012222110211101122222212100111211101111101111110111111111111
110111111a0111111101011111111110111111100111111101001111111a1112202212012201121122020211202120111111222020020101111101021110020122011111111111011011111010011111
110101101a1100110010111110111111001110111101101110101111111a1112020122120122212122002022202121111111202121122211000212101101022211101001111111111111111110101110
011101111a1110110111111110101011101111111010110111111110011a1110211212112211222101102222202012110101111111111111111110110001110011010100111111111111110111111111
111111111a0011111111011011100101111111111111111011111111111a0112111221222211122201102112022212111111100110110111101111111111011001111111110111111111111111111111
111011111a0111110111011011111111111111000111111111111101101a1112222001110111011222102222210202110101110111110101110101111101111101111111111111111111101111011110
111111111a1110111111111111100111111111111011110010111111111a1112202122012110120201102111120011111001111111111011001100111100101111111111110110011111111110110101
111101111a1100111101111101111100100111011111101110101111111a0111002201112122122110220212220111111111101011101011101111111110111011110101110001101111101101100011
111111111a1111111111110111101111111111111110101111100101111a1011001201202211122222022121111001111010011111101111111111111101110101111111111111111111111101101011
111101111a0111101111111110111111111111111111101111111011010a1111112122221102201102211110112211111110111111001011011111110111111111010110110110011111111111111110
111111111a1111111111111111011111011110000111111101111111111a0111011222122122111211222101202221100111101111111111111111110111101111111101111111110011101111101010
111111111a1111110111111111011111100111110101111111001101011a1110012212202021210122221212220120111111111111101011111110111111111011101101111111011101011111110110
110111111a1110101111111111111111101111011001110111111111101a1102222111112110012011211111000111111110110110110011111111101111111111111111001111111111111111100101
111111111a1111010111111111111011111011111111100011101111110a1011101111111111111111111111111110111010110011111111111111011101101101001111101110101111111101111111
111111111a1110111111111011111011111111111111101111011010111a0111111011111111111110111111111110101011111110110011101110011011111111100110111101111111110101011111
111111110a1001110111011110111111110101111111110111111111111a1101101111011111111111111011111011111110011111010110111111110111111111101011111011101110111101011011
111001111a0100111111011111101011111111010111010111111110111a1101111101111011111111111110111111110111110111111100101011110111000101111100111111111111101111111111
111111110a0111110011101111111011111011111111110111011101101a1001110011111101111111111001101101011101111111111111111011001101111111111111111111111110100011000011
111111111a1111111101111111110111111101111111001011011110111a1111011111101111101111110111111111110100011011111111011001010111111011111101111101111111001110111111
