11 26
144 79
78 98
151 42
145 5
137 70
84 74
99 77
115 88
85 8

1100111100000111111111101111111111111011111a01111111101010110011111111121011121b10012221221111122112211001111111111111011111111111222201221222111222122000201222
1111111111101111111110111001101111111101101a11110111110101111111111111201121102a10021211121210011002111111000100101110111111101111102021001122211221021222212212
1010101111100011101111011110111111111111111a01111011100001111111101101212112112b21002211112221121222211111111111111110011111111111120101012222212111212220220022
1111110111111100111110111011010110101111111a00101111011111111110010111111020101a22020202211112211201211011111111111111111111111111220020110122221101012221001021
1010111111111111111110110001111110111011111a11111101111111110111111111111201121b22120011011021212122111110111110111111111101100110210202100102120220022212111120
0011100111111111111111111101111111110111101a01111111110011110101101111110012212b22122221122212120022101111111110010111111111000111212212120222121121012212201102
1111101111110101111110110101111110011110111a10111111111111111111110111112000210a22221211011201011112211111011111111111111001111111120022220112100102222211222022
1111111111111010101001101101110111111111001a00111111011101111111110110102101101b12211212111220000212111111111111111011011111110011121101122202001011012111121201
1111110000111111011111111111101111111001111a11111001100111111000111110212222222b12211202112121101111211111111011110011101011111011220102212102212210011221221101
1111011111111011100111111111111011111111111a11101111111111110111111101200112212b21221202221112011100111111100011111111111010111010122101210121222202000212220122
1011111111101111111100111111111111110101111a01111010111111011111110111122002010b12122101111020122122201111111011110111111111011010010120122221100101212010121201
0101100111111110111101111111101110111110111a11111110111111101111110111022120002b12220111222221120111111111011111111011101111111111212112120122212112022222211020
1110111111011101111111111111011111110111111a11111011110011011111111111211112121b12211011221012211021211110110111111100111111101001111222120011121202212102122020
1111100111101111111001111111111110111111110a11111011110101010101101011121222111b10022111011110212112101111111101111011101011111111221221221222102122012021122021
1111111111111101111111110111111110110110111a01101101011011101111110111222110221b20022022212101201121111111011111110111010111101111021211012210112200201212112211
1111011111111111111001001111101111111101111a01001101111011111110111111112110122a12122210020022201110201111111111101111101111101111212202222211012120022210212222
1111101110110110111111101111111101010111110a11111111111111110111111111222001222a21212002212222122211111010111111111111101111011111121120102102111221111100122122
1101111111111110111100011111101111111100010a01110111110011111111010100122221122a11021112121222122102111111111111111011111110111011221122122222122220111200111122
1111111110110101011111011110111011111011111a11110111110111101111101101222122111b11010211012112121012211011111111111110110111111111022212120212012121102212121101
0111011111001111111011011101101101111111111a01111110111111101111101111120200121a21002212121211221200111111010110111111101101111111010111102122112211222102210221
1111111111111111111011011101010111011101111a01010111111011111011111110110212220a01222200122102102122111101011011111011111111011111002221022210211121212011220222
0101001111011111011111111101110101101111111a10111111111101011101011111020012211a02222110021220212120111111010111111100111111110101211221221211002012121121100001
1101101011110110111111111111111001111110011a11111110011111111011011101121012210b12212101111122211222011111111101111011010111111111121122121201122212121122112212
1100001111111101101011111011110111111111111a11111111011011011100111011212222021b11110222212021122121111011111101110111111011001111102121201111101122000221200111
1101111111111101101110111111110011011101101a11101011100011011011111111120022021a12201220202220101212100111111111111111111011111011122011221221111122110102012221
1111111110101111100110111111110111111101101a11110111111111111111101110111221101b20111011110211222022101111110111100111111011111110111120012200112112121020110011
11111011000P0111110111111111011111111001111a11111110011101111010001111122100112b21210211211121121111211111111111010111011110101111112121122202200211211011212101
111101110101PPP0101010011111011111110101111a11011111111111111111110010201112112a12211212221212222112111111101111111111111110111111201200222012120221202220212222
110111011010110PPPPPPPPP0110000111111111110a10010111111111001110111101111112122b01021121221222012221011110110111110111110111111000221112220120000212220210100221
111111010111111111010111P000111101111111111a11101101110101111111111101222021211a02210220210201012212111010100110100111111011011011112100202220222222122100022222
0111111011111111110101110PP0111101111101110a11111111001011111111111101212222221a11111121112210111111111101111111100110111111111011102201221202220222221122112022
111110111010101101111111010PPPPPPPPPPPPPP10a11101111111111111110111101111111111aaaaaaaaaaaaaaaaaaaaaaaaaaaaaaaaaaaaaaaaaaaaaaaaaaaaaaaaabaababbaabababababababab
10111111101111001011101111011101101010111P0a11100101111111011111011011111111110111011110110110111111111101111111111011111111111111111111212212122110202101010221
111011110111111111101011110010111111111110Pa11111101111101001011111111110111110111111110111011111110111111111111010111101011110111110111111212212122112222201112
1011101101000011111111111011010101111001111P11100110110111011111110011111011111111111010111101101111011111011111111111111101110111111101020210222022122120102112
1111101111001101111011101101111111111011111P11010111111011111111111111011010111111111111101011111111111100111001110101111111111111011011101112112222221212211201
1110111111111110001011111101110111111111111P01111110111011111100111111011011111010001110110110111101111011111010111100111011111011101111210001201221121222221210
1110101110111011111101111100011110111111011P11111010111110111110111111111111111101101110111101111110111111100111111011111111111101111111212110200122112122111210
1111000111011111110111111101111111111011111P10011111111110001111111111111111111100101111111111111110100111111011111011011111110110111111212021022120120212101212
1111010001101111101111111101011001111111111aPPPP0111111010110111011111110111111111101111111110110111110111101111111111111111111011011111012221211121122201021111
1011111001111111111101111011110111110111111a1011P011100110111101111101101101111101110011111111110011111111111111101011110011100111011111122110222101010201220001
1111111011011110111111111011111101111111111a11011PP0111111111110111100111111011111101111111111111011011111111101110111011000111101111111112111121112112110220111
1101111011011111011111111111111111111101111a1110111PPPP011101110111111110010111110111111010111110111001001110111111110111111010111111110021211220122202221211120
1111011110110111101111111110111111111111111a10001111111PPPP10111101011111111110011101111111111111010101000111111111011101101011110111111111211202221212222111110
1011111110101111011111011111101111101111101a111011011101011PPPPPPPPPPPPPPPPPPPPPPPPPPPPPPPPPPPPPPPPPPPPPPPPPPPPPPPPPPPPPPPPPPPPPPPPPPPPaaaababbaabaababbbabaaaaa
1111011111111111111111111111110101111100110a001101100111111a111010111111100111111111100101011101111111100011110101111111111011111110101P100212111211110002102201
1111111111110111111011101111111111111111111a111110011101111a101110111111111010111110011111111111111011111111111001011101111011111111111P202221100221012002222222
1111100111111101111111111111111111011111111a101111111111111a110111000111110111111111111111111111111111011011111111111111111111100111111P221212111102211022212111
0100111111111111111111111111011011001011101a110111101111111a011110111101101111110011110111011110111011110011101111010111110111111111111P222211122202221012122211
1111010000001111111011111111111111111101101a111111111111110a011111101101111111100101110111111101101011111111111011110111111111111111111P201020222020201121120211
0001001111111001101111111110111111111001111a101111011111101a0111011101111101111111111111111100111111011111111011111011111100011111111111P21121211201111221022222
0111110111111111111011001011110100111111111a111111111100100a10110111111100101111110110011010110111111111011101111111111111110110111111111P2012022201122220211221
1111110011111111111111110011111110111111111a110010110111011a11001111011111111111100110011010111101011111111111101111111100100111111110110P2120112201211112101102
1011011101010100100011101111111110001110111a111111111110111a110011110101111101101110101111111101111111011011111011011111111111111111110020P112122021201120221111
1110111111111110111111111011011011001111011a111101100111111a111001111111001111100111110111110111111111111111101111011101111111011111110121P121210122220122222210
1110111111111011111101111111011111111111111a111011011111011a1011101111111111111111101100100110111111111111110110111111110111222022022211222P20122022212201112211
1111111011111111110111110101111001110111011a101000111111111a1101111011110111111111011111101101111111111111111111010011111112110020221102022P20212100222212200012
1110011111011111110011101001111111111110111a011101110111111a1111110011110101111110101111111111100111111111100110111011101022112221012202022P22221111222221212112
0111111001111111111111111110111001111101011a110111111111001a1111100101111111101011101111111110111111111011111111111110111022011121220210110P22122221202101111111
1101011111100111101111111101111111101110110a111111111100011a1011111111212220122221011012221121220102111001111101111111011021211202011100211P20122112212021011111
1011110111110111111111111111001111111111111a111111111111011a1101010112020122201112021210212021101112010011111011111111101112212021110211022P20122111012211110011
0010110111111110111111110111101110111101110a111111101111111a11101101001201201211101122121012010202011011110110111111011110012212221012122201P0221102101201001111
1100111101111111011111110111110101111101101a011111111111111a00101111101220110112110020221222221212112111210021121120111101010021111202011000P0121222112201001101
1111101110111111101111111111111111111111101a111111111111001a11111100122020111112021102122102221222101211222221201101110111111120111202120121P0100122111210011111
1111101111111111011111011110011111101101111a111110101111011a111101110202200221220112012112110222020222122012211210210110112120211010221122110P222021012221011011
1111101111011111011111111100011011101111111a101011111111111a111001111112110121211102220122221222201002000222011012001101111211221222111012122P011122021221100111
1111111001001111111010111111111111011110111a011010111110111a1000111112211222111222110222222222112202120222111012221111111012222201110022210112P00110112021110011
1111111101111111111111111111110111101010110a011110011110111a1001111111011012121111012221212122002202112220021211221110111112201112100211122112P12102011020111111
1011111111110101110111001111101101111101111a111100111111111a00111110111212221212121121222211122120020222222121122121110100111212122121121211202P0021000121111111
1111111111010111111111111010001111111110110a100111111111101a111101101111110120202011222020022221212111111210210122211111110122111222112011212110P202011121111111
1011101011111111111011111111111111011111011a111101111011111a1101011112222111122111020222202122222212112111211210120111011010101020201000111111222P12122101111111
0110111101101101111110110111111101100101111a011100110111111a0010011110111010222110121222211200222212221012022011200111011011020111212221121202122P12202011011111
1010000111111101000111111011101111010011100a111111111110111a1110001112012002021011111012122002221222102101210211022111110022022022210111212101211P01111110111111
1111111011111110011111011111111011101110111a110001111111110a101111101220102112021222222202102120210202022201200222211010122220222002211112211012P000121211111111
1111111100111111011101111011110111101111111a111110000111111a1111111112212211010101112020210222101202220221002021101120122112021222022221222202020P21020201110111
1011111011111110011111001110111110011111101a111111100101111a1111111111211220222201202202222222021201200220122012022200201111020022021201211111202P12112211011011
1101111111110111101111111111111111111111111a111001111111111a011101111022120101220121212212222202222222221210222212012221220221202100221101020120P101100201110111
1111111011111011111111111111110110110111111a111111111101111a11111110122211122211222001222220212222211020212222210202200212111222220002111222210P0222111121010101
1111100110111101101111111110111001111111011a111111111101111a10101110120101202202012120222212212222222121102221221211121221222110122012221221110P2222211121111111
0110101011111110001101110100100111101111110a111011111010000a11101101112111112222211211220220222222bbbbababaabbbbbbbabaabbaabbbbbabbbaaababb22220P111212211011101
11111101100000111111111aaaaaaaaaaaaaaaaaaaaa111011111110111a11111111111212201122120201002222222222b122201102121020111202122001220202011110b112221100112021110010
01111111110110111111101a11111111011110111010101111001001111a11100101021222111211022210211110212202a222022102111222211111110222220000122222b222122221211211010111
11110111111111111010111a11011111110111111111111101111011111a11111011020121220120221122110021100022a222112202212221011122222220212122121210a010120201100211111110
11100111111111111101111a11011011011110111000101110111011111a11022102200212212122122222122220222210b211122221222220221121120002122200012210b101212122110111101110
11110111101111011110111a11101011110111101010101111111110010a11122210022012222022222202201221221220b220122120222222112221120201121121122102b121020220002021101111
01111111100111101111111a11101110111110110110111011111011110a11122010120122210220222022202202122100b002210021222222000022221212210220011022a112111122111200111011
11011111111111111110111a01101001111110111111100110111111011a10111222002202222221222222000222221202b202222201102022122020120200202201110111a010111010111111111011
11101101101011111110100a01111111111111111111110111111111111a01121212222222220222000022220002221122b222212122222122120221111202120201110111a111110110111011111111
01101111111111011001111a11111111101100111111111111100111111a11101211220222122222122222222222022202b221201111212122220112122121212121011111a011010100111111111111
11111110101011111011011a01101111111101111100111111110111111a11121210220220222122222222222212020112b112222211220212210221121102201121111101a011010111011101110101
11111011101111101111100a11111101111111111111111111110111101a11112221120121121222200222212220222110a222221220012221102020110211211011110011a111011011110111111111
01111111101011111101011a11101110110111011111111111111111111a11112121222021002111221220212012211010b222222021222222112222221102222221110111a111110110111101111111
10101111011111111101111a11111111111111110101111111110111110a11022222212021112222012222200122221021b102220222220222210011222100211011111001a110110110101111111110
11011111011100111111111a01111111101111111111111001110111101a01022211120220112101101112112211111111a100100222220122021211120120122021011111a011100111111111011010
10111111101011110111110a11010011111101101111011101011111111a11111021121222211111212221112122211111a120222122101000112210011202201011110111a101110111110111110110
11111101111011110000111a11111101111111011111111110110110101a11101220122211220111222112020020011111a121111211122111102001121022101120111010a011111111110001111111
11111101111110111111111a01110111110111100110101011110111011a00122111112221110120222101122011121111a001221002122120221221110221211201011110a111110111101111111111
11011110111011111111000a11111111110100111111101111110110110a11022220200221011222111112212220201000a112011212211121212021210012001201111111a111111100101111010111
11110101111111010111111a10111111111111111011111011111111011a11112011111111122202120101221222201111a111201021221212222120222211211121011111a111111011111111110111
11111101100111111111011a11101011011111101110111111110111011a01111211101212202102120220122121220011a120121110222001122202011212120111101111aaaaaaaaaaaaaaaaaaaaaa
11110111101010101110011a11111110111111111111011111011111111a11111221021122011220120121011012121111a1202011021122121012122200102212111111011111111111111111111111
00110111110111111011111a11011110111111101011111101111011110a11000112122112212212210121110121111100a0001010221122012122121120201010211011110111111111101110111111
11110111011110111011111a10101111011111111110101100111101111a11110011010222111201212002211121221101a1121122220002210011101220221101211100110011010111100101111001
11110111101111101111101a11111010110111001000111111101011111a11121111220110222021212022221121211011a1021222202220121121210222012120211111010101111011111100111011
01111110111111100111111a00111111101011101110111111111010100a11011222012211221012211122101112101011a1111101111111000111000111111111111111011001111101110101011111
00111111111001011111001a11111011011111001110110111111111111a11112121101121012212111221101221011111a0101101110111111011111111100111010111111110111111111111111111
10111101111111111111111a11111111111111101101111111111111110a11112222201010222210020011121020021110a1111111111011011111111111111111110011110111111011111111111111
11111111111101110110111a11111111011101111111111110110101110a11112201212111211121110222122122211011a1111111111111101111100111111110011111011111100100111111101111
11111111111001111110111a11111111111111111111111111011110101a01111122122122001110210121010111211111a1111111101011111111101111101111011111011110111111111011111111
11111011111101110111101a11111111011111110111111110111110101a11101122012102102112111121121122211111a1101111111111111111111111110010111101111110111100111111011111
11011111101101111101110a11101111101011001110001011001101111a10110121102200111002012212222212121111a1101011111111111110111101101111111111111111011111111011110111
11111111011110111111111a11110110111111111111101111111111010a11012102001011010111122222112021221000a1011101110111110111111111011111111101111010111111110111111011
11101101101011111011111a10100011111110100001111101011011001a10110111110020200202122002110222101100a1111001101011111010111111111110111110101011111111111111111111
11111101111111111011111a11111111100111111110111110111111011a11102102121220022112112222220212221111a1111110110111111011111101100111101010111110011111111111010011
11111110110110111011111a11111101011110001111110111111111111a11011011111111111111011111111111101111a1111111101111111110111011101110110101101111111111111111111010
10111111101111111110111a11111111101101110011111001101101111a10101111111110110101111101111011111111a0111111010111011110111111010111011101111011111111111101000110
11011111011111101010111a11101011100111011011001011111111111a11011101111111101111111111101110111110a1110111101111101111111111111111110110111101010111111010011110
10101111010100111100011a11111111111111111101111011111111011a11110100111111101101111111111101111011a1100111111101111010111001111101111110111011111111111111010011
11111101111111111010110a10111101011111111111110100111111111a11110111101111011101001111111011111110a1110111100111110110110101011001111101001101110111110101101111
11010111101110111111101a11011111011111110111111101111111101a11111101101101110110101111111111111111a1111101111111111111111111111111101111111010110111110011010111
