154 116
72 10
78 98
151 42
145 5
137 70
84 74
99 77
115 88
85 8

011111100111010011111101010111111011a111111011111110111111111111101111122120012020111200101111022112011111111111010111011111101111222222001012221012222010201022
110111111111111011111011101111111111a011111101110111101011111100011111201202022110122022112100121212211011111111111111111110010110221110210201012122010210220221
111011111111111101111111100011101110a110111011111011101011111111011111200112212211221212212100102201211110111101101011111111111111112121121020012122102222121221
111101111111101111111111011111111010a011111101111011100110101110011101212022222122221011201221110012211110111111111111111001111110110122122211021211111110112212
011111011101101111001110111111111011a111110111011111110101111111111101121222021120201110022101221212200111110111111110011011111111122221222212121202211102202210
111010111111100010111111111111101101a110111111111111110001110011111110111212221211221112102222200222111011111101111111101111110011202111222221120112112222122221
011100111111011111111111111111111111a111110111111110011101111001100111120121101121102121201202211112111001111111011111011111011101111110122212022022221011212112
111001111101000111111111111111111111a110110111111111111110010101111101211222211121122010022211021211201110111111101101111111111111202221221112021111021112111110
aaaaaaaaaaaaaaaaaaaaa111111010111010a011111110111111111110111111111101111221210021221111022122211112100111111111100111001101111111222211100211222102111020211020
11111111101111010111a110111111101010a011101111000111111111101111111101121102202112101021211220001112111011110111111011111101111111202011121202112001111112122122
01110110001111101011a010111111110100a111110011111011111111011101011111021120222211211012111112101101211111111110011100101111101011112101122112211211221221011110
11101111100010110101a111111100111111a111101111010011101011101011111111112112211012002212102222221201111111111101111111110111111111021222222222011121121120011112
11101110111111111111a011011111110101a101110111111111101111101111111011111122001222121220010212122120210111011110011011101111110111222121200211112112111212111221
11001101111010111111a111111111111110a101111100100111111111111110111111221100011011012021121121010212111111111111101111011110111100221211211212201020111212022220
11111001111111111111a110111101001010a101101000100110111011001111111101111212011110112011202212211011110111010100111111101111111111112112222000110122212102102121
11111111111001110011a101110110111110a110110111111111011111110111101111201011121111111221111110110110111111101111111110110011111101012122111102120222010212120201
11111011111111111101a111110111111000a110011010110111111111111111111110120212221201120210221122121212201111101111111101111101011110122112212221202121120012102222
11110011011110111111a110111111111100a101111101111101011111101110110111120111120111122021120002201121111111101111111111111100011110122122211121102120101120122021
11111101111111111011a111111101011111a110110111111011111111111111011011020112211022201201020121121121210001111111111111011111111111221121101221021110122221012020
01110101111111111111a101111111111101a110100001011111111111110011111111102212201102211122011201201021210111111111111110111110111101021202120112111201011120111111
01111111101110111111a111111110110111a011111101111100111111110111001101201120121122000222102112012212111111111101011011111111111111222121121122212011221012112120
00111111110110111111a111111111111101a001111110001111111111111101011110110222120221021122111111011122211111011111110111111111110111111100022112001122121200021221
10111101111111101111a011011010111111a111111110110111111101111000111110101121212120022112110222112221111011011101001011111110010111201221212122201210220120120220
11111111111111111101a100111010111111a111111111101111111111001111011111111221111101222022222212122222111111110100101010101011111100212222222211222202000201112022
11100111101101111111a111110111011111a111101100101111111011111111111111111111122222122112012211101001000110111111011111111111111100121122111022202112112221011222
11011011111101101110a110011111111111a111111011101100111111101111001111222112112202001011121212001002111111011110111111110110111111121022112010111222112221011100
11101101110111101111a111101111111111a111111011111110111110111111111011222122222221211221122121112221211111111111110111101111111111112212022221121011120211222112
11110111111001111111a111111111110110a111101111011111110001110111010011211002102121020121212211110211010011001111111100111111111100110221122010210020012212001222
11111111111111111110a101111110111110a111011110111111111111111111101110221112221212122012111212111122211010011110111010110111111101211221210000222122012222212220
01110001001111111111a111011110111011a11001111110011101111111111111101010211102212210011012221111122bbaaaaaaaaaaaaaaaaaaaaaaaaaaaaababbbabbaabbbbbababbbbbbabbbab
11111100111111101101a111011111100111a00111010111101011111111111111111111220120101122010022121202112a011011110110010111111101111111221211122222210202222210021212
10110111111111101101a001111001111111a11101101111101111101111111101110111111111111101111110110111111a111101110101111111111111111111011001211221122112211212101222
11101111111111101010a111111111100011a11101110101101111110100111111101110110111111111101011110111110a111011110111101101011111111111111111111111111212112022211222
11111111111101101100a011101111111111a11101101111111011110111111100110111100111111111110111111111111a011010001101111111001010101110101011121111122201200021020111
11011110100011011111a111111110110111a11111111101110001111100111111001111111111111111111111111111110a111111101111111111101111101110101111220101212122110011112021
11110011101111110111a111001111011111a11111111111111111111111111111111111111111111111101001111111111a011011011111111111011110111111010110201112212211100001220110
11111111110111011111a101111110101111a11111011111111111111101111011011001111111111111101111011111111a111111011111101111111111111111111101210102122121002212121111
10111111111111011110a110100110111111a10101110111111111011111111111111001111111011011111110101111010a111110111110011110111111101111111101102011220012210021121111
10111101111011110001a111111101111111a11111111111111101011110111100111110111111111111111110001111110a111111111111011111000101100101011111021211211122122221202020
11111111011110101101a111111111011111a11110111111001101111100110111011111111111011110111111011111111a111111111111111101011111110111111111222122022222111211021101
11111110110111111111a110111101101111a11111000111111111001011111111010111111010111110011110111110111a100010111111110111101110011111110001221011212202001110121021
11100011111110111101a111110101101010a11110111011111110100111101101111001010111111111111111111011111a111111011111110101101100111101101111112122221110212120000211
11111011111111111111a111111111111010a11111111110101110111111111111011111110101111110001111111110111a111100110101110111111111100111111111110211112112210210121002
11111110111101111111a111111110111011a11101011011101001111011010111100111110111011110111111011011101a111111111110111101011110110111111111221022222012201021212221
01001100111101101101a111101111111111a11110110111001011111111101111101111011110111011101111011111101a111011111110111011111111001010011011012111212221200211101121
01011111101101111111a111111100110111a11110101111111111111111111010110111011110110111111111010110001a110111011011000111111011011111111011011111220222100210212222
10111110110111101111a101110011111011a10101011111100111111111111111110110100101101111111111111111100a101011111101110111101101011101111111122201210211211211100111
11011111111101101111a111111111101111a11111101010111111111011110111101101111011110111111101111001110a110101110111001111111111001111011101210110110201101122100102
11101111101110111111a111011111110111a11011110111111010111111000110111111111011110101101011111111111a111110011101101011111111100011101111221020121001021211222201
11111010111011111101a111010111011111a00011111011110111111111111110111110111110011111110111011111111a111110111101111111101101111111111111102222111110222221012111
11111110011111111111a101110111111111a11111111011111111111111101111111110101011101111101111111111111a111111110111111101111010111111110110202021122111021122111020
11111111101101111001a111110011110111a11001111111111110111011111111111101110000100111111011111010111a011111111111011110111111011111110101221220110001011120110111
11111111000111111111a111111111111011a01111110011111111111111110100111110011110011111111111001111111a111110101111100111011111111100111101100100221212121222221211
11111011111100100110a111111100111101a11111111111111111111101111111111111101010111111010111110011100a001101001011111111111101111011111101011221201112000211211111
11111100111111110111a011011111101111a11101110111111011111101011000110111111111011110111111111010111a111110101100111111111101101101111010222220211200112111212100
11111011111111111101a111101111011101a01110111111011111111100111111111101101111111111000101110111111a110111111111111111111121220122001221122200002220120222212121
01011111011110111101a111111111111111a11111000011111111111111001011101101100111111110111101101111110a101111111111111011101111222110202121021222222222222022212101
11111110011111101101a111001001111100a11011111111011111110111111111101111011111100111101101111111111a111011110111111111111121101022112221201222220211001222211121
11100111011110111100a011111101111111a11110011111111111110111111111101011111111111010111111101011111a111101011110110011111121220122222201220012200112122001111111
01101110111110111110a111111111111111a11111010011101011100101110011011212102221212201101012122210201a111111011111111011111112211101211212120021120122201121001101
11110110111111101011a010110110111111a01101101111111111011111111111101121220111012121221111100222221b111110111111111011111111111121111102101012121211221201111111
11011110111111001011a111010100111110a10101101011111110011110111100111211221201201120121011212002120a101111011111011111011112121121220110212212211200201221111101
11111101010111111111a111001011111011a01111111110111111110111011110111010222102010112122022001022201b2000012221122121101aaabbabaabbabaabababbababaababababaaaaaaa
00111101110111111111a110111011100111a11101111111111111111110111011110110220210012011220212022212022a2221221221021211111a0012111121010011022201211020220210111111
10111111111111100101a111101101111111a10011001111110111111110111111011002002112120102122122222020110a1212221120210121110a1112112100101212121222011011222211011111
10100101111111011110a111011110101110a11111010110111111111010111011110212021201201111222202221022212a1012121120212201101a1112202121201121201221012100210121110111
11011111111101111111a101111111111110a11101111111110111111111110111111201120110012111122120000022022a1101021022122120111a1101222112221012210222121212122121101111
11111110100101010111a111110111011111a11010101111111011110111000010111122222122122212222201222211121a2100221212112120011a1120101221021011211121112011001011111111
11111101001111111011a111011110111110a01111111111110001111110111111111222021101211221022222220012222a1222122220221021011a1112201021111211020011001211212021111111
01111101111101110110a111111110011101a11111011111111111110110110111111011211001022012122221221212000b2122112202201211011a0112211222001221212002120221012121101101
11011111011111111111a011101110111111a01100011101111111111011111111111121121121121101022222222121222a2111021112121011111a1112100112111212221122121212021210110111
10111111111111111100a101111011110101a11010101111111110011111111011111120210121112121122000222221112a2221022121112121111a1121200111212010211111122211122221100111
11111111111111110010a111011010101111a11110101111111100110111111001101121202001212021022110211222222b0222212021221221110a0101222211202221000011100021121211111111
11100011111111111111a101111111110110a11101001110111111111111101111011121221100121212120222202220200b2022222220220202121b0100022221102122011111010222121101101111
11101111110111111111a101111011011111a11110111111111111101111110111111220112102220202020112012221102a2222111222020121211b0221222022021110222100021221112121110110
01111111011111101101a111111101111111a11101111110111111111011111000011001222222120112001202222222222b0001222101200020202b1021201111222020101112101222002111111101
11110111111111111011a111111111111111a11111111111111111101111111110101112102211111110222211221112122b2222201012212022112b1212202022221120111111111222211111111101
11111111111101111110a101111111110111a11111101111101110110111111111110022222222011001122001212022122b0002221222102121120b0000222220011220121212011122011111110101
11110111101111111111a111011011111011a01100111111111111111111110011110002202112220112111221002102022b2200122022222121212a1202002212221212021101121112201110111001
11111011111110111111a101111111101111aaaaaaaaaaaaaaaaaaaaaaaaaaaaaaaaabbabbabb0212102200212022022222b2020202112012022211a0012222222222122122122212210011101110011
11111111111111111111a1110111101101111110111011101111111101111011111112112122a1122022220222210122121b2002221122210222211a2212222112220211221220210112121201111011
11011111111011011001a1111111111110111001111110011111111100011011111111000221a2100112222021212121201b0001202222120202202a0120202022221220101122012011111101101011
11111110111111100111a1111111011101111111111011010011101111111111111010020111a2122110121022122211012b2122222222221111210a1222212222222011210212021202101011110111
11110111111110101111a1101111110111011010111111100111111111011110201011222202b0221212020201022202002b2220221012221002111a0221021212201121120201121212121121101011
11101110111001111011a0101110111110111100011111111111111111111111211212122212b2022222222222222122022b1002122202020011200a0122122221222122122211212111101211111111
01111110111111011000a1110111111011101111111101111111110111111112221222020002b2201111202000000201210b2221212212122201212b2122122222212121211212022100100101101111
11010111111111111111a1111011111111111100111111111111101010111012011211122021b1122102212120222002002b2022211111220220212a1112122221210111011111111111011100111111
01111111101111111111a1011111111111111101110011111111111110111010212011220201b2101211000122020222122b2021222122210122011b1120101122000011111110111111111111111111
11111011111101011111a1011111111111011101110110011111111101111010210212222012a2222122222222022021221a2022220022221212112b1211212221211111101111011011111101111111
11111111111011010111a1101111111111111111110011011111111101011111201200112222b2022002220122122221201b0122022211012222212a1201211012110011110111110111010111111110
11111111111111101011a1110110110110111101111011011111110111111110121120121122a0110222122222222212211a0222222000222211111a2021221011211001110010111111111111110111
11110111110111111101a0111111101110111101011111101111111111101110121121000200b1202200122222221222001b2222022220122222102a0000211222211101111001111111110111111110
10110010111111111110a1111111110011101111111110101111111011101112010220111120b1002110021111210012111a2221221222022212212b1111111212211111111111111111011110111111
10011110110111011111a0111111001001101111101110011111011111101012111210210221a2211000122102212210111a0021211201101102212b1010102202101010111111111101011111111011
11101101111111011111a1011110010111111111111101101111110001111012211211120112a2012221101011220211111a0021212221121120122a0222000112011111110110011110111101010111
11111011111111110111a1111111111111111011001111111111111111111110102201021202a1202221111222101211111a2111110110220112012a1121221110011110011011100110111010110011
11001011110010011111a1101001111110111100111101101111111111111111111202220122b0221222222222120111111a1101102211021221021b2101221121211111011101111001101111111101
10011101010111101111a1010111101101011011010110111111101111111012122011212212b1022112101100122211111a1002211002002222210b1112211100111111111111111011101101011101
11111111111111111111a1100111101110111011101110011110110110111110121121210110b1110221212022121210110a1121222121121212210a1011221111211111011111111111110001111011
11011111111111101111a0111001111110101100011111110011111011110111100021102210a2122110012121112110110a1210221220112022201a0111012111111111111111010111110011101111
10110011111011111011a1111111111111111011101111101011011111111111120212220122b0101012112222101101110a2212111211112212110a1222111110211111110001111100111011111110
10111101111011111110a1101111010011111010111100011111101111101111102212100211a2021122112020211111111a0220220122212212102b2112121001201101110111111101111011110111
10111011111111101111a1011001110110100111111111110111011110111011112120110022b2020011111121111111111a1222212101021201111aaabbbabaaaaaaaaaaaaaaaaaaaaaaaaaaaaaaaaa
11010111111111111110a1111111001111011101101011111111110111111012221101121110b1121120211212220111111a122220220120212220012212121112201111101110010111101111011010
00111111111110111011a1111110110111011111101001111110001111111112111020222111a2212121121201120101111a110010101111111011111111111111101111111111011111011101111111
11111111001111111101a0111111111111101111011111111111111010101112022211022212a2210022201112220111111a111110101011111110111111011101111101110011001011101111011110
11110111111101101011a1111111101111110011111111101110101100111101112110122221a0221011221222221201111a111111110111111111101111111110111111111111111111101111111111
11111111110111111111a0001111111111111010110111101111011111111110120010211002b2222211220112122111111a111110101111111011001101111110111111111110011111001111111110
10111011111111111010a0101111111111111111111111111011011001111101211111001112b1221111111222021211110a111111111011110011111111010111011110000110110111111111011111
11111101111010111011a1110110110110110101100111101111010110111002212212000121a1222122222212122111111a111111101011111111111011100111101111111111111111111111111011
11111111111111111111a1111101101111101101111111101011110111110112022122101100b2010202110102022210111a101101111001111101111010110010010110110101111111011100101110
01101111111101011111a0110111110110111111111111101110111111111111102200122212a1012211200110212111101a111111111101111111010101101101011010010111111111010010111111
01111111111110111101a1101111111111011011111111110100110011111111202110111102b0211111120202122110111a111101110101110111101001101111001110001011111101111111111111
10111110100111011111a1111111111111001110111110111110111111011012022012122120a2112011122212111211111a010101111111111111001111011111001111111011101110110011111101
11111111110111111011a1011011011001111100111011111110011001111001111110111111a1110111101111111110011a011111111111101111111011011011101111111101101111110001111101
11110011111111011111a1111111101011111101111111110110001101111110001111111110a0111101111111111000110a110111111111111110110111101111111100111111111111010011111111
11111001111101111111a1111111011111111110101101111110011111010011111110111011a1111101101111110011101a111111111111011011111011111101010111111111010111111111111111
11111100111110111111a0111111111101111111111010111110111011101111111011111111a1111111011011110101111a111100111111110111110001111111110011101111111100011111111111
10101101111101111111a0111110110110111010111011011010111111011011111111111111a1110110111111000011011a011011110110110111011111011011101101110111111011110111111101
11110111111111110111a1110011110010110111100111111101011110110111111111111110a1111101110111011111111a110011111111111011111111101101111101110111011110111011111111
