2 8
143 24
78 98
151 42
145 5
137 70
84 74
99 77
115 88
85 8

111101011111a01010011100111110011101111111011110001011111001111111110122220122100210112011112120022221110001111111111111111111a011022221112112111002002100a12121
011111110111a10111111110111110111111101111101111111111101111101011011111211120201221020012202022021211111011111010011011000110a111021122112210212010211102b11102
100101111111a11111011111111111011111111011111111011111011111110010111101121022122212110110012112110211111101101011111111011101a111112212202221121210222100a20222
101111101011a11111111111101111111111110001011111111101101111101111111120220121220120202122011110022011101101111111110100111110a111222222022221211022112112b21120
111111101101a10110111001101111011110111101111111011111111111111001111120111112111010201102111221121221011010111111011101011111a111222012221111020121122022a02112
101001110111a11011110111101110111111111111111110111111111111111101110100101102022122212202120121112021101111011111011111011111a111222202122111022112112120a10212
111111011111a01111000111000011101111111111110110101111111111111011111011111110221211002112022211202111111011110111011011111011a110221021111211102221211222a12011
111111111011a11011111011101111010111101101110101111111110111111111110101222120210102201011120112112021111111101101111011110111a010202120110211212221222211b11201
110111011011a01011111011111111010110110011010111100111011111011111111101122202022010220022111112001010111111111010111111111111a111220221020202121012212211b12211
111110111101a11110111111111111011111111010001111010111011111101101111111022222222120101122211222222220101111111101111100000101a111011222210110212221211122b02210
101111011111a10110101111111111111100011111111111111011011011011111011110121111111122222202202121121120111111101111101111101111a101111211211211112121110202b12111
111111110111a11111101111011111111111010010110111110011111011001111111121212110122111001212121211221121110110111011110011011110a110120010122111201212010022b12101
111011101110a11111111010010111111111110101101111001111111011111011011001211101211221010210112021112011111111101111111111111110a110110210221110212022221111b20222
111011111111a00110101111101101111110101110111111011110101111111001111121122212021211202001212111212220111101110100111011111111a111120011102111120112011010b22022
110111111101a11111111111111111101111100011111111100011111011101101111112221122202011120212211222101221100111001111011010111101a111011112112012112101122210a12022
101011101011a00110110111011101100111111111111111111110011111111011111101222112201221110211120011221211110101001111110111011001a111202122222121111220022102a21200
101111111101a01010010011110111011111111111101111111110011101111111111122222101111222111112221211211011101111111011011111101001a011120202210122200221212201b21202
111101011111a11111111111101111110111111111111111011111111001111111100121022121100211212212211101220110111011010101011111011110a111120122022011212222121111a11022
110011111110a11111101111110111111001101111111111101110101111110111111120011220211121020121002112112210111011001111101111101111a111212210002121012120221222a22011
111011111111a11111010111110101110100011100111110111101111111101101111000122211212201111112200211111121110011111110001111011111a001122222110102111222200122a22112
110011111011a11101111111101101111101101110011111111111111111011101011101211211100022222122020200221221111001101011101011111111a111111210112001122011222112b12221
110111111111a10101111111111011111011111100101110101110111111111110111111221211220222200211222101010221111101111111101111011111a111222021021110111120111020a21221
111101111101a00111111111011111111111111111111111111111010111111101111111100121120121222011221220121211101101111111100111111101a110011221002112121001211211b21222
111111011101a11111011111101110101111110111011011001001110101111111111122212112111210110222220212112001101111001110111100110001a111022112120022212112102212b01112
110101111110a11010011011111011010111111110011101111111111111111111111012121201210100021211122212122211010011101101111011111111a111101011111220221021212111a21102
011100111111a11010111111111111111101101101011111011001111111111111111111222121111122222110020212112120111111101111111111111111a111001122112112102012222201b11121
111111001111a11111011111111110111011101101011111011111111110100111011122102121102212212121120202102221011111111111110110111111a010120221221212012220111100b22121
011101101101a10111110111111111110111111111111101110111111011011111111111221202011222022112020221211111110110101111111110111111a111110210022221122220212222a22222
101011011100a11111101010111111111011111101101111111111111101111101111100111012210121122202122012001121111111011100111110110111a111002211202222220102222022b02002
110111110111a11111101110111111111110110101111111101111100111111111111022210122012112110221111111112220101101111111111111111101a011211222222212210222222222b22120
111111111111a11100110011110101111111111011111110100111111101111111111121111021112120001210200011110211111111111111101111101111a101211112211011222220221202b01221
111111111111a11111111000011011111011111111110111111110111111111111101111011001011010100111111111101111011111111111111111101111a111010110121101122122202112a02111
111010011001a10111110111000110111111111110110110111111111011111000111111111111111101111011111111110011111101111001111111101110a111111011102222010212002012a20020
101111111100a11101110111111110111111101011001111101011011111110001101111001101111111111111111111111100111111111111110111011111a011111111111012010210020222a02121
110111111111a11111101111101111111111011111110001110111101111111001101111011111111111011110111001111111111010110111111111111111a101101111122211002112111120b01211
110111111111a11011011011111111111100111011111111111001011111101001101011110111011001101011111111111101101111111111111001111111a111110100121022201222022211b11122
111101111111a11111111111011101011111111101111110111111110100111111111111110111111110111111111111101111011111111111111101111001a111010011220221002021210121b20221
111101101111a00111111110011111101011111011101011111110110011101101101111101111101001110101111111111111111111110111110111111111a011011110101110212012011112b20222
110111011111a11110011111111000111111111101011111111111110111111111111111101111111110111100111111101101111111110001011111011111a110101101111020222222212222b11200
011011110011aaaaaaaaaaaaaaaaaaaaa110110101111010001111011110001111111111111111110110111101111110111111110111111111110001011111a111101111222111000201221200a12122
11011101111111111111111101111110a111101111101101111001110111111111111111011111101111111111111111111101111111101111111110111110a111111101211200202212211211a22222
01111111111111011111011100100111a111111111111101111111101101101111111111111111010101111111101111111111111011111111101011011101a011010000112012211121222021a20010
11101111111111111011110111011111a100111111111111101111010111011111111111101111111111111111001111111111111010111111111111111111a110111111122121212201122212b11212
11100111111111111111111010110111a111010100111111111110011110111111111100111111011111111110001111111111110011111111001111111011a111101010221202100112011202b11210
11111111111111111101111011111111a010011101101110111110111111101110111101011111110101101111111101111111000000110111111101101111a111010111121202212202212121b10021
11111111111011011100011100111111a110010111110101011111110111111111111111011111010111111001101111111111110111001110010011011111a001111111102220112011221202a20202
01101111111110101111111111101111a011101111101111111111111110111111101110111111111101111111111110111011111111111111111011101000a011110111220122111211210002a21001
11011101111101111011011111011101a111111111111011111111011101111111100011111111111111111111111111011001101011101001111111001101a100111111211122220001210101b12211
11011111111101111110111110110111a111111101011101101111100011111111110111111110111001101111110110011111011111111111111111110111a111111110222221120122100201b02112
01111111111111011111111111111011a111111101111111101011111110011111110101111011001100101111111110101011000111101111110111011110a101010010211210122202211112a02222
11100110010111111010111111101011a111111101111111111010011110111111111101101111011111101111011110010011110101111011111110111111a110001110211222221122111021a12222
11100111010111111110111100111111a111111111111101111111111111111111111111010110111111111110011001111001101110111101111011010110a110111111012012121120112122a01101
11011111111111111110111111110110a111111100010100011011101101111111111010111111111111111111110111011110111110111111111111111101a111111111200211122221211012b22110
11111111100111101111110110111011a110101111101111010101011111011111111101110010111111110111111111111111011100011011101011111111a011010111211201222112211122b21112
01101011110111100111111011111100a011010110010111110111101010111011111010111111111111111111111110111111001011100011111011101101a111111111020122111121011121b22210
11001111111110111110111111111111a101111011100111111111111011101011110111011111111111111111111111110000111011111111111111102011b222211120220120222021222112b12102
10010111101111111111111011111111a111010100111111111111101111111110101111111111111111110101011111111111111010110111110001102202b220111011122202020212111021a02111
11111111010111111111111010111111a011101111010011011010111101100111111111111111111111110111111111111110111111101111111111111122a011222211222012222020221121a11012
11110111111111111111111110111111a111111111101111111111011111111001001111101101111101101111110111101111011101110111111111110211b102122210211201112201000121a11111
11111101111111101101011011110101aaaaaaaaaaaaaaaaaaaaaaaaaaaaaaaaaaaaaaaba21121211021221022012111112211111011111010111011110201a111012110111222021200211111a11111
111001100111111010111011001111111101111111110111111011111111101111111122a12112111211112111201221112011111111110111000111112121b111001022200111020112122211a10011
110011111111111111111111111111111111111001110011111111001011110111111211b21211110112220102101012101211111111011111101111110202a022001121222122012120120121a11111
011010011111111111111111111111111111011110111110011110111010111111111021a10210112121222222112120121211022001221112201101110222b110000021122210112022220021a11011
001110111111011111111010111011101111110111100111110111111010110111111112b12112122101211220102202222222110222122202010101110000a211212111221111222011122221a11111
111111111011111110111100111111001111111111111101111111110011111101111221b11121122010212002222202212212212222012112211111012122a121112112021210112102001011a11101
110111110011011110111111111011111101111101111111101111111011101101111212a01101220011212022222122020220212221010112111100011112b212010112102222100121101120a10111
111101011111111111111111111101111111111110111111011111011111100100111111b12110122121222220201121210222111212001212201101111122a202020212110002121010121111a11111
111111101011111111111111111101010111111011110110110111111111101110111012b12222112122222222201200222120212122012210211111112122a112111101121222110110220211a10101
110111011011010110110111110111111101111110111110011111101101111111110112a11020110201101222220112202200011001112121211111112220a122222110001202012222100021a10111
110111111111111101100110110011111111011111111110111110111011111111110211a22211221220220222202222012021220121212111210101012112a111202211220222211121111101a10111
011111011111111011101111111101111111111011110110011111101111111011111002a11010111222222022111211220212112022122212111111011101a111212112120200021111122121a11110
110111111111111100111111011111111111111110011010010011101111110110100100b01102212202022220102212120210112020212211111110112221a122012021021220011211122121a11111
111111111111111111010011111001011111101111111111011101111111011101010111b11220112222022112211012221211201022211100211011010221b222212211222120212111010111a11110
111110110110001011110101000010111110111111111111000101111111001111111221a11101222221222221221222222211022212020020021211012111a022211221212222121002121220a11011
110111101111101101111111110111111111111111111111111011111111111011111120b22212111120222202022021210122222121222202222222201221b220222002112212100201021101a10011
111111110111011101111111011100111110111111110110011111111011101110101211b11120122222212120211212122021222220211200202201201222b102011222222210212222122201a11101
101111111110101110111010111111111011011101111111110111111111110111111220b10221110222122222202222122201222221222201212222221202b122212111212211011121022001a11110
111011111001111100101111111110011111101101111111110111111010010101111211b22121012122222020222122222022020121212021222012202222b021122122010101122221112211a11111
111010111111101111111111110111111101111111110110110010111111110111111202b11211212210220102222212122010221100221211021121002222b102211121212101212101201011a11101
110001111111111aaaaaaaaaaaaaaaaaaaaaaaaaaaaaaaaaaaaaaaaa0111111000101222a22202122022002112212122210022222222202222202220220011b222011110111201221120220100a10101
001111100111110a111011011111111111111101110011111111011a1101001110011120b21021222111222221022222221020100022012212111101222212a220110022111122120212101111a01111
111111111110111a111100001111100111111101011111011010001a1011101110110012b11221212112122222212222022020201221220212220102101012b222211021111222202101011220a10111
101111111110111a010111011011110111110111011111101110111a0101101001111220a20221221121101220222212012022021101020221212000222212a022211121110220120122121221a11111
111011111101111a101110111110001011111101111111111111011a1111011102021221b21221012012202222121212101210200221210011211102202112b222210122222012010020122201a11110
111100111110111a110010111111011111101111111111110001110a1111111211021210b22112120221022022022211221212022212212222220212022112b222102222211211212020011221a11111
111111111111111a110101111111001111110001111111011101011a1101111200012222b12222221110222020222212221022211202112212210000202212b102021002211222121011111120a11101
011111101111111a101101111111110101110110111111101010011a1111101122220222b22211210111002202002122202202202221122211220212202021a101211001100111101111111011a11101
111101111011101a011111011110001101111010111011111101111a1101011102222011b22222020112022222200210212221211222110020102220210002b211111111111111111111110111a11111
111101111111111a111011101101111111011101111001101111101a0001011211201220b22112222112222202222211222222202211202222220201011012a121210111001111111011100111a10111
101101101111010a111111111101111111111111111111111111111a1110111110202220b20212211222222220202021201222002221122221220111222012a201111101101011011110001111a11111
011010111111101a111010011101101111111100110111111110111a0110111122021212a11022001122222220110210011021021202222210012112222220b001211110110111101011111111a11111
011111111111111a111011111101111111111110111010111101101a1111111221210122a20022120202102201120212212122222222221112212211212202a020201111011011101100111111a11011
111111111110011a011111111100100110111111111011111111110a1111111112212101a10020101102222221212121221122222211122202011101211221b011111111111111011101101111a11111
111111110110111a111111111111010110110010110111111111111a1111111101020011b11111121212121012221211110101211121001111022121212121b122211101111110111110101011a11101
111110101111110a101111111110100111101010100111011111111a1101110111221022b12201112122222100122010111121111212112221212011210220a100011111111111010100111101a01111
111010111101111a110111111101111111011111111011111011111a1011111201220110b21012002221122021120211111122201221112221211212102222b120111111111110011111001110a11111
011011111111111a010011110100111011110111001101111111101a0111111221010111a12221102022111100210210111022122222112020111101001111b111201011100111110011111111a01111
011111011101110a101101110101001000110110111111111111111a1111110211201122a01220212220101011010001101111222112221111122210112120a102111110101011011011111111a11111
101111100111101a111110111111111011111110100111111110111a0110111111122210b10220211110212101112211111120211112212221110122220002a122111111111110011111111110a11110
110110011101111a101101111111111111010111111111111100001a1011111221011120a12012102211222021020211001012011212222010222101020211b021111111111110111001100111a10101
011111011111101a101111111101111111111111111101111101101a1111111111110221a222010222222211000102101101201111bbbbaabaabbbaaaaabbbb010210111111111110111110110a11111
111011101101111a111111111111101101110111111111111111111a1110010202210221b021121222212021112222101101122220a01012222102112111111010111111111111111111110101a11111
111111111111111a111111110110110111111011110101111101111a1111101120202221b122120120201220122222111111202101b20111222222000001212112100101111101111010110011a10111
111111011111111a011001111111101111110111111011111111011a1011110112112122a012212121211112121122111111012111b21111121111211220221221111111111100111111110011a01111
011100111111101a111111111111111111111011111011011111010a1111110202200011b002121121212212101022111110001011a11110101011110011111111111111011000010111111011a11011
111011111111111a011111111111111111011111111111111011111a1100111110221200a220202121112202210212111111011111a11111110111011111110011110101111011111111111111a01011
110001110111101a100001110111110010111011010110110111111a1011111110122221a022211221111021222120111010101010a00110101111110111101101111011111101111111101111a11110
001111101111111a111111110111101101101110111111111111111a1111110121121212b222121221221120022101101111110110a11111111111101011111111001101111111101111111111a11011
011111111111011a111110001110011111101001110101111100111a0110110001212211b220010111112000121222101111111111a11111101111110110001111111011011111011011101011a11011
111110101111111a111111111111110111101111011110111011111a0011111200110111a222120021000122222021111111111101a11010111111001101111101110111111111111110111111a01110
111111111011110a110100011011111111010010100011111111011a1111111121022010a121122212110222120221111011011111a11101111011111111011011111011011111101111111110a11010
111111111111111a111111110111101111111111101011111011011a0111011221211121a021111222102012222021001111111111a01111111111111101111111111101110111111111111110a10001
110111000111011a111111111011111101110111111111011011111a1101101111200112b221101102220020212222011101111010a10010001111110111110111111111100111011110111111a11011
111111110111111a100111100111011111000111111011111110111a1111101120201111a122111120021221111011111100111111a11111101101110111101111001111011111111111110111a11111
111010111011111a111111111111111111111111111111001101101a0101001111111111a111111010111010111111001111101111a11011111111111110011010110101110111011110001011a11011
011110111010111a011101101110111111100111111111111110101a1101101101111101a111111111111110111101110110111011a11111111011111110111111111101111101101010111111a11111
110111111111111a111111011111111111111110111001111011111a1111111111011111a111101110111001111110011110111111a11111111111011111101011110110111110011111010100a11001
111101111110111a111011110110111110110111111101111011101a1001111111101111a111110100011111000010110001111011a11110101111110100111111000011111011111101111111a01101
111111111011111a111111111111101110111110111111011111111a1111111111011100a111110110111111101011111010111111a11111110101101111111111111101111111111111110011a01111
111111101101011a111111111111011110100100110111111111110a0111111111111101a011110111011101111011111111111111a11111000101101111111111111011111110111011011011a01111
