85 16
107 109
78 98
151 42
145 5
137 70
84 74
99 77
115 88
85 8

10101a1111101111111110110111111110110111111110111101101011111110001111021212002122122111a102201111220011110111a0101011101110011100111022100211212101120120210021
10011a1011111011101111111111110111111111101101111011111001111110110111212111212102120102a022022221201110111101a1111101111111111111212202210022212112222211001101
01111a1111111111111111110111111111111001110111110101111111111011100110111210102210112212b012102222111110111111a1101111111111011110111202122102201121210101021120
10110a1101110111011111111110101101111111101101111101111111111111001111122211211121122120b121122020112011111010a1111111111011101111211001222210211211122022201121
01111a0101100111111111111011110111011111101110101111111111110001111111202111200211101200a021212011001001111111a1111001111001101111112112112012220121201011011111
11110a1101111111111110011111100111110111111101011111111011111101111010022022000212211222b211202021112100111111a1111111001011111101120201202112201121121122211222
11111a1111111100111111111011101110011111111111110110111111111011111011222201122111201212a011111102022111011110a1111110111011111111121211211020110121022111020111
11111a1011111111111111111111100111111111111011011111111101111111111111102022102222222112b222211100111111111111a1011110101111111111212202112111121220202111122222
01111a0111111011111111111111101111101110101110111011111101111111111101002202111212112220b110022211120111111111a1111100111111111111202120202aaababaaaabbbabbbaabb
01001a1011101111111111111111101111111101110101101011111100110111101111220101201112001222a120201101102111111011a0101101111000110111102121202b21001021211020101211
11101a1011011111111111101111001111111010111111011011111111101111111011111210121201121102a202122222111111110011a0110011111111111111120122122b02021222222122021101
01011a1100111111011111111011101110111111110111101111111111000111111010221020211111210122b121111212221111111101a1111111110111100100010122111b21100220212212002211
11111a1111011101111111111110111100111111111111101111111111011010111111202120022212202122b100212222112101111010a1110110101111110011222110222a21210212111020222211
11111a1111111110110110011111111111111110110110011111111111101111101111101101200212122121b221111221120111111111a1111111011111111110121222120a20111112102222102111
11101a1011011011101011110110111101111011110100111111111111111110101101002222222222212220a222102112020111111101a1111110111111100101211111211a21010211222222202212
00010a1011111111111111101111100111111011111111011101011111011111111010211210222222000221a022000100122111111101a1011110111111011101101112121a12221112112101001211
11111a1101001111110111111011011111010001110111111101111011111011111001122212221122111PP2a221101200221111011111a0011111011111101010211112222a21111022121202200111
11011a111101011111111111101001111111101110111111111011111111010011111120010211111112112Pb110112120210111011011a1111111110110111111122222110b21011001211111201012
11010a1011011110111100111111101101111100111111110111111101111100111111112122120120022222P002221021122111011110a0101111101101100010012221110b00211212112221201112
11111a1011101011111110111110111111100111111010111111111101111110111111111011220112211122P121112100221110010101a0111111111111011101122200121a02212011102202212011
11111a1110110011110110011111111111111000111011011101101101011101011001112121022201112111P022120220100111111111a1111111111111111110202211200b22222211201022012110
01111a1101111101111001111111011111111111111110110111111111011111111111220121101122211112P122110222222111110111a1111101001110111111111021110b11201221011120021122
00001a1111111111111011110111111100111000111111111111110111111110111111111111210021212210P222022112101111111111a0111111110111001110110112122b22112101222211222202
10010a1111011111011111111101101111110101101110111011011111110111111111022221021220122120P020020222121001011111a1011111111111111011121022120a12211211221212122211
01011a1011110110111101011011010110110011111111101111100001010110101111212012122211121122P021002122120111111111a1111111011110111011210202210b10121222012212120201
11111a1110010011011101101110111111111111111110111111101011111101011111122210222202211210P102122110222111110111a0111100111100111111121201222b21202120120000210220
11011a1111111111110111011100011111111101111111110111010111011111011111222112111121220111P220002211021111111111a1110111101111011110221022200a21112221010122121121
11111a1011111111101101110111011111111010111100011111101111110011111111111112221110122102P121202122022101111011a1111111011100111110222111122b01122020122202202020
10011a0110111011111101111100111101001111111111111101111010111101111111202111002101211200P122211122212111100011a1110010111001011111112121212b01212222222201202121
11111a1110011111111111111110010010100100101011011100111111111011111111211102212110112122P121121221222111111101a1011110110111111111212201122a12020212220212220222
11101a1111111111111011111111011111011000010111011110111111110111111111122102221222212022P111122122100111011111a0111101101111111111122222122b01221220102021212221
11001a1111111010111110111110001111111100111101110111101111110101101111111111110111111111P111101100111111111111a1111111001011111001110110212a12111221212121112221
11111a1111011101111110111111111111010111110110111111111001011111111111111101100111111111P111111111111111111001a1111111111111010011111111102b11222212111220122122
11011a1111111111111010111111111101111111011011010111111111111101110011100011111111011111P111011111111111111111a1111111101011101111111110222b02112222112001120102
10011a1111111111111101101110111110111111101101011111010111111111111011111111111011101011P001111111111110011011a1110001111111111110111111220b11201001012112102220
11111a1110111101111001111111111111111011101111111111001111111111101101110111111111011111P111101100111111011110a1111111110111011111011111112a02101212202020221210
10000a1111111110011011101111101111111111110111110111101011111010110110011110111111111111P011000011111111011111a1011011101111101111011001111b12011222220022110121
11011a1111111111110101111101111111111111111101111000101111110011101111110111110111111110P111110111110111101101a0001110111011111111111111111a10102221011022111101
11111a1111011111110110111101111111001111111111111001111111111111011011110011101011110111P111111111011111101101a0010011101111111111010101112a21121122100111222101
11111a0111111111111111110100111010111011111110101011010110111101111011111111110111111011P110111101101110000111a1111111111101111110101111112b12222011021212011112
11100a1111111111111111101111111111111101101111101111111111011101111010101100111101111111P011110111101001101110a1111111011011111111111111222a12122220001122110122
01111a1011100111101011111111111011011111111101111111110110001111111011111101111110111011P111101111111111111011a1101011111111111101110011221a11212111222210210012
01111a0111111011101011111111111111111111111111111011010101011011100111011111111101111111P111011101101101111111a1111111111110110101111110121a22120001221001102211
10111a0111111111111110111111111011111110011111111001110101010110111000111111111111110101P111101101111101111000a1111101011111011111001111111a21220221022222211212
11111a0011111111101110111010111100111111111111100111110011111011111111111111111101101010P110001111111111111000a1111110111111110111111101011a22101021101112112112
11101a1111100110101011101011111110101111110111111111110101110111111100111011111111111001P011111111110111111011a1011111101111111111001111222a11112222111222122122
11111a1111111111011011111111110111111110111011111111101111111010111110011110010101011111P111111110101110011111a1110111100111011110111111022a22002022120100210012
11111a1001011111110001111111111001011111111101111111100111011111001111111111111111110101P000011011111111111110a1111001111011111111111101011a22222221111221121021
11110a1011011110010111110111111100001110110111111111111111111111011111111111111101100010P011111101111111111100a1111111111110100111101111010b22200221212121022112
01111a1011111110111111111101111011101111011111111111110011010011111111101011111111111111P111111011101111101111a1011111110111101011100111201a20020202122121220122
11010a1111011110101100111111111001111000111011111110111111011111111111111111011001111111P101111110000011101111a1111111111011111111110111122a22022012011001202100
11101a1111101001110111111110111011101110011111111111111101111001110111110111101111111111P111111110101111101111a1111001010111100111111110201b21101112211221222210
11111a1110011110111111111011111110110111001111111111100111111111111111111111011010111101P001111111011111101011a1111011111111011111110110012b22222120212111212012
11101a1110110111111010101111111011111110111111101101100111111111110111111111101111111111P110111111110111111101a1011111110111001011111101022a12121122110101111120
11111a0100111100111111111110111111111111101110111111111111111111111011111101111111111111P100101111111111111111a1111011110111011001111111122b20210220111001200012
11111a1111111110111101111111111111111110010110111100111111101111111111111110111011001111P111100111101111111111a1111011001122111010200220220b11110202112021212201
11111a1111111011111111111111101111011110001110101111111001111111110111111010101111010111P100010111111111111100a1111101101112201210110011210b11212202221120111102
11011a0011111111111111111111110011111111111001111110111011110110111111111111101101100101P110110100110111011111a1011110001022222122110220221b11221121111122211122
11011a1101111011011110010111101111111011010111011111111111000011011111111110111111111101P101111111001111011110a0111101000121202121000101221b22222011212110111111
11011a1100101011111110101111111111111101110111111111100010011111000110112010210200122110P001100120121111111110a1111111100111222221122122112b21212112002111111111
10011a1111011111111110110100111111111111011111110111111111111001110101012110121222001221P212221112000111111101a1111101011112202221022111201a00211022202110111101
01111a1101001111111111111101111111111111111111101110011111111110101111112121122222201102P122012212201101110111a1111011111121221212210121221a11121111102101111001
11111a1111011111111111111110111110111111111101011010111101101111111110011011221210110222P222121212202211111112a2102110111012120112122122211b21221221212211001111
01001a1111101111111111011111111001111011110111110111101011010111111012011211121102221220P121202201220110110111b1221111111111000111001110212b11121211221121110111
11110a1111101111111111111111111111111111101110111011111010111111111112101221111110211122P021122222221221222011b2012011111101201222020221221b21122212112221111111
11011a1111111111011110111110111111111111101111111111111011101111111111211201022211102222P200220220211222102221a2110111111102120112200210112b01102011112221111111
01111a1111110111111111110100101111111111111111111111111011110101101111100211111222110222P220211221022022020220a1121011111111202200220222212b11202011212121111111
11111a1111111110111101111001101111111111101111111011111011111100111111210111212220102201P211022221220122001222a1222111011100221122111021011b20211102012021111001
11111a1101111101111011011110111101111111011111011011111111011110100112210120221201012022P100220021212222011121b22010111aaabbbbbbabaaaaabbaab20211121200221111101
11101a1111111111011101101011000100111110100111011011111111100101111110122011222111220222P202210202222220121221a11111011a1121210221102212202122021122222121011101
11111a1111100111011101011011111101111111011110111101011111111111110110211221122222112220P022212212122122110211a20210111a1121121110221122112201221211121111101111
11111a1001111110111101111111111101001100110111111111111111111111111001222122120112121101P222220010022011201212a22110011a1111102111112111012121120221202211011111
11001a1111111101111110111111111111101111100111110111111111100101011011101110210011200210P012220210020222211100b01021111a1112220122111121120011121211211021111111
11111a0001111111111101111111111011111111011101111011101111111101111111121222021220020212P120112021222122122122b22222120b1122200222021220012110221222012011111010
01110a1011110111111101111101111101111110111111110111111111111111011012210211201020012122P221022222222120122222b21221221a0202021220222212212112201110112201111110
11101a1011011100111011111101011111111111111111111110110110111111111012102201112012121021P221122222121022222222b11221022a0221221012101211001021212011122201011101
11111a1101111101011001111111111011111111111111111110100111111111100112100110201122010200P101210221220222020222a02201120b2102112112221202021111021221201221111111
11111a1111111100011110111111111110110100111100111111111111010111111111212002021112112222P121112122212022102220a22102121a0122110222222202111012212212101211011101
11111a1111101111111111100101001011111101111111111101111011111111101112201110000202000102P222022222212101111001b01021222b0100012122212201210201021122111221011110
11110a0111111011101111111011110011110011111110001111111101111111011102222112221022102220P221202122222202021122b20121111b1222122220002221122210120121100211111111
11111aaaaaaaaaaaaaaaaaaaaaaaaaaaaaaaaaaaaaaaaa011010110111111101111111122121112001211122P222022111222002120222b22201101a2020110212212100011211110201111011101100
111011101011111000011110100110111100010000110a111110001101111111111111120111120221210222P122022210212212022120b00212222b2002212120201121021002211221111121101111
111111101111111011110101011101011111011111100a010101111011110111011110111111221212222000P221022222220222221012b12222111a2122200020212112121221111211122120111111
111111110111011011111111111111111110011111111a111010111110111111221202201220002102202220P222112222202011022222a20121110b2120122022202011122212002222021101111111
111111101101111111010101011110011110011011111a111111100110111112211002020122110212021022P202111122021122210102a02220021a1012112220201001210120222122011221111111
010111101101111110111111111010110111010010111a111101100010100111210220212020012001212212P222022212222212222121a22001221a0201122222222211122011222002222201110110
111111111101111101111111111110111111111011001a111111011011111112002212220012022222210122P222220212020012210022b02220010a2120111100210110111011011101011011111111
111011111111111101111111101111101000111011111a111110111101111110102221222220220212212222P022211122202021122120b12022020a2221221121110111111101111101011110101111
111111100111111111001111111111011011111111010a111110111111110111110122222222202222211212P022222020122212201011b02121212a2220122011211110110111111111111111111111
011111111111111111110011110111101111110011101a111101111101111111121112222212220221212222P222121201202222221222b21222111b1212011012111111111111100111110110100011
111111111101111111111101111111101111010100110a111101111110101012120221221202220222212222P222221112000221202120b10121010b1211120222001110011111111111111111110110
111111101011111111111111101110111111001111101a100111110111011110220112122200211101022202P202211112022222021222b20001211a1202012101211111101000111111111101011110
010111001111110101011111111111111011111111110a111011111101111112221211102111012121022222P212211012221220122220b00221112b2020112112111101011011110111101100111111
001110011011111010111110111101111111101111101a111111110010110112201121112221122122012221P112111011110211211122b21012011a1210202121201111101111101101111111111001
111110001011011111001111100111111110111111110a100010101111110110120101122222122211112201P212210111112021120121b01221021a2121211201211111111101110110110101011111
101101010111111111111111111111100010001111011a101111111111110102221202222120211212020212P101010111111210121211a12120022a1101121212211111011110111111001110100101
111001011110011110101111111010111111101111111a111111111111110112212112122211211212221210P012011010112210121212b11120211a1211211001210111110111111011011111110110
011111111111111110111110111011111111111011101a111010111111111110111112220222211002112212P001211111110221122121a11012202a0111122211210110111011010101100111010111
111111111111111111111011110001011111111110111a111100111111011111111122012122100211222212P221120110010202120021b20222211a1202122101010111011101011111111001100101
111111111111111011001111001110111011111111101a110111111111111111221001222001102212211122P122211111110111200021b10012122a1222122110211110111010011111110111111111
111111111110111001101110111110100100111111110aaaaaaaaaaaaaaaaaabbaabaaaaaabaaabbabbbba22bP22121111102122222121b21012122a2122211011211111111101111001111100111111
1011111111101111001111110110010111011011001111010110110001100111112111121101101211111a22a1PP221110101221122111b20121211b2021121110211111011111100101111110111111
1111001111101111111101011111011111111100011111111101111111111112211112212122201122101a22b012PPPP01110021121100a10222201b1010211112201101111111010110111111110111
1111111111010011001111111111111101111001101101111111111011111112121212102211222112121b21b1001201PP012210102100b21121020a1111112111110111100111110111111111110111
0111111111111011101111111011101111111011111111101111101111001110210122020111001011002a22a221211111P00011110101a00111111a1101011111101110100111111111111111101111
1101101101111110100111111110110111001111111111100111111111101112201111101222112222020a22a1212100011PPPP1111111a11011101a1111101011110011111001111011111111110111
1111111110101011111111111111111101110011111101111110101111101112012022210220202012111b10b01220001101111P011111a11011111a1111111101111011111011011111111101101111
1011111111010110111011111011111010111111111101111111111111111111222122212111111102002b21b211011100110111PP1011a01110101a1111101110111011100111111111101110011101
1101111111011111110111111001110111111101011111111111001101111112211111102112101112221a02a12112110111010111P111a11111110a1111011111100111111111111110111111111111
1110111111111111111101011111101011110110101111101011111111111111021221101221012011221b10a121121111111111101P11a11111111a1111111110111111111111110111111111111111
0011100111110111001111101011110101111111110110111111110111011102101010120102101110212b21a022120111111001011101a11011010a1111111101111101111111111111010111111111
0100100111111110110111011111101111110011010111111111110111111111122222121221211122011a12a120211111010111100111a10101101a1111111101111111111111111011111111010011
1111111111111110111110111101111111111011111111101111111111101110011010221222122222211b12a200121101111011101110a11111110a1001001001110011111111001111111101011110
1110111111111111111111111100111110111111011111110111011011011111211211002222212120001a12a110011111111011110011a10011111a1111110101111110100011101111111101111111
1111101111111111110110110011000011100111010011011011111101001111111011110110110111111a11a111111101110111111111a11111110a1110111111111100011111111111111110110111
1111101111111111110110111111101011110011001111100111111111111111101111111100111010011a11a111011111101111110101a11111111a1111111111110111111011101001111111100011
1111110101111111011110111101011111111011111011111111111111100111111101101110010111101a11a001111111111111110100a01111111a0111101110111111111111111111111111011100
1111110111101111110101011111111110110010001101110101111111110111111001111111101111101a11a011111111011101111111a11100110a0111011111111111011111101110111011111111
1111100011011111110101111111110111111111111111101111111111111111010111111111110110111a01a111001101111111111011a11001111a1111011110100011111111111111101000111111
0011111101111111111111111111101111111111111111011111110110110111111111111111111111110a11a111011110100111111111a11111100a1111010011111011110011110111111110110111
