143 90
0 49
78 98
151 42
145 5
137 70
84 74
99 77
115 88
85 8

101010111111111a11111111110111111101111111111111a0111010110111100110101211100011210111202101121200122111111010111111011011011111111111211212a1111222111211112121
111110111111110a11101101111111111101011100111111a1011111011001101111110212200121121112022122101121121101111101110111100100011111111001211022b0200102111011110111
100111111011100a11011011111111101110101111111111a1111111111101100101011110212202021211111121122120102101101111100111111110101111111011210020a0012110121112212111
110110111111001a01111111011111111100101111111111a1111110111111111111011201222010101211010012120222021111111111111111111111111011112122001121b1221122102011112221
101111001111101a11111111111111111111100111111111a1101000010101011111011211210222212102022020012111201011010110111111110111111011100222211210b2112221000222200111
111111111111110a10101011110111001111110111111011a1111101111111111111111222211122222101010112120012220111110111000111110111111111102202002112a0212212201211002112
111011110111001a11110111101001011011111111111011a1110101101111111111111121221201110222122212111212212000111111011101110111111011012122110011a2201212121121121210
111001110111111a01111110101111011110101101111111a1111110111100111111112211211011221210122112201211011001101010111011011011101111110200201210a1220212221212201201
111111111111110a10111101111111111111111101111101a1110111011101101110110221011021020111202112201011011111111111111111111111110111112020212202a0100200112001211121
111110111111111a01010111110111111111111111111111a0111111111111101101112122222111221001021011112022210111100111111111101111111111102112101211a2211022122022011222
001111110101011a11111001101111111111011011111111a1111011111011111111100001201202122122021111121010211101011011011111110111011111010121121211b0201112110221222112
111011111111111a11111010111111000111111011111011a1101111101110011111012012121020101102202211221121110011110101011111111111111101111111111120a1202221012122121121
111100111101100a11011100010111111110011101111101a0111111011101011111111110022010100211121212112111221111111101111111011101011111111201010122a1020202221212121211
001100101111011a11011011111111101011111100101101a1110111110101111100101121210101111111121222121111222011111111111111111010111110111220022202a0201202221112020120
100111111111111a01111101111011111011110110111110a1011101111011111111112021121212111211021211100202121111011010011111110111101011112221122011b1212221110120111121
111111111111111a11111111110110101111111111111111a1110111111100111111001012022112122020111112102201100110100101111111111101111101112122122120b2221010111212101202
110111011111111a11111100101011101111010101111111a1111111111100111111111222110121222202112220022101112111111111111111111000111111012100221212b1211110202111222111
010111111111111a01111110101111011101001101010111a1111111111111101010111010112122211102221221210210100011111110111111111111111111012222112221a1212002202122222010
111111111111101a11111111111110111111101011110011a0101111011111011111110121121022112011122112121021012101001111111111111100111111112212210001a1211110221101112202
111111111111111a11111111111111110111111111011111a1111101110111101111111222022121101201102111221102212111011111111110111111011111010220220021a11222110bbbbbaabbaa
111110100101111a11110111111011101101111011010111a1001011101111011101112022211222111202022201212200121110111111111111111111111110010110011112a21112211b1221101202
111111110101111a11110111111110111111001111111110a0111111110011001111112110012101220122122110022021212010111111111111111111110010112012022110a11012012b1211102000
111110111110111a10110011111111110111111111111110a1110110011001100111010120111121110211222112102210111111101110101111110101011111111122211112a01211220a2201202221
011111111101111a11111011111111111111111111111011a1101111111110111111112022112111120021122012011211211111110111101111110101111111111111011111a21222102b1012111222
111111111111111a10111111111110111111111110111111a1111011111110011011111222220102012021112221120221101111101111111100101011111111012011201211a11122222b0011212221
111110011110111a11011111111111101110111111111111a1111111111101111111101011120120101121202222010212211111111111111111111111111110110101110121b12112211a1012101020
110110111111111a10110101001100101111110101110110a1111111110011011101112102221212220102202001201201110111110110101111101111111111112220112012b11112212a2221020112
011101110111111a10110011110111111011110111111111a1101111111011111110111112002211212102022001022120022101111111111101111101111001001021120122b01222021b2022002122
111111111111111a10110101111000101101101111011111a0111111111111010111111211012210112121121120100122020011111011111011111111111111102112111020b20102222a1222122022
111111111111111a11100111110111111110011101010110a1001111111010111101110010102111111111202121221201122011111111101001111101111111011101220221b02020021b2200022220
101110111111111a11111011111111110101111011101111a0111111111111101111112222012212220222200112011022121111110111101111101111101101110122201222b12212121b2212022222
111100111111111a11111111111111111111111111111111a1011101101111110111011011111111111111111010111100101111111111011110111111111101101111112121b11112221b2221110001
011111011011001a01101111011111111110111111100111a1011111011111110111101111110110011110111111010111001101001111110011101111101111111110110222a12210021b2112212102
111111111101111a01111111101111011011111101111111a1111010111111111111111111111110011111100011111111011110111111111111110111110011011111110111b12012121a2211110212
101110111111111a11111111110111101101010001110111a1001110111110111100101110111111111101100110111011111111111111111111110111000101111101010121b11202221a1212212220
111111011111011a01111100111110101111111110110101a1111110101111110111101011111111111111111111011011011101111110111110011111111111111101111210b22211011a1110100022
110111111011111a10011101011001011100110111111111a1011011101111110111110101011110001010111111011101011111111101110111110110111101111111010221b01012121a1122202012
101111011101111a10111111011011111110111111011011a1011110110111111111100111000111111101011111110111111111111111110111100111111111111111110122b20011022b2122110100
111101111111011a11111111111111011111111111011111a1110111111101110111001111111001111101011011101111111011111110111110110110011111111111110122a02001202b2221100101
11111110011110PP10111110101111111111110110111111a1111011111111110101111111111111111110110111011100111111111010111111111101101101111100110201b12120111b0011111211
01111111111PPP0aPPPPPPPPPPPPPPPPPPPa111111111010a1011011110110111111010100110010011001111011011011111011011111111110111111011110101101110212a12211221a2220110102
1110110111P111011111100111110011111P111111001011a1011001111111111110011111111101110111110011011111111101101111101111010100101111101111112120a21222112a1120002212
111111100P0111111110011111111111101aPPPPPPPPPPPPa1110111111110111111111111111101111010111110111111011111110111011111110011111010111101111122b10122112a0112021112
0101111PP10110111011100111111111111a110011111111P1111001111111111111111111101011111111111111111111111111111111010110111110111010111111002220a21111102a1221211220
101011P1111111110101001111011111111a110110101011P1011011101101111001111110111101010110111110111011111111111111111111111111111111101111112110b12201122b2212102102
11010P11100111111010111011101110111a111011110011P1011110101110011110011110110111100000110010111111010111111110101110111000111001111010112222a21000000b1122021001
111PP111111111111111011111111101001a110011111111P1111111011111111111111111111111111011111011111101110011110111110111000111110001111111112220b10112101b1101101112
11P11001111110111111111111111110111a111111111111P1101111011111111111111011101011111101101110111100011110111111111111001111101110101111112202b12011111b2011212112
1P010111111001011111111111111111011a011111011111P0111110111111111101111111111111111111110111110101110111111111111101111111101111111111102221a11110102a2221222111
P1111111011011010011111111111111111a111111101111P1111111001111001111111111111011111111111101001110111111110011111110110111101111100000112210b11121120a2122212221
11111111001011111111111101110011111a111111111111P0111111101111111011101111111111011111111011100111111111111101011111111110111111101111102222a10112100a0011020210
11111111111111111111111111111111111a011011110101P1011111111111111111111101011101111110111111111111111010110111111011111111111100000111110212a22121222a1222022122
11110111111110110111111101111111110a011110101111P1100111111101111110101101111111111101110110111111101111010111111011111111111010011110112122a22222102b0222122211
11111101101110111111111111111111111a101111110101P0111111001001101111111011010111101011101101111101011111111111111111111110111111111111112121b10122112a0221221201
11111111110101101111111110010111001a011110001011P1111111111111011110111111111111111111100111110111111101111110110110111000111111100111112012b21102120a1112210121
11011010111111111101110111000111111a110101111111P1011011100001111101111101111111000111101111110110110001111111011110111111111122122112112222b22122022b1221210121
11111111011101111011111111101100011a111111101111P1111100101111111110011111100111110101111111101001111110111111111111101101212022112121211210b22222222b2121202202
11111111110111011101101011111011001a111111111100P1111111110111110110000110110111111111111111011111111111110111111011111110222112222001102212a12020221b0020200200
11110111111111100111101101011111111a111011111111P1110111111111111111001111010100110111101110110101111111111011110111111111212121222221112122b11211121a1220101101
01111111111111111100011101111111001a011111111111P1010111111111111111102201100112112112112221101100101111101101110110011101102101211221112002a11011122a2120101110
01111111111101111111101111111111111a101111111111P1111111011111111011110112112102221120222101212111111010011111101111111110111212122112012012a00222111a1220111111
11011111101111111111011111011001110a111111010111P0101111111100111110011121222122222210221121120221211111111101111100100111222020102220112021b22221102b2121111010
11111111111111011111010111001010111a111101011110P1111111111011111111122120111110111222200122222101022111201021222121111111111111212222222100a00020221a0011011111
11111111111111111011111111111111011a111111111101P0111111111111101011100221112120021222020222122220201201202110110011110111201111222110212122b22002112a0221111111
11111111110111111111111010111111111a111111111111P1111111111011111111110222112211022202222220121212222212121111120021111111112220120100102222a21020212a0201101111
11011111111111100010111110011111011a111011001111P1111110111001101011102101211110021022122222222200221222111022112201110101201201212120211212a12102121b1221111111
01111001110111110101111111111111111a111111111011P1101111110111101111122122012121211220220112222220201211112111202211110111120002222202112220b22220100a1121111111
10111011111011111011111100111101011a111111111101P1101111101010111010011012211221210012122222121222211210012212111121111111002202211111210212b21210221a0220101011
11110111111111101011111111111011001a111111110111P1111110110101101110111210212212011220222212011022222011120111222221100101222112111010210212b20211101b0201110111
01101011111111111111110011011111011a111111111011P1111111011111111101110012212221111222122212022022220022120220002221111111212111221012220001b22212002a2121111111
11111110111110111111110101111111101a011111111011P1110001111011011111121212221101020112201121122122222221112000121221101111222212212112221000b12222111a0220100011
11111110111011110110111110111101110a001101111111P1011111111101001111122122212120112120122222202202120012201120101221111111220021122011201212b12101120b1211111111
11101001010110011101101011111110111a111111111111P1011111111111001111112212122111121112000201101212220011120011101111111111002211022220110121a22222001a1211110111
11001101111111101111111111111110111a010101111011P1101110101110011101101010021110112221011222222221222212122212202111111121202121002212112022b02120102a0201110111
00101111101111101101110011101111011a110111111111P1111110011111110111122122022121011111222222200000122122102221022222010212202122212002022222a01012021b2111001111
11111001111111111101101111111111111a011111110111P1111110101111111001121122102222221122201000121002121200222122202222120211022122201020221021b12120111b1001110100
10101111111010010111111101001111111a101111011111P1111011111100101110111111210022101011200122021221220122222220122211022212222221121110112221a01110210a1021111111
11110111101101111111111111101111111a111111111111P1111111111111101110112120202211121022222202022022222222220220122211011122022212222020000211b11112212a0210111110
11110110111111111110111111111011011a011111101111P0110001110111101111111201112212120212212020202212122102220222210212111110222222020122022221a11022222a0200111110
01111100011111011101111111111111011a100100110111P1111101011111111010122101000101221012221222022112211202200221122210001211210202122211122022a20222221a2120111111
11011111010010111111111111101101111a111111110111P1111111100101111110122220112112201121220100222222211100100022212201200102222011022212120221a12111120b2100111111
11110110111111111111111101111111111a000011111011P1111011111111111111111212121111112221020200222112122202222022222102202111200022200221212222a10222211a1011110111
11111111111111111111010110111111111a111010110011P1111111111111111101112112221210022121010211211221211211122212110222112110222022112121212220b00211221a2221110111
11111011110010111111110101111101111a011111111110P1011001110011110012102221212022022222012222212120212210022201122222001122212202211122222122a22202201a0221011111
01111111111110011111111001101111100a111111101011P1010011100110121202002010221222021122022022222221222020202122221221212122001222100112001121b10010221b0201111101
11100111110011010110111110110111111a111101001101P1011111111111111012122121220222120202222022220212022220212202211221211021022022201202201021b22221111a0111101101
11111111011010110101111011111111101a111111110101P1111111110111112111210222012202120020202222022220122211020210202222221122211211210111111111a10110111a0111110110
11110101101111111111111101111101111a011111101111P0111111111100122111022221001220221202222212222120222022120012112210122002222122011111101110a01111111a1111101111
11111111111101110011111111111111011a011110110111P1111111111011021022120221212221100102222001210022022212012020220212122211110221011110111011a11111100a1011111111
11110111111111111011111101101101011a111111111011P1111101111001002120021220222212121122122220120202222010120220222221100112111110111111111111a11110111a1111111110
11111010011101010011111111110111111a111110111011P0111111010101111112200220222100202222221222201111102222221202020002222212111201211011101111aPPP01111a0111111011
11111000110110111111011110111111011a111011110101P1111111111111112112212112121012221020211222222111120022022222222202211111122111022011111111P11111111a1111101111
11111010011111110000111011111011100a101111111011P1111111111111111101111111020212220112002221211112000102221222011212102101021112001011011101P11101011a1111111101
11111101111111111111110100100110111a111001111101P1110111111110121211121212110221112112020122211111012211122221111122111011112122021111111111P10001111a0101000010
11111111111110100011011101111100111a111001111011aPP01111111111122112211121022211211011212222201101112001022122121102212222201121210111111011P11001111a0000110110
11110111111111111111111110111111101a110110110111a10P1011111001010122022111211121111211021222111111102212121211010011212021201111021110111111P11111111a1101110111
01111111111111100101101011011110111a111101100011a110PPPPP00110112112221200222021111102012121211110011122111012212221122121211022221111000101P01110110a1011001111
11111111111111011101101111111110011a101111000111a00110100P1111120100112112112112021102122112011111111212001210101222102111021120102111001101P11011011a1011011111
11110111111111011110011111111110111a111111110010a111100011PP11112112111220220221020221101102211101110222212112010010121220200000020101111011P11111111a1111110111
11110110110101110111110111111011110a110111111111a01111001111PPPPPPPPPPPPPPPPPPPPPPPPPPPPPPPPPPPPPPPPPPPPPPPPPPPPPPPPPPPPPPPPPPPPPPPPPPPPPPPPa11010001a0111110111
11111111100111001001111110011111111a101101010111a10101110111a1112202101110121222022002212201221011111021001101222212102100202220101111111111100110101a1011110101
11110110111110011111111111111011101a111011111100a01111111111a1022221221121020221221112110211201111110012111122200121002201120110102111111011111111011a0111110111
10011111101111111101011111111100101a111001111111a11111111101a1012122222101222112021122222210221111112212221112221102211022112210201110011111110110110a1011011001
11111111111111111110011110011111111a101101111111a11101111111a1122210010022222200211002021210001111111021212212202102222110100112112111111110111111110a1101111110
11111111110011110011101010011101111a110011111011a11111100010a1111210211212112000021212120110120111111011110111111111010110110111111011011111101011111a1111101001
11111111111100111101110111011111101a111111110111a10001111110a1101012212221222101010021222021110111010100111111111101111111110110001010101111100111101a1011110111
11110111101111101111111101110110111a001110111101a01011111111a1121221222110220202112211011020011101111011110101110111110110111111111111111011111111011a1111110111
11111101111111111111011011111111111a011111011110a11111101101a1111221222000122122212212122120211111011011001011111010111011011011110100110010101111110a1111111111
01101110111111100111011111010111011a111101111110a11111111111a0021020102102211111122021022212221111111111110111110111111011111110101110111111111111101a0111111011
11110111101111101011111110110101111a111011101111a10011111001a1121121121210221112212221222210101101111101111110001111110111111011101111111111111110111a1110111111
11111111110111111111111111101111011a100111011110a11111111111a1120021100121021221122220221120111110111011010011011101111011100111111111101101111111111a0101111100
11111110011011111011111111111111111a110111111110a11111111001a1101110221102112210122211011222121111111110101110111111001011110111111111101111101101111a1111110111
11110111011111111111111111101010111a101111111100a10101011110a1111111210010220222011022121122100011111110111111011011010001111111111111111110110111111a1111011111
11111111011111101010111110111100111a111110101111a00111111110a0122122212022122221201111122201211111010111111111111101110011000110111110101101111111101a1111111011
11111111111111111111111111111111111a110101110100a10110110101a1011111111101101110111110110011110111111111111111111011111011011111111111110110111011111a1100111111
01111011010111101111111111001111111a110111000011a11111111111a1111101101111111111001111111111110111111101101111001111111111111111101111111111101111111a1110111111
11111101101110101111101111011111110a011111111111a10111111111a1111111110011111111111111011111101101111111111011110110111111011110111111110111111101111a1110111111
11111111111111111111110110101111111a111111111000a00110100011a1111011011111011111101111011111111111111111110110111101111101011111111111111111101111101a1111101011
11111101001110111110111110110101111a111001011111a11110101101a1111111011110011011111111101110111101111110011011111111101110110011010111111111111011111a1101110111
01111101111111111111001101111101111a111111100101a11111111110a1100111111111100110111111111111111111101111111111110111011011001011011111001111111101111a1011010111
