85 16
107 109
78 98
151 42
145 5
137 70
84 74
99 77
115 88
85 8

111111000111011111110101110111100111110111101110001110111101110100111011202021011222211112121221222a210101110101111111000100110101012200110012221211012021211220
011110111010010011110111101111111101110111111110101111011111101111111101111202020222222012120201212a211100111111111111101110111101022121212100011211121221120201
111011011011111111111111101111111101111011011111101111111111101001001111222220110211221120221221211a211111111111110101111100111111011112101010000011111112101102
111111011111111111111111111111001100111111110011110100111100011111011021111212100020102101002012222a0111111101111011110aaaaaaaaaaabbaaaabababaaababbabbbabaaaabb
111100111111101101110111111111111111110111111110110101001111101111111121102102021021212102121210210a2111101011001111110a1011011110111112212122101121221021120120
010110011110111111010100110101111110111111110111111111010111111101101102110212112122021212021222111b2111111011111110111a1111111011012220121101021102222200111111
111111011111111111111111111011011111111111110111100111101111011111111102122121111221122210211102121a0111011101111101111a1111111111101212122221001220102121121110
111110110010111101111111011111011111111111110111111110111111111111110012110220121211011100222012010a2101111111111110111a0110111111122221120120121111122222100212
111101111110111101111011111111101110110110111111001110011111100101111112220112122021121121022111121a2111110101011010011a0011101010101221212221221100212011222201
111111111100111111111101101111101111111101100100011111111111011101111112021222000200122110121111121a0101111111011111011a1111111111200012221201220212102122012110
101110011101111111111111111111111111101101111111111111111111111101011112110100211112121020212121221a2011100001110111100a1001011101111220211211122121101102202102
111010111111110111001011111111000011110110111101111110111110111111001001022222111111222212221100100b2111101111111110101a1111101110212211021211211222211112121222
011011011010111111111000111111111101111011011101111110111111101111010121222111121012212122221022222a1111111011111111111a1101011111111022012201111222122221201221
111101111111110110110111111101011111100111111111011111111111111111111111122122211220211111222111221b2011110111111111110a1111110111211100202212210121122121122011
111011111110101111110101111111111111111110110011110110111000110110111012011010221211112211112201110b1111011111110101110a1111111111122010111111120221001211001221
111011001011111111111111011001111010111110101110111100111110101101111112200111221012201220101121120b1111101101111111111a1110011111122222021111222112111111212221
111111111011101111111111011111011101101111101111101111111011110111111001212212101221201112222202201b0110100111111111110a0011101010012021122222112101121212111220
111101110100111011100011111011111011110101110111111111111101101100111122202211021112111121020202101b2111110011111110111a1111101111021211201212111001221021110120
111000010010101111111111101111111101101011111101011110111111111111011010222212110211111111201212121a0111111100111110111a1111111010200021012111220021211111111121
aaaaaaaaaaaaaaaaaaaaaaaaaaa011101111111110101110111111111001011111111111022112011112001010221121212b1111011111111111111a1011111011111101111112211122121122202210
11111111101100111011111111a111111111111111111111000001011110101111111112001201012112110211012211112b2100111010110111111a0111010111220222121112222111111022001011
11110001111011011111111011a111011011111011111101111110111111111100110112110120222221121112122122120a1011101100110100111a1011011111221111021222112220222211211211
11111111101111111100011111a111111111101110111110101110001111111111111022212121111210112122001100121a1111111111111101011a0111101010222222121201101111110022010222
11011011111011111111110111a111111110101111111101111111111111101111111001022110221002111212121222112b2111111110101110000aaaaaaaaaaabbaaabaaaa21212221111222121001
01111000111111111100011011a111110100111111010110111111111111011001111010211202002201212111111020220b011111111101111101110110101111112220122a12020211101122221121
11111011111111111001101011a100111111111001111100110111011110111111010122101210101112212102112022112b101111111110111111101110110111102021111b22212121122202202222
11101001111111111111111100a111111111111111110001111111110111111111010120202111222222002212121212202a210111111010111011011111111100110101010a01101221112020111200
01111110111011111101011111a011111110111111011111101101110111110111010011121211222111011112221110111b111110110011111011110111111111111012102a20122212210201220211
11111011110110101111111110a111111110111110100110101111111101111111111012110021120012111121121022211a101111101111110100111001010111021220010b22220212122100122102
11111111111101111110111011a010111111111111111111111111111111111011111100201011111102112222002201211a111111101101101101111111111110112102212b22222200002122222112
11111001011111011101011111a110111111111111110011111111011111011111110012102220010012111011210220022b210110110011100101111011110101122222222b22001122222122201212
11111011111111101011111100a101111001111110111011110111111111111111111101110110001101111111111111111a110111011111111111101011011110011111220b22212122112121221021
11110111110011111011110111a111111011111111111111111111111111111111000111100111110111011111101111111a111111011111110011111101111111100010011a10121110012210120212
10111111001111011111001111a101111111111011011011111110101000110111111101111111110101111111101011001a111101011110111101101011010111111111021a12122112100210211111
11011111011111111111111101a101111111111111110010110111111111101111110111101111011111111111011110111a111101111110111100111101010110011111020a10010010221212201021
10101011010110111111101101a110001111111011101111110011110110111111111011101111111111011111111111111a111111111111111111011111111011111111121b11200011000121100111
11111111110111110010011011a010111010111000111110011111111111101110111011011011110011011111111111011a111110101011111101110111111100111111222b22210112211121201121
11111101111111100100111111a111111111111110111110101111011011111011110011111111010101101111101111101a111111011001011111011011111111111111221b12211220121100201212
11111111111010111100110111a111101101111111111101011111111011110111111010101111111110111111111110010a111001111110111110111111011101110111222a11120121211111122221
11111110010101111111111011a111111111011011111001011110101001000111111111111111111111111111101111101a111101111110111110110111111111111110001b11111122211121110121
11111111111111101100011100a111011011111111111111111111101111111110110111111101111111110111111110011a111111010111110000010111111111110111012a22112122212120111112
11111111111011111110010111a110110111101111111111110110111111111111111111101100111110111110111111111a111110111111101111111111101111101111212a11112020101021121211
10011111111001100111111111a100111111010111011010111000111111111111110111111110111110101111101110101a011111111111011110111111111111111111122b21212222112202221110
11111110111110101111101101a011111111111111111101111101011111011111111011111011111111111110111101111a101001111001111111111101011111111111002bbbbbbaababbaabbaabba
11111111101110011011111100a011111101011101110111110111011110111100101101010111111111111011111111011a101010011111111101001111111101101111202011111210110212211122
11111111111111101101111111a111101101111110111111110011111111101111111111111110111111111111111111111a111011110101111111011111110110111101120112012012121222122122
11111101111111100111111111a111111111011011111111111111111111111111110011111111110100111111110101011a111011111111011111111110011111111101121020012020112220211122
11111111111111110110110011a111111110111110111111000111111111110110110011101101110100011101101110111a100111111111101100111011110100111001221112222222202011121011
11111111011010110101111111a100110111111111011111111101011101111111011111000111101110111111011111101a111011111111001111111001010011110011122221100020201211022212
11111011011101111100111011a111111111111111101110110101111111011111111101110111101111111111111011111a011111111100111101101101110101101101000122012021122210201021
11111110111011110110111101a111111111111110110101111110111010111111111111101111111111111011111111111a111110111111111111011101011111011111112012211000221121012122
11100111110110111111111111a111011111110111101011111111111110101011111110111111111111111110111101100a110000111111111101111011111101101111012222202112012021021022
10011101111010111111000011a111011111011111111000110110111101110111110111111111101111111100110001111a011111111111001011111111111101011110211112021121112122011211
11001101111111111111111111a111001111111011111011111011111111101110011001111111100111111011111001111a111011110111111100111111111011011111222011121110211101211202
11111111111110111111111011a110010111101001111101011001001101111111101111111111111000111111101011110a111111111111110101011111111111001001111210012221021212021001
11111111110111011101011110a110011011111010111111110111111101111011111111011111011100101001111110110a111111101111111011011111120211022212220222100211202121201212
11111111111111111111111111a101101111111101111111111001110101110111111011111100110100100111111011011a111111101111111111110122111211210220121022121202212012110021
11101111011111011110111111a111111011111111111111111101111110111101111011111100111011110011111110111a111110111110111111101011112111202021022202200211111201101120
11101111011111111111111110a101111011001110110111100011111011101101101111111111010100111111111111111a001100111111110011101122221021102212111112102202021110111111
01111111111110111111101100a110111111101111101101101111101111111110111200110110211020120221012222010a111110111111101011101111020212122210022122201111121221111101
11111101110111111111111111a111010001110110111111111111111111011111111222212112211222122112211010200b110111111101011111110122121111110122212122212121100211011110
11110111100101111011111111a110000010111100111101111001111001011110011211212202121001011222122102110b111011111111111111011111112121220212200212201001201101111111
01110111010101111111111111a111111011111101111111111111111111111011111101010222102210222122112220222b122202202011201010011121111202112201221221122211222121101111
11111011011101111110101011a111110111111110101111110101110011111111111111011211222112121001222222222b021122001112212111101110211121212111112222220111102210111001
10111110101011111011111011a001111111011111111111001111101011111111111112111221112122222022221211020a210011222111010111000112201202010120120011101022201201111100
10111010011110101111000111a111111111011111101111111011111111100110111211222121121121220212222011222b001220022212111111101111022102212211202212211102202201111111
11111111111001101011110111a111111111111111111111111111111111111100101102211211122211022212101202012a122020211102120110011111112120212020222120012221221211011111
10110111101111111111110111a111111011011111001010101111111111111111110222110120021121221002222101021b201221221000112111111111121022220222211222211011200211110111
10111111101001111111111111a111111101111110111111001101101111111111101111011112110102112212122102022a121111201200221001101012022221100121122001212111201120111111
11011111101111110111110111a100111100011111110111100111011111011111101221201202111101212211112222220b021220121022221101101112120011010211010110221110201210001111
11110111111110101011011111a111111111111111101100101111111111111111101221212100211111222002221122202b210101111110221111111021112222122211210012201221212100110101
00101101101111111111111111a111110101111111111111111011101011111111110112210121212022222020221222122b212201211121121111110121002121120111110212211121121201111111
11111111111001111101101011a101101111011011011111111111111111111111111012000111120200212210012012222a110121220122112110011111212111001122020102221212122111110101
11110011111001101111111111a111101111111101111111111111110001111101111121011021120120021001022220121b120022220111221222100221222022222122120222110002221100111111
11111011110111110111111011a000000101100110111111111111101100011100011102100100221211221022201212021b212222200122022202120122100101202222102120220211101110111111
11111101101111101101101111a011011111111011111111010101111101011011111222011111111222012100222220222b212200022122021112112020122022201210102211000121211121001111
10011111011101111111111110a101111011111111111010011111100111110110001111112011102222221012212122122b202212211112012120101202222220222021021121012221122121110101
11011111011101110111101111a111111110111111110010101111110011111011111022121110212211022112212211021b110112222002112212122221112020012212111121011211222221111110
11011110111101101111111111a111101111111111111111111111111111110011111201010112220221222202221222211b212122121200221100220222210222011121111221222101022211111011
11111111111011111011011111aaaaaaaaaaaaaaaaaaaaa1011111111aaaaaaaaaaaaaaaaaabbaabaabbbbabbbbbbbbbbb2b220221202222202010121222222222211222102222101101011211111011
1101111111111101111011111101111111111011110001a1101100111a111111111012112120122111021222012200201b2b022222120122220022120012212221221112200011102002112210011111
1101111101101111111111111111111111111111111111a1100100001a010111111011212221001221222020112222222b2b010121222222222011221120220212200112222220121212110121101111
1111111101111011111111111110111111101111111110a1111111111a111111001102120122111111110222022122210b1b221220202222210021211121020011222101222200121201111101011010
1101110101011011111010111111111111101101111010a1111010111a111102222121020222202212222222122221222b2b002122202120222021210212002102221211221222201211111210011111
1100101101110011110110111111111111110101111111a1111011011a010111002101221211102000212200222202100b2b222020222002211210212122020202020012111111212111001111111111
1011011110001111111111111101111111111111011111a1111111010a111101222012202221022121112222200222222b2b200212222122120111100022220222222102212120221012012220011110
1111111001111001101011111110111111111111101111a1100110011a111112212220120220020212020212222222220b1b220122202012202201102002112120211011100111111011011110110000
0110111010100111110111101111111111110101111111a1100011111a111112210210000221202222120122221222222b2bbbbbbbbbbbbbabbabbaaaabbabaabbaaaaaaaaaaaaaaaaaaaaaaaaaaaaaa
1111101111110100011111111111011111011111111111a1111110111a101102101200112212200220220022021222222b20012212220222212202211111122010111111111011101111011111111110
0011111111111111111110010111010011111111111111a1010111111a111112220111110122122221220220200202201b10212221122222220211120110221211111111111110101111111111011111
1011101000010111111110111110110110010111111101a1101001111a101110112202111110221001120220212101211b22021002202221101012210121120111201111111101011011101111111111
1011101111111110101111110111111111111100111111a1101111011a011110202011121121101121112022001022122a22110222121012110212221211221222210011111111111110111111110111
1010111110011111111111110111100101111011110100a1111101100a101111122122110012102111201111221202012b10122212112220020211121020102201101111110111111111111111111111
1011101111110010011111111111010110110110111011a1110111111a111111010211122222101201122211010120111a10101122201222112111001121010111010111111111111101111011110110
1011110111111111111011111111111101111111111111a1110111111a101111210021020121211122122012101121111a10121121121100222102112000212121101110111111011011111111111110
1111111101111011110110111110111010110111011001a1111111110a110110211212111200112121121122120121101a10211220122111010111200112021212111111111111111111111101110111
1010010010111111111111011111011111111111111111a1111111111a011100220102101022121122121222112211111a11111212212222112020111112222202211111111111111110111011111011
1111110111011111111111111011111111111111111011a1100111111a111110222021010221112122212212022111001a00100121102212222201012121211220211111111111111111011111111111
1111111111111111001101111111011111000111011111a1111111001a111111002112122220111211012111210211011a11111222022111222222121222111221211111011110111111111111110111
1111011101111101111011111111011111011111111101a1110101111a111112021122012111112111112021011112101a11112122120011000211111211121210211110001101001100011111011100
1101111101111111111110111110111110011011010111a1111101110a111101202122101122112101101211100010111a10221112021020220011221122011222211111111100011101110111110111
1011011111111111101101110111111110011101101111a1110111111a011101222212222122222012122111121021110a11221222122110002021112212112212201111101101111111111101111011
1111111011000001111000111111111101010111110101a1111111110a100112110102211220200110121122112210001a10212220202222110122112221121220101000010111010011101001000110
1101011011100111110111111010111111111111111111a1111110111a111111221112212010211101201121220021111a10222111202000121121121202121012001011111100100111111111111001
1010111111111110111011111111011111011011111111a0111110011a101012021121110221122110221002211102111a11110111111111111111111111110111011011111101111111111111001011
0111111111111110110111111011011111101101111111a1111111101a111112112221010122212120010210212022011a11101011111101111111111111111111110111000111111111111101111110
1111111111111101001101011111111011110111111111a1111111101a111111122022221112212202102122011020011a11111111111011111111111110111110111111111110101011110110011010
1111101111111110111111111101001111101101011110a1111101011a111112121212221121121211001112221022111a10111110111111111111100110110111101110100111110111100011111111
0111101111111101111011110111111111101110111111a1101111110a101112222221022122210112112120010211111a11111101101110111101111111111111111100111111111111101101111001
1111011111110111001111111111110111110011011110a1010111011a111011221222220121210212212211112201111a11110111111110111011101111101111111101010111011111101111111011
0010001101010111111111110111011111110111110111a1110111111a101001120111001111022212110121222010111a01111111111111111111101111111011111001111011010111111111111110
1111110011011111111010010111111111110110001111a1111111110a110112220122102221112122121111221100111a11011111111111011111111111111101110111101100110111111111111111
1111101111111111110111111011111101111111111011a1111010111a111102110221111011122202122021122112010a11011101011110111111111111010111110011111100011111110110111001
1111111011011111111011111010101010101111111011a1111111110a111102221221211221120210121112120222010a10111111100111100111111001110111011111111101101111111111110011
1111110111111110111110101111011101111001111111a0111111011a111101110011000111111111011110111111111a10101101110111010111010011111111111110110110100111110010010111
1111111011111111111001111110110101111110011110a1111111011a111111110111101011111101110111111011111a11111011111111111101111001011101111101110111111101111111101011
1111011111111110111111010111011111101111111110a1101111111a111111111111111101111111011101111101111a01111111111110111111101111101101111100011111011110111011001110
1110111010111111111111001111111101110111111111a1001011111a111110111111111101100111111001111011101a11111111111111110011110111110110111111111111110111111011011011
0111110111111011101111111111111110111111111111a1111111111a101111101111111111011111101111111111111a10111111111111111110111111111111111011110111111111111111011111
1111111111111111011101111110111111110111111110a1011111110a101111111010011111110011111110110111111a11111111101011111011111111111011111111111101111111111110111101
