2 8
143 24
78 98
151 42
145 5
137 70
84 74
99 77
115 88
85 8

1011011111110110101111111111110111110111111011111011111111101011111111120122022022202112211121101020a01100111111110111111101111111200101112010211112101222120220
1111111111101100110001111111111011111011011101101111001111101111111111211210101001212110022210211111b11111111110111011101111111011110221120022101120121222221120
1101111111110111111111011011101111111111111101111100010100111011111111211111002120220011210212111012a10110111101101111001111011101122210200022202202221021222111
1111110110111101111111111111110111110111110111111111111111111111101101221120202212211112121102201220a11110101101110011111111101111011221211101221212022202221211
1111111111111111010111110101011010011101011111111111111111110110111111210022011222221022010222220121b11111101100111110111111111001111101112211022011121202212220
1110111110111101101110101111111010110111110111111111011111101111110100222220212201112020201121121210b11001011011111111011110101111212212112221211222111220102211
1111111111111111111111111110111111011011111011111111111111111100111111011001111201021021102121012100a10111111111011011111010101111212112221211201112112112122202
1111111010111111111011111101111111111111111100101111001110110011111111211212121120111210011220212222a01111110101101110111110001111220122201111112121110221201222
1001100111111111011011101011111001010111111111110010111001111110111110200222110220110122122122222110b11111111011111111101111111111111122221211102221222121120212
1011111111111101111011111111010111111111110111011111111011010111010101112121011222222101211221200101a11010111111111111111111111001202111121021211121211022222202
0111111111010011110110111111010110111111111111111011111111111011111111210122221110212202212101212101a01101011110111111111111101111212000211211121121220110112111
1111111011111010001101010111111011111111111111111111011000111111101101210222220221020122112212012211b10011111101110111111111111111222221121221021101222010110021
1111111001100110110010111101011111110101110111111111111110111111111111221222112022000121121111221120a11111111001111111110001111011221121001011021210111120220222
aaaaaaaaaaaaaaaaaaaaaaaaaaaaaaaaaaaaaaaaaaaaaaaaaaaaaaaaaaaaaaaaaaaaaabbbababbabbaaaaaababaabbbbabbba01011111110111110111101111111212012111221222112101212212102
1011111111111110011111001111111111111101101011110101110111110101111111022202101010212211200012201112111111111111001101111111111111120112202120212120112111210121
1011110111111010011111111111111101001111101111111111101101111101111011220110110100212111221112112010111101111011011011111111111110210021112102201222010112010011
1101111011111101001000111011110011101101111111111110111111011111110111202012211212111211112020220112111101111111111111111100101100021221120212220111120220202121
1111011001111101111111101111111011111111101111111011111111011111111111110011112120112211110222122002111101101101100101111101011111221122120202121000211022221112
0011111111111001111011000001111011111001111110110111101001111011110111122022021111222222121102202221011101111011111111110111111101202212210212222112111022001122
1111101011111111011011001111101101001011110111011111111011111000011011221221110221022221201211122101211111010101111011101110011011111222212222212220211222221102
1111101110101111001111110111111111011111110111111101111001010111111111221210101102122001001122010121110111111111111111111111110111101012201012211122211122222220
0101111101101101011111001110111101111110111111101101110111111011111111220010021021221112220200210020011011111111110110111111111101221122221122220222022222022222
1111111111101101111111111111101101110110111110101110010110111111110110221211101201122121212211212101211111011110111011111111111111222111112222210111020101022211
0011111011111101011111111100110011011101101111101111101011001111011111112100101112101110021221012220110111111111101111111110011001211122221121212121201122102222
1111111111101101110111111111001110101110001111111111111111111110111111122001012201120012200121210201200111111111110001111111111000111122222222012112210212001211
aaaaaaaaaaaaaaaaaaaaaaaaaaaaaaaaaaaaaaaaaaaaaaaaaaaaaaaaaaaaaaaaaaaaaababbaabbbaabbbbababbaaaaabbaabaaaaaaaaaaaaaaaaaaaaaaaaaaaaaabaababbbaabbabaaaababbaababaab
1100111011111101111011101111111111110011110010011111101101101111110100122222121002000111202002110212211010111111111110011111110111221121022111110111122110222122
1111111111110111011111111101111111111111100111100111111111011011110101020001202102112110010122221221111111111111101111111111111111122222201221112222122102021212
1111101100111111100111101111111111111101111111111111111101111110111010122121220111010022002112112222111110111111011111111111111111021211012021221222222121022122
1111111011010011011101111111101111111011111011111111101001111111111011212021112122101122011222211102211111011000111111110110111111212221222222220222002222020220
1111111111011101111111101100111111110111011111111111111001111101101111121122011122210121221111122121111011111111011101111111111111012111212220220112020221212211
1101011010011101011011110011110110101101111111111111111111110011111111111101111111011110110111111111011101111000111111111111111010110011102112212111221022112120
1010101111110110011111111101110111111111101011111011110111011100111111111110001111110111111111111011010011101111011100111011110111111111211120021202001121211102
1111011110011111110011111110011010111110111111011011111101011110011011111111111111011111101111111110111011111111110111100011111011111111221112222212012101100021
1111111110111000111101011111111111111110111100011110011001111011111011111011111011111111111111111101111101111111111111110111011101111111020111012002021121022001
0111111111111111001101001111001111011111111111111010111101110110111011111110111111111111111111110111111111100011101110111101111111110111212221211120111212221222
1111011111101111101111111101111110111101111100011011001100101110111110001011111011011111111111110001111101110111101111111111010111111101111210212122121211012020
1011111011111011111111111111111111111100111111110011101111111101111010111101011011111100111101101110111111111111111111011111111101111110210211001111111021212200
1100110101111001110101111111111011111111001111011010011111111101111101111111111111101011111111100111111111010110111111001111101101101111212221111001112011121222
1110011011111101111111111110101101111111111101101100011111111111011101100111110001010111101101111111101110111111111111110111111011111111122222222112012212102022
1111111111111111001110111111111111110111101111111111110111011111111111111101100011111111010111000111111110111111111011101111100011111111220210112221012120002122
1111111111011001100111111111101011111110111110111111111111101110100100011111111101101111111011111111111111101111100110110101111011111111212211120012121221012112
1111011111111111111101111110010111110010111111011111010110111111101101001111101110011111101111111111111110111111011111111110101001111111111100222112122120202221
1101111110101110101111111000010101111110111111111011111111111111011111111001100111111110111100101111111101011111111111011111111101011111201112211112022221120211
1111111111011111111110101111101110111111001110011011111111111111111111111111100111100101111111110111110111010111011111001011111111010111010121020112112212210001
1111111101111111111011101110111111111111111111110101111111111111111111111101101100011111110011111110110111011111010111111111111011000010012110121210212002002120
1111101111101111111011111110111111101111101110111111111100110110001111111011011111111110110111110000110111111110111001111111010010111101120201122221111111211121
1011111111110111111111110010111110111111100011011111111101111111111111101111111111111110110111111101101110111111111111111111111110111111222111211212211210211111
1101100011111101110011111111111110111011111111011111110011101111111111000111100111101111110111110100111101011010110101111110110111000110202112122022201121121011
aaaaaaaaaaaaaaaaaaaaaaaaaaaaaaaaaaaaaaaaaaaaaaaaaaaaaaaaaaaaaaaaaaaaaaaaaaaaaaaaaaaaaaaaaaaaaaaaaaaaaaaaaaaaaaaaaaaaaaaaa011111111111111021101111221212102000000
111111101111111111011111111011111111111111111110010111111111111110111110011111111111111111111111111111111111111111101111a111111011011111112120111121012112021221
111101011111101100011111110111110001111001111111111111111111101010111111111111011111111111001111111110110011101011101111a100001101100010111011211220101110111211
111111111101111111111011111011111011111111110110111111111101010101111111001101110111111011111101011110011111101101001110a111111011011111010120212211200112220210
110111111111111111111111111011010111110111111111001101111100111111010001111110110111110111111111111111111111111111111111a111011011011111220222212021211121222212
110111111100110111101111111111011111111111111111111101111110010011111111110111001010111011111101111010111111111011011111a011111111011111101012102212210002211220
111111111111111110101111111111111111111011101111111110001111111111111111111001110011100101111110111111111111101111111111a110222102012101012022111020222121221022
100001011011011111101101111011101110111111111111001011011110011111111011111111110111011101111101111010111111011111011111a012222110210110022222220221222222122222
111111011111101111100111111111011010111101111111101111111011111111111111011111111010011110111111011101111110111111011111a120212111121210022221222022122220210121
100100111100111111011111111011110111110111011111101010111111111111011111111111100111111111111111110011111011111111011111a122022222010221221101020110221201111011
111110111111111011011111111111011111110111011101100011110111110100111222221111201211022211002011100201111001101111110111a021211011202221112102221121221210110110
111111110111111001110110111101101111010111111111101110110111100011111122212111210202211101021220121101111111111111110111a101022110222112000221121121220211111011
111111111111111111111111101111001001110110011111010111110111110111111002111111012201122121222221120111110011111001001101a111212002201020211222121121211221111100
111111111011100111111101110111111111110011110111111011111111101111111010211211012122221000110222220111122212102112211111a101012122101122122111102212111020111111
111101111010111111111111111110111111101111111011010111010001001111111212122122202220222111222201210200222102221221111001a121221122220110122220101111012211111110
110111111111101110111011001101111110111110111111001111011111111111111022111011120212212112201020021222220212200112210111a110122021220022012122122102121220111110
101110111110111111111101011011111111111111111011111011101111111110111122222202222211222022112222110020112111211202211111a111001012121011101112002102112221101110
111011111111101011111101111111010111111111111111011011100111111011111112121212212121121112222210210210110111220120201111a121121202111020221002211010221121111111
001101111111111111111101111111111011111101010111011111110101111110111212210000011012222220222112221222102221021222011111a112110220121220121210012212101120111111
101111001111110000011111111111011111111010101111101101111111111110111102102211022112222221222212112112122120111122211101a100211211222222121122101202222011001101
111011110101101011111101101101111111100111111110111111111111111111111112112010212022202222220122002211112212202211111111a111000010122121010201022112202111010111
111110111110111101110011110111111111100011111011111111011111101111011001122002120210100222012212222110101211122212210110a112021222112100212221102222211101111011
001110111111111101101110011111111111101111111110011111111111111111111110120021211112211102221201222120012212222201111111a112122210211012121020121112201211100111
101011010101111110111111111010111111101111111101111111100010101100011221211212122202122222010202010110211210110122111011a122100122211112212121211102102221101110
111111101001111111111011111111111011101111111110111011110110111011010102212120012121222220212220212012111220210202002201a022220122020121211122012102021121111011
111100101001110111111101111111111111111110111011111111110111011111111122011211122122202211122220022020200222020122221111b202122222222122101011222210120221101111
111110111111011111110110011001111010101101010011111010111011001101101010212001002011102121022222120222021122200120221212a121121102201112201112220201200221111101
111111111111111101111111111100011111111111111101011101011111111111111120121121202221102122011101221202202122012120121221b120222220211111221121122212121101111111
111111111111111111111111111101110101101111111011010110111111111011111101121202221222120122122212002120112220121102221122b022212222021112100002222220211211111111
000111111011111111011110111001111111101011001001111110111111111111101121121110122210012011121222120222222212222002212012b222222212211222112212210021121121111001
aaaaaaaaaaaaaaaaaaaaaaaaaaaaaaaaaaaaaaaaaaaaaaaaaaaaaaaaaaaaaaaaaaaaaabbabbabbbbbaabbbbbbbbbbbbbbbbaabaabb22221110201121b022102002201212110201010102221111111111
111111101111111110111001011111110111111110101111111101111101110011111212222002112112221201212210002222222b22211122202202a212122221221111111221122201221121111110
111111111111111101101111111011110011111111111111111111111101111101101211100100212111222222220221222222102a22022221222102b210222222111202201122221120122211111111
111110001011110111011111110111111110101111111100111110010110101101111201211100220022221201221112112212202a01122101121221b220022222212220012111211020102111001111
111111101110111011101111111111111011111110111111101111011111101121121212202221222222210022201222222222210b02022001120102b121122012121120021010021112012021111110
111110011111111101110110111111100110010101011111010111101111111210120222221202222222222202022211222222222b11010121001220b212212222122112012002212210210111111111
111111111111001110001111101010111110111111011011111010100101011121122212110122020121020222201221112222202b22012211221211b121020022211221221211020112121121111111
110110111110111111111110111111011011110101111111011101111101101221201202212122022222202102202222221222222b22222021221202a220212211101111101101110111111011111111
011111111101111111101110101111001011011111111101111110111111111111112220222122211200221221222221020221210b22022222010222b212201220211110110011110111101011110111
110111110111111111101111111011101011111010111111111011111100100121122202222020201222220122222211212202100b22202122202011a110221111011111111110111111111111111111
111100010101011111111111111010111111101011111011011111111010011220122122021212211011221212222020022222122b12002221111222a211221102111111011111011010110100101110
111111001110101001101111011111101011111110111111111010101111011111020111211112112121202202222212111122222b22100022111202a110111022110111111111111111111011111111
011111101111111111110111111111110011111111111111111011111111001222202222111011121221222221220120221122221b11211020022121a212211102110111111011101111111011101010
111111110101110101111111011111111111011111011111111110101100111022111202110111121011202221212212012122200a12220010221002b200021120110111111110110111111111101110
111010011111111101001111110111111111111111101101111111110111111211112101222212112120101110002111111121022a00021202210122a202110002111011111101111111111111111101
110111111011111001011101111101100001001111111001110111111111111212202212121122202021022202222211111122221a22211001211221b111122121111010110111011111011111111101
111111111101010110011000111111111111111010110111111101101110111110110112211102220022122011121101100012102b10022120100021a102222101100011011111110111011101111111
110111001111111111111111110010011010111011111110111111101111111122222201120122222001021102102110011111121a20121012112122b122222000211011111011111111100111110111
011110111111101111011010111111101111111111101010100111010111011011120220221101121210201212112211001121120a21121122212101a201122210211111100110101111111001111110
101011110111111011011111111111111011111101111111111111010101111011002201201011121111211220022110111111201b20121101110111b222222102211111111011111101110111111101
111110101111111111111011111101111111111111111001111111111111111112121120101220222121120212020011111121212a21222221210112a221120202111111111111100111011111110111
111011010101101111111111100111011001011111101101110110111011101101202011222212111211212221202211111121222a11021112201222a111111102111111110111101111110110111110
111011110111111111110111111011011110011101010111000111111110011212221200002110111111212012120010111110221a10122111222210a122211212011111011001110011001011101110
100001011111010111111111111011101111011000111111011111111111111210110201202121221212121201101211110122022b02211011002102b212121111111110110111111111111101110111
111111111011111011111111111110110011011111101111011011111111110122201201221201200122011211221101001120000b21220111222121b212001122211110011111111111011110111111
111011111101001010101111010101110011111111101111111010010111111122211212012212111111010021220210111011111a10111010111111a101110111110111111011011111101111111101
100111000011111111010110110110110111000011111111110101111111101101121210002222212222102012110211011000111a11011110111111a011111111111111110110001111101110110111
110111011011111110111111111101110111110111011111011101111111110122022211112012120122210222122111111111111a11111111011111a000111101111111001101110101111111111111
101111111100110111111111111110111110101010111010111111111011110010220211101110111111011101222111111111111a11111111011111a110111111111011011111001110111111011110
001111101111110110111101110111110110111101101111101111111111111112022211002111121201202220101200110111111a10111111111011a111010111111111001110110011111101111110
111111111111110111011111111110111101111110110110011110011011101210122010211212211121012001202011111111011a01111111111110aaaaaaaaaaaaaaaaaaaaaaaaaaaaaaaaaaaaaaaa
111110100011101111111011010111010110111110111111101111001101111111001111220220122110212020121211111111110a010111000111111111111111111000111111011111111111110111
111111111110111111111011111111111011011011011111111110111111111222112100120102000201220011111201110101110a011111111111011111111110111110101101011110110111101111
011110101111111100111111111111000111110101111110111111101111111021011210122101122211122212211111110101011a011111011011111011101011010111111111100111100100011011
111011111111111111111011110111011111111111011111010111100110111220220102222102012211022222122111101010111a111101111110011111111101111111101111111111101101111011
111111110111011110110111111111111111101111111111101111111111011111011110101111101111110101011111101000110a110010101111111111111111111011110111011101111111101101
110110111111111111001111011111111101111111111101111001100111011111101111110111111101111111111111111111111a111111111110111101111110111111111101101110111111111111
110111110011110111001110111111100100101111111101011110011111110011111111101011110011101011101101111111111a111111110111101111111111111111111111111110111111111111
000111111111111010111111111111110111111111111111111111111011111001101111111111111010111100101111111101111a011111111111110111111111111001001101111111011111111111
111111111111111111101100111111110011110111101111111111111110110110111011011110110111010011101110111111010a111110111110011101111110010111101111111111111011110110
111111110111111111101101101100110111111101111101111001111101111111101110011110100111000111111111111111111a110111111111111101111001110111011111011011110110111101
