155 15
1 104
78 98
151 42
145 5
137 70
84 74
99 77
115 88
85 8

111111010101111111101111101101a11111111100111011110011111100111101111122211120220111201212a1112221220101111111101111111111111111111111001220112112011a1120202221
111111110111110101111110111110a11001110111111010100111101111110011111121102112111121210221b1222120221111110111111111111111111011112220022210012110210a1101000211
110011111111111111111111010100a11111100111111111111111101111111111111110221121222211102202b1112211121110111110101110110111110101111111021010011110000a1222012110
101111111111111110101111011111a11011111111110001101010001111001111111111111011121121221212a1110011122111110011111010110001110011100102210012212210212b0112221202
011111001111111111111100010101a11101110111011011110111011110111111101001212212111110222120a2222222210101111011101100111101111111110112201212122121111b2222021021
111010101111111111111111010110a10011010110011011111111011011111111000101112222121012211222b1202200101001111111011111111010110111011110102010121221201b2221222112
111110111111111011111110110101a10011101101101111111010111110011101111011210111222002221102b1200111122011111011111001111111110110111211101021020011101b2212011121
111010010111001011111011001111a10101111110011111111101111000111111011012100121222111112121a2102210012000011111011110110011011110111022111021102211222a1121121221
101111111111011111101011111111a11011111101101111111101010111111111101121201010211211221201a2002222112111111101101111101111110111111001121222211112112b2021101011
111111111011111111111111111110a11110111111111001111101101101111110101021112002102221121121b1201102122110101110110101111111100111112121111102202111212b1021011200
101111111111111111011111110111a11111111111101101100110111111011111111112122221221101111202b2222221011011111110011100111111111101112021010021121022222b2212111121
101110101011111111100111110101a01111111111111111111111111011111111010112011222021010121111b2211201100111011111110011101110111111101112200100111211211a2102221111
111111001111111111111111010111a11111111111011111111111011011101110111112112002211111221022a1121021122101101011011111011111110111011110222111122102212b2211111211
111101111001111110011111111101a01111101111001110111011111111111110111112211202212121112201a2212022112010111111111111101111111111110012111101211112110b2202111122
111111011101110111001101111110a11111110111111111111101111001011101111111222001110112201122a2102222221111101111111101111011100111111001101122112211122b1112112221
111111111101111111101011101111a11111110110111111111100111111111111111122211221021210201111a2121122212111110111110111101100111110001011220010112022222b2102222110
011100111001111101011110111111a11110101111111101010111111110001111111111112211112021020121b2211210001011110101111111111101101111112012202102122210120b1210112112
110111111111111011111111011011a11111111111100111110111110101111111111120011212210222102201a2120202100101100111111101011101111101102102111010012222200b1102212211
111110111110111111101011101010a11000111111111101111001111111011100111110110212201212022211b0212122210111111111111111111111100111112221221220221110221a2010120122
111111111111111110111011111110a01111100110010101111011111110111111111101110222222022111121a2001212221011011111101110001111110101112222022020100122212a1011212122
111111100111111111111011110011a01110111101011111111111011000111110110112022112220220121122a20201101210111011011111111100111111111aaaaabbabbabbbbbbbaaa1102110211
111001110111111101111111111111a01111111111011111111101111111110101111112220121100111100202b02102201221111111111111111111110111111a022021212111212112122212201111
110111111101011111100110110111a11111101111111001011101111111101110111112011101222110121112a22202211000111011111111101110111101000a120121112221011021100022222222
101111111111111111110111111101a10110110111111001110110101011111110100122021212112111200122b22110120101101111110111111111110111100a121112110012210211112110222220
110101111111101101111111111101a11101111111101111110111111101101111101110201111021011001200a00221100210111111111111111011101101111a222212212011100221201222211222
111110110101111011111101111111a10111011100101011111111111111111111111101202211210001121221a12012102121100101011111110110111111111a110001212112010120211222221122
111101111111111111111111111011a10111111111111011111011100111011011111100121111212211110101b22121111121011111011101111111111111110a222111202211111112022211122221
100111110110111111111111111111a11111111010111111011110111011111011100111110001221122121020b11221211011111111011111111111111111111a011201212220202202221222022012
101111000011101111100101100111a10111111110011001111111101111111111001102211210111121101212a11222221101011010100011111110000111111a211002111022222221222222222212
111111111111110111111110111110a11110111111111111111010110111111111111122111120212122102221a22212122211110111111001110011111010011a222221221222210000000120222222
101011011110101110111111111010a10111110111101111101111110100111111111111110210200122122111a01211222021111011111111111111011111110a101210200102220000222201112220
001111111001101111111101111001a11111111101111011111111110110101111101111111111111100100110a01011011011111110101111111100111111011a110011220211111211020112112011
111111111111110111001001111110a00111011111111111101011000111011000101101010111101111111111a11011111111110111111011110011001111110a110111212011021211221100121221
101111111000111111110111111111a11111110111101111111111101111111111001111111011111101111110a10010111101111011111101011111111111001a110110012121222220101212212222
111111111110111111100111111111a11111111110111011111111101111101111100011111110111111111111a01111101111110101111010101010111101111a111110001022121112100012221020
011000111111111111100011111111a01111010011100101011111011111110111011111111111111010101111a11000111011111111110111111110111111111a111111022112122221111011101020
111110000001111111100111011111a10101110011100101111011111110111111101001011011111111111111a11011111011111111111100011111111111110a011110111102212221012011121112
110011001110111111110010100001a01111011111111111111101010111000011110111111111111111101111a01111101111011101010111111111011111011a111011210121000102220001022102
110111111111111111111100011111a11111101011001111111101111111111101110101101111100111111111a11111111110111110111111111110101111111a111100110022111012120211121211
110111101011101111111111011101a11111101111111111011011111111111110001111101111111011011010a10111101101110111011111111111111110111a111111122121001120221011121110
011110111001101001111111111110aaaaaaaaaaaaaaaaaaaaaaaaaaaaaaaaaaaaaaaaaaaaaaaaaaaaaaaaaaaaa11111100011111111111111111011111001101a101111122011221122212221020212
111111111110101111011111100111111111111111101001111100111010101101111111111111111111110011110110111111111111111110111111011111100a101110121101111221022201121222
111001110111111111111101111111111111001111011111110100111101110111111101111110111110110110111111110101111111101001111011111111111a111111210002202120222121111221
111111010111011101110110001110110111011101101111110110100111001101111111110111111111111011110111101111111110010011111110011101111a111110022212212102212121211122
011010101111110111111111111111111111010111111111111111111111111111111111111111111111111001111110111111110100111111111111111111111a111111212121111112102021102120
101111110111011101100111101111111111111110111110111111111110111111110011111111110111110110111110111101101111111101111110011111111a111111211122201102222102121200
101111111111111000011011111111111110101010111111111110111111101111110101111111111111101111111011111111111111111111011111110111111a101010212120010222011100200011
101101110110110011111100111011001010101111111111111111111111011111111110011111011111101111111111111101101101011011111011101111111a111011111121210212021210102212
111101111111111111101111101110111111111111111111111011110011111111011101111011011011110011100011111100101110000001111011111111010a111111121022102200222122202012
100111110111111111111111111111101101111111110111111100111111011101100111101111111111111111110011101011111111111111110101111010111a111110211222122221110222121110
110111111111001011111101011111111101111111111111111111111110101011111111111111111101111111111101111101010111111011111101101111111a111111122202212121201122021112
101101101101110011011111111110111111010111111111010111011101111111111111110110111011100111111111111111110011111011111111111110111a111111120221101121021122121121
111101111101111111111111111111111111010111101011101111111111110011111110100111110111101111100111111001111110111111111100111101111a111101221121220001122212021121
110101011111111011110111110101011111110111111101111011111111010001010111111101101111101111111101111110111101011111100111111101111a111111201011211122022022102121
111011111110111110111111101101111100001110101111111111111011111111011101111111111111110111110011010111110111111011111011111111111a111111111112112111222220100121
011110000101110111101101011011111111111110111110111101011111111111111101100111111011111111111111001111010110111111110110110202122a021121222222221002122221011121
110111111100111001111111101111111110110011111111001101011011110111110111111101110101111111111000110010000010111111111111112021112a221211222220022012122022211221
111011110111111111111111111101111101110011011101111111111111111111001111111111111111110101110110111111111101011100110111111211111a021222102012202122002021121111
111011110011111111111011110111110111111111111111111111111101011111011111111111111111001111110011111111111111111111111011110212212a021110201110011200210011111111
111011111111111111101111111111111010111111101111111111110111110111100110211201101112111111102112121111001011111111000111001220111b010112222211210211100100011101
011111101101111010101111111111101011111111111111111010110111111111101102122121111101111022122002100201011111111101110101011122220bbbbbbbaaabaababaaaaaabbaaaaaaa
1101011111111111111111111110111111111111111100111110111111111100111112121122212222211020121221220211111111101111101111111110111221220221102020212012121111111111
1110011011010111111001101111111111111111111011101111111111111111111111121112000122110222212220211221212220022012121101101011210201202212220110122110022120011111
1110101100010111110110111111101111111011001111011110110111111110111110112201121012120202112222222122111110001020010111101112211021110212110222111211222100111101
0110101011101111111111111111111001011111110111110110111111111110111012012202102222122021122212012122112221011222102111111120211211212110211111102201220110111101
aaaaaaaaaaaaaaaaaaaaaaaaaaaaaaaaaaaaaaaaaaaaaaaaaaaaaaaaaaaaaaaaaaaaaababaaaabbbaabbbbaabababbbbbbbbabbbaaaaabbaaabaaaaaaaabababbaabbaaaaaaaabababbaaabaaaaaaaaa
1111111111111111111111001010011110001100111110101101111011001111111112011211121112122212220200122112122022122210111111111120112111112202201011111221212201110111
1111111011101111111001111011111111011111111111111110111110111011011111102021122221122022220222221001010112111112021111111110011121211121221011121200102220111111
1011111111111010111111111101001110111001111110111111111011011111101111110202121201201222110222020200120122212112112111111122020110222202200010111111121210111111
1011101111011110111111101111101010110101111111111110110111111111111110021221212211212002222221012202012211222222111110011120111212221102112220211221102111011001
1111111100011111111111011111110110100110011111111111111111111100111110101102212202110222112021121021221210121220121111110022011011111110112102211012022110101111
1110011011010111111111101110110111011101111111111111111111111111110110122222112222022102222022222222220201122011211011101120112021022121121112212212210201111110
0110111111111111111011111100111101111111011111111011111110101110111102221112220211210222122222121222021111212210212100110111012222021211101111221211022201111001
1101111111010101111101111111111001111101011111111111011010101011101111110221211022120220012022202220220202202220202011212122020212120121211211112121201101111110
1111011011111111101101111110111111101100110110110111111110111110111112211222202112112221202122221200211202101222222110010112201210220210120002121012112101111111
1111111010111111110110011111110110111111111011111101110111110111111112210222111022202220212210222222221020111111220201021212111221211111211112221022222111111111
1100110110111111111101011111111111011111111111111101111101111111110110102101222122222121122122122222212122020222220121211220202202221121222201222121221120111111
1111111111111111111111011111111011111111101111011111111110110011101110101001010110120212220111122022222022020112212102111021220020211122121002212112102100110110
1110111111111011111111101111111101111101011111111111011011011111111111022210121011022222222102021220220212122021221222221020122222220121111102101100022100110111
1101111111111101111110111101111111111111010011110111011011111111111112002112021212210222220022112022222112022221221121221112222202210222212221211222210021111101
1111111111111011110111011111111111111101111111111011111101011001101112121121111111102122021021222202210222110222220021112221222021102022112112201112221211111011
1100111111111011100100111111011111011111101110011011100101111111011111221221222100110020122221020011122022202022020122121222020112212111221220221122211111101100
1110110011101111110101111011011111111101011001111110111111110101111011121211222121122222110201121012202121222122222002211222222122221122202012111020111121111111
1111101111010011001111111111011100110111111111111111111011111101221112221222222022002222020121210122222221011021200112110221200122210022110200222010212201001111
1111011110101111111111110110111001111111111111011110111011110110201210222011122222200001222222222122221212222122221210211102211212222121011102222011221021101110
1110110100111111111010111111111111111111111110011110111111111110011122011222122222202202222222220202222121210020222221102202222222210102202210122011010211101111
1001101000111111101111101011111111110001111111011111011011111102102221022222022201220201112220122122220021221222222020112100102122211111111111101011111111110111
1011111111111111001011011100111111111111101111111111101111110012220212222022022212022202022221220122222002122200112202102212211111111101111100011111011111111111
0111001101111100111111011110100111111111111111111110101101101010200122022102221220212222222222212022102202210222021122212120022112111111111111110111101111111101
1110111111111111111001101101110111111101111111111111111111110012221110212222020200222021221222212222022121112122222002111211111100100010111111111111001111111111
0111111101011110011011111101111111111110110111101111111101010011112212211111211110112022221102202122020002122222110012002121121001210111101111001101100111010111
110010011101111111111111111111101101100aaaaaaaaaaaaaaaaaaaaaaaaaabbaaabaabbabaaabbaababbbabbabbbbbbbabaabbbbbbbbbbaabbbaaabbabaaaaaaaaaaaaaaaaaaaaaaaaaaaaaaaaaa
111110101010011100101111111111111001111a011101111111011111111110122220220121021101020220222222101111120102222010222222011211111222211111110110111111101111101111
111111111111111111111101111011110110011a111111111110111111111102222211202221200121111020210212110111110212012111201111111022222002010101111111111111111111100011
111111110110001111010111011110011101011a111111011011111111111011121011210222112011022101212001110101201211222111212202121111220211111011101111111110111110101111
110101110000111111011111111001111110110a111111111011111111111111022222100202211210102202222212111011101101001111211021102001201011110111111111011111010011111010
111110011111111011101111100011011101111a101110001101100111111111010212211011201212111021200010111011112011222112110202221221111021211011111111111111111111110111
011111101111101101011111110111101000100a011110111111110010101111221211011112021100122211102211111110122011211220101011101222102220201101111111011110111001111110
010111111111111111001111010111111111111a111001111111111111110012022212222121021111112010102022010111122122202121221201202111211220010111111111111011100111101111
111111110111111111010111011101111101011a011101100111101101101010121211120222011211201101212102111111102020221121111112022221221011210000111110111111111111111011
111101111101110011111101011001001110101a010111110111011100111111022100222220210121221112222102111011111220101110212010212102011102011100111111111100111101111111
111110111110101111011111110111111111011a101101111101110111101111211110110111222220200210100102111101102110122211221112120222202101211100101110111010111111101111
110011111111111011111001011110111111111a111111110011110110011111111222112210212212102022110002111111121220212212021111021012110222011101110011011010111111010011
111110111101111111111111101101110111111a111111111111110101111101111202101022122110221012112122011011111221002112121022111212212122111111111111111111110001101100
011011001100011111111011111011110011111a001110111111101011101012202201221111222122212011111201010110001011111111011101101111011111101111111111111011111111011110
111101110111011111011011011101111111111a111111011100110110111101012000122211221222220212122212001111110111011111110111111101111111011101011101111111111011000111
111110110011011010111111101111110111111a111111100111011111001011222221122001212110210112111121111110111101011101111111111111111110111111111111111111111111110111
101111111011111110111101111111010110111a111111110111111111101110101212112200002222010212211112111111111101111011111111111110011011001111111110111011111111111111
111111101110111101110111101111011111101a111111111110110111011112220112202202201221120022121212110111111110111110100110111111111111111111101011111111011101011111
111111111111111010111101110010111111110a111111001111111110111111211021121202212122121112211222110101011101111101111101111100111111101111111111111011111111111101
111101111110101111101111011011110111111a111101111011011111111100220221222121122121220100001111011111110101111101111111011111011110111101010110111101110101111111
111111111110101111101010011010111100111a111101110111111111111111112022222111212221121211210101111111110111010111111011001010001101110111010100011000111111111111
010011101111101111111111110011101111100a111111101110011111111101212121210211122220222110221112111111110111101111101111111101111000110111101110101110111111111111
011110111101101101111111111000111111111a111111101111110111110102112221222001011101212210221121111111101011101101111001101110111110011111111110101111101111101111
111111111110111111111111111100111111110a110111111111111101111111110011111011111111101111000111011111011111111111101110111110110101101011111100101011111111101101
111100111111001011111011110000110010010a111001111100111111111110111111110111101010111111111111111111111011111110110111111110111111111011111111111110110101111111
011111111111110011111110110111110111111a111111011111110101111111110111110101111111101111111111111111111011001101110001111111111101111111010111110011111011110111
111011111101111101111111110110111111101a111111111110010101111111110100001100111011111110010111110111111111101111111011111111111111111110011111111010110010111111
111111111011110111011111111110111111111a110101111110111111101111111011111111111011111011111111101101111101010100111111111111111101111111101011100111110111011001
011111111111101111100111111111111111011a111110111110101111111111111111101111111111011101111111010111110111111010111011011100111111011011110111111111111101011011
