155 15
1 104
78 98
151 42
145 5
137 70
84 74
99 77
115 88
85 8

1a1111111010111110111011111111011011111111111011a1011110110111111111112012222121102112222112210211221101111001011111011111111110a1211001112112222221021221221100
1a0111100111111111111110111111111111011111111101a1101110111011111111100012112020222211111021120111112110101111101111111111110111a1122120121211212010021121212211
1a1111111111011111111101111111111111011101111011a0111111100111101101112211221210111010111022122221112111111011111101110111101111a1222111102222202121022211022210
1a0011110110111100111111111100111000110111111011a0110011111101110111101220122122212111221212220122021001111110111011011111110111a1100112220221212011121212221112
0a1111011110111111010111011000111110111111111111a1101111111111111111010111212112001021222201210112222111110111011111001111111111a1012112011002112212110112202021
0a0111111011101101111011111101111111111111111111a0110111101111111111111212221212012121111212212110121111100110111111101111101111a1212211201012222121222112212211
1a1110110110111101111111111101111111111111100111a1111110010111011110101111111211011112102220122012221111110101100111101111101111a1122201012111122122210120121111
1a1011101111101011110111111111101111111111011101a1110111011111111101100111012010112121120222012111011011111111101111111111111111a1122111201002001120020212221222
1a1111111100101111111111111101001111110111110111a1111111011001111010011111212201210202221102100102211111111111111100101111011111a1211111112221101120022210222221
1a1111101110111110111011101111111010111001100110a0111111111111101111112202222221222111201021120221202010111101110101111011101111a1221010222121012211121112021221
1a1111111111111111110111101111111111111110111111a1011111001110111011110221212101222111111220011121022011110111100111111101011111a1222110102102021212102112211022
1a1101111111111111101111011111111111111111111111a1101111101101111110101121010220011102211202002022212111111111110111111111111111a1222111201002211212212211021122
1a1111111111001110011111001110111110101101011111a1111110110111101111110000201120201121111221220102221111010111110001111011101111a1222102221000110200112011202111
1a1111111011010111110111011111001001111101001110a1101100111111111011102110201210121222111222102112112110111110111011110111111110a1002202011021111111120202221202
1a1111001111101110110111111011101111111101011101a1101101111110011001112221211201102121202122211002222111111111111111111111111011a1001222121112012221112201012012
1a1111111111111110011111111011111111110111111111a1111110011111110001001222110220101221010120121222122010101001110010111111011111a1021111122121121021212221221012
1a1111001101111111001100101101111111111111111101a1101111111111100111110112122212000210022112122212001110111110101011100011011111a1220211121111022111100112111121
1a1111101111111110111111110111111111111011111111a0011011110011111111111122111112222222110112211012022111111111111111111011111111a1111120201122212110101011221001
1a1101101011111110111110111011011110001111011111a1101011111111010101111122002021200111110221000011210111111100111101011010110110a1110112111222211212101212102011
1a1111110111101110111111111111011011111110111011a1111111110010111111111012012211211211222221220220021111011111011100110011111110a1212011101112211101212021212002
1a1110111101101111111111111101111110110111111010aaaaaaaaaaaaaaaaaaaaaabaabbbbabbbaabaabaaabaabaabaabbaaaaaaaaaaaaaaaaaaaaaaaaaaaa1011202001122101222221112222122
1a11111001111101111111111011111111111111011111101010011110111111110111202221212122111201102222211012211110110111111111011100001110211222121110101120121110121202
1a11111110011110111111111111111101011110111101010111000111111111000111212012121121111121102210210201111111101101011111111111111111112211220111021121002021200111
1a11111110111111111001111111111111110111011101101011100011111110111111121212102111011100112212222112110111111011111101111111111111121122022111002212210200120112
1a11100110111111111101011100111101101111011100111111111101110110101111121122220221222010001101112222111111110100110111111111111101121221202110222212210221211112
1a11101101110101101111010111111011011011110111111101110100111100111011212001111112212211211122011202111111111111110101111111111111020111021201210211220211110211
1a11111111110101010011001011111011101101001011011111011110110011011111100022011111112121012012200210000110001010100111111011111011211210211111212222112020122121
0a11111110111111010010010111111110100110101111101111111111111101011110012211210121221222021010222110211010111111111111100111111111012122200222222222210202222222
1a11111111010111111100111101111111100111111001011111111111111010111111211212121121212022012011210201111011111011010110101111011100121112022122122102202222202220
1a11101111110011111111001101111111011111111011011100111111111111111111212001112122122012100002112212111101110111011011011110011111200202222102202112122210122102
1a00111111111111110111110110101111111101111101110111101111010111011100122121122121201120021112220022211111111111111101111111111111222212202220222121112012021021
1a10111111111011111aaaaaaaaaaaaaaaaaaaaaaaaaaaaaaaaaaaaaaaaaaaaaaaaaaaaaaaaaaaaa11001011100110010111011111101111111111011111010101110101201aaaaabbaababbbaabbaba
1a11110011110111111a11001101101111111111111100111111111111101011111111111110101a11011101111111100100111101111011111101011110111001111111222a20120121121000112212
0a11011101111111111a11110111001111101111110100111111011110111110111101111101110a11101111110111111111110111011010110001111111101111111111121b22222221011012202121
1a11111101111111110a11111100111111111111010011111110111111110111111110111010011a01110110110011111111110111110101100111110111111111101101022b11121101011122220101
1a11111010110011010a11011011111000111101111111111111101011111100110111110001111a01111111111011111111001111111111011111111101111111110110220a10202211210222100202
1a01111111101011111a11011111110101111111111111110101000110010101110111111111011a11111111111011011111111111010111101111110111111101101011102b11022222200220212222
0a01001010111101011a11111101110111110111111111111111011111101111101111101101110a11011111111111111101111111111111101111101100111111111111011a22121112221211201200
1a10101110111111111a11111010001110111100111111111111111011111111111010011101100a10111011101111101111101111111111011011011111011110111011221b22221021111202120101
1a11101111011110101a11111111111111111110001001111111111111110110111111101111011a11111001111111111110111111111101111110101111111111111111210a11122210201122222201
1a11101111111111110a01111110111011111111100011111101111111101111111101111111101a11111111111111111111111101101111010010110111101111101111201a20110201201001011212
0a11110111011111110a10111111111111101101011111111111110010111001110111111111001a11111101111111111101111011111111111110011111101111101111121a11122210110111221210
1a10111111111111111a11101100101111111111101111101011111111111111101011111111010a11111111111111101111111111111111111111111101001111111111102a21210001012221122212
1a11111110011101111a11111111111111111111111101111111111110101011111111011111111a01111111101110011000111101111111100111010111111110111111222a10112112121122112120
1a01011111111111100a11111111101101111111111111101111110011111110111111110110111a11111001011000011111111101110110101110111111111001011111000b22110201121021210110
1a11111111110110011a10110111011111011110110111111111110100111111111111011011111a10111111111111111011110111110111001001101111111001110111122a12221012001221211222
1a11101010111101111a11110111011111111111110001100111111111110110111110101011001a11111101111111111111111111111110010111111111101111111101120b01211021002122221012
0a01010111111111111a01101001111111111110111110111001111111111110110111110110111a11011101111111111011111111011011011111111111111100001111211a20011110210111210112
0a11101101111111011a11101111111111001011110111111011111011010110011111011110011a11111111101111111110111011111111101111111111111111010111221a21220102020002101200
1a11101111110111110a11111101111011110111000001110101111111111011111110100000111a10111111110111111111101110111111101111110111101110111111012b21121012112210212221
1a01111110111111111a11111111111010011111111101101111110111100101001111111111011a11111111111111101111111111101110111110111111111011110111202b11120121212201111211
1a01111111011011111aaaaaaaaaaaaaaaaaaaaaaaaaaaaaaaaaaaaaaaaa1101011111011111011aaaaaaaaaaaaaaaaaaaaaaaaaaaaaaaaaaaaaaaaaaaaaaaaaaaaaaaaaaabb20021011222221122112
1a111111011111000001101011111101111100101110001111111111110a1111111001100111111111111111101100000111011111111001101111101001101101111101122100211210110211220210
1a111001011111111110011101111011111111111011111111101100111a0111111111111111111101111111111011111010111111100111111011110010111110101111121011221210011110121220
0a110111111111011011101111101111111111010111111111110111101a1111110100110110111101111110011011111111110001011111111111010111111011111111122222112222122011121221
0a111111111101110111011110111101111111110111011111111111010a1111101101011111010010111011010011111001110011101111100111111122222002022202222022222221222221211121
1a101111110111111110111111111001111111110011111111011101011a1111111011111111111111111111111111101111110111111111111111110110211122101121222022222222222220121112
1a111011101111111111101111111110101101111010011110111111111a1100111111111111111111110110110111111111011111011011111101111112220222111221220221221020012211000221
0a101111011111011001111111011111111111001111100111110111111a1011111111111111111111111101111011111111111111111110111111011111211121020201101111102121212121110111
1a110111001111100110110010101001101101111111111111111111111a0111010110102110011012011210121112111212010101101111101111111112121102212022200222212120102201011101
1a011010110111111111111111111011111110111110011111111111011a1101111110202122212122121212202022221112101011111110100110111121122212111120222212201221122211001101
1a111111111011010011111111110111111111010100101111100100110a1101111110120220111122121221210121010222111111111011110010111122122000110111200110201022200221111111
0a111101111111111111111111111011111111111111101111111111111a1100101112101012022220011202212021000220110002120121121011101121012210110121022012202102010221110111
1a111101110111111111111111011111111110111111101011111111111a0111111011212021122001112212022202022211221200101102121111111111211112211202212210211122121220110101
1a111111111111111111111111111111011110101101011111111011111a0111111012221210021121022222121220222122120101111122221001111022122212222111112021121112001021011101
1a111011101001011011111101111111111101111101101101101111110a0011010110221222122212011001202212222212221212222221202010110101110210201002102110100111221121111011
1a111010110111111111111100111011111111111100111111011111100a1111110012211121021211121202122012212222222011020221110011011111122222212121021112112221211001011111
1a100111111101111111110111111111111001100101011111111001001a1011001111111001112122221222212222202222011201211112211111111110021112112201210121221102121201111111
1a101111110110111111111011101010101111101111111100111111111a1110111111202212221221020122222222202101211122022112222001110121111110112211211100001211022221111011
1a010011101111111111111111111110111111111111111111101111111a1111111101112021211021222122202222220010211002222121102111101111111122012220122121011102011120101110
1a111111111111110111111011110111111100110110101111111111111a1011111111102111110110200202202021222022212221100212100110011110221122110202221101222121111221111001
0a110011111011101111111111101011111111011101111110111100111a1101111110221122112111010211012202022001200111222012020101110021221022110121012222111210221111111111
1a010111111111011111111101110011101111111111011011111111111a1111111110111111101211111101020221022220121202021122122011111002112222121222221022222111101111111000
1a111100111101110111101111111101110101111111110111110011111a1111111112111112202212210201212210120221000222220220222011121221202220112112211120211221212210111101
1a001100111001010111111110111010111011111011100111011101111a1111101112111120101122120222211201212121220102020201202222222122202211202221121211122120021110101001
0a111011111111011100111011110111111111111111111011111111110a0111101112111112222021002022210202202011222222102220222010210122200122222020201021212111100221110111
1a111100111101101101100011111111011111111111111111011111111a1111111111021021210101220220212012102202020122212121122101102222222120222212122111210210101201111101
1a101110101111111111011110111111011111110110110111101011111a0101111110021200221220112221110121210222002211200122121111202120121222210101120102010011111021111010
1a110111100101111101111111100111111110001010011111111111110a1111111110222212112120122022220222210222002122112120221222201220022222202212020211101102120021101111
1a011111111011011111110111110011011110010111111111111111111a11111111121202111111110102000200211222bbbbbabbaabbaabbaaaaabbbabbbbabababbbbabb022111022221121101111
1a110111110111100111111111111111111010101100111100110100101a11011111111212101011201002202202002222b200222222100222221111221022220121222121a201221222202221101110
1a001111111011111111101011111110111101111110111111111101111a01111111112002211100021022222220020001b220120022222202211201111201222200121121a102221212102210011101
1a011110101111111111010110111111111011100100101101110111011a11010110122222120121220112110220202202b202011012022222221211122022012222111001a020212210111211111111
1a011111111111111110111110011111111011101111011010111111101a11022202102221222202220222221222012212b221222222220012112100222221202222222202b021122101012211011101
1a111111101111100011111111011101100111111111111101110111101a01101121212220122000122222220202222110b121202022010202201112022222002200122212b120221211122111111011
1a100111111101101111111111011110110101111111110111111011111a11120010221022210110210222202212122210b221220122022100200112222220122112121220a212012122121211101111
1a111011110110110101101111110011111110111111111111111101111a01021210222210022221021020222222022221a021212021221102122111220211221201111111a001011110101111101111
1a111011110111101101011111111111001111111111111111111111111a01101122010200201121222222220120221212b121011021002222211122010122022221111111a111101111111111010101
1a111111111111111110111111100111011111010111011111110111110a11110211202222121220122222222222022200b222122001220121102111201121121221011111a111111111111111111101
1a011111001111011111111111111110111101111101110111111111111a01110220101020222220220222220222222122a020120012002212222011121112011121111011a111110111101011111111
1a110101111111011011111111011111111110111111011101111111111a11110022112021201122201122202221122202b220212221221220122122112121111121111101a111111111100101111010
1a101010111111101111110101111001111110101101101110110011111a10112010211012002001212212212220212211b212221012122222010120202211121201111010a111111010011111111111
1a011110111101111111110000111111111111111111111111111111111a00122211021221211001022222222221022111b222222212221121121011101222111101111110a101111111101111011101
1a111110111111111100100101111101111111111011111111111111001a11001111222201211121120112011222000111a120111021212012102112122102011121111101a111101011111111111111
0a111110101110111111111101111110010101101110101111111111010a11111111102210202220201221112220121110a102222101201222101211012201021101111111a110111100111011110101
1a111111101111110111111011110111011101111111111101011101010a11122211111020211101210102022001121110a111212211010100112220200122021121100001a111011011111111110110
1a111101101110111011111111111111111111110111101111111010111a00120010112012210011121202100210111111a120221120212222211121022112111200111111a100010111111111111101
1a010111001101011110011111110111110110110110011111111011101a11121222211111121202202201222102010101a111101011220110221000122221222211001111a111111111111101110111
1a101100110110011111011111110111111101111111011101111011111a11112012112021002222020122122201101101a020100121212021202102122222221221100111a111111011111111111001
1a111011110110110101111101101110110110011111111111111110111a11112211110112122122112122022122101111a011212122112012222120112210111111111111a111010111010111110110
1a111111111110111110111011011111011111111111110101110111011a11010011222202100022202020121122101111a011220202110001122202220112112211101101a101111011101101011111
1a010111111011111011111011111111001111111101101111011101111a11002211211112220211122120212120201111a111202221201112021121212122200121111110a100101111101110111111
0a110111011111111011111101111110110111111101111111110011110a01021100222201121022221121010122120111a121221111220011211221110011102020111011a111111011111111111110
1a111011111011011111111011010010011111111111111111111111111a11121121101200220020202012201121101111a120211111202111112221022221001221011111a111111111111011110111
1a111011111111011011110110110111111110110101111111110011111a11121211202121222111020212122202110111a111111101001110110111110011111111111111a011111101111111010111
1a111011111011111111110100111111111111101111101011011101111a11120210100112122110102011222212121111a111110011111110111110111101111111101001a111111101111111111111
0a111011111111011111110011101111100111101110111011011101101a11001120011201122121111210202020021101a111111101111111111011111011111111110111a111001111100111111110
1a101111101111111110111111110111101101001111101111111111011a11121212022222212111021212211112221011a001111100101010111111111111111111111111a111111111101111111111
0a111111111111110111111111010111111111011111011111111111001a11110012211122220212212012221011111111a111101011111110111111111101101111111111a011111111111111010111
1a011111111111110111010111111101011111011111101111111111001a10122221121101220210122221221020121111a111101101101011111111011111100111111111a111011101011010101111
1a011111111111110111111101001110111111111111101110101111110a11111202210111222020211102122200111111a111111111110111101111111111011111111101a111011111111101001110
0a111111111111011110110111111001110110011111111111101111111a01120222021102112012200211221002011101a111111011111111111011100011111111101111a011101111011111011111
0a011111111111111011010011111011101110110111011001111111111a11112022122202221002212221202212101011a001111111111011110110100111100101111111a111101011111110101101
0a111110111110111011111111111101110110111010010111111111101a11121210100212002212122102222210001111a111111111101101101111110111111110111110a111010111110011111111
1a111111110101100110101000111011111111111111111111011110111a10111111111011110011110011111111010111a111101111101001101111111110011111111111a010111011111101111010
1a101101100111110101011101111111111110111111111111111111111a11111111111101111101010011011010111111a111111111111101111011101111111110111111a101111001111101111111
1a111100011111111111111110101111111111110110011101111110101a11111000111101111011111111011111110111a111011011110111111011111010111111111111a111110111111111111111
1a111111111111111100000101111111110101111111110111001110110a00011101110111111100111111111111111111a111101110101010111010111100111111111110a111111011110011111111
1a111111111111011111111111010111111011010110011101110111111a01110111101111111111011111111111011110a111111111111101111111111111111111011111a110101011111010101110
1a111110111110111111111101110111111110111100011010111111010a11011011001101111111101111111111110111a111000111111011101101111111111011111110a011111111111011110111
