155 68
7 78
78 98
151 42
145 5
137 70
84 74
99 77
115 88
85 8

11011111111111101110111aa110101111011100100111000101101111111111011110222122122202011221202211222121211111111111111110111110111111111012111121001112002010011001
11110101111001110111011aa011111101111111111011111011001101111001110011021121022110112220211121100212111111110111111101110011110101212221020011011002201021110111
11111111110111111111101aa111010110111101111001010111111111111100011111221011201122021021220222112122111101111101101111110100101111211012212210012102121212211102
01110110111110111111111aa111101100001111111101111111111111111011011111121221212001201122102012012212210110111101111111111111110110101222221201012212112121120211
11010111111111010111101aa000111111101101111011101010011100101111100111111110212222121222110111021022100111111011011101111111011111112212222110221222111210022121
11110111111101111111100aa111111110111111011111101111000111111111111011201021121210220222011222011120211111111111111111111111111111021101101022112211101221122212
11011110110111111111101aa110111111111010010111101111111011011110111111012221221221122121021222111021201110111111111001111110111011111122011221210122100212122221
11111111111011010111111aa011000110001011111111111110100110101101111111020111211012220101111022221002000111111111101010011111111111100002210221011222222112102201
00011111111111011001110aa111001110111110100100111111111011101110111011122111202121101021110111201122211111110001011111010110111111110121212211222220111202012122
11101110111111111111111aa111110111111111101011101111111111111010101100111011210001212022122221202011111110011001010111011111111101211211212122002210122221212122
10111101111011111111111aa101111111011001111101111110111000101111110011012021101121221120012012211122200110111011101101100111111111211111021012000212210121221211
01110111111111101110110aa111111000111101111011111110111111111110111111201101211100022212012211111012101011111111010110100101111011221112121212000220222201111220
11111110111111111110010aa011011011111011101110111110011011111111110101011112112210111012211201212201211111101011101111011111011111100111021222221222221222021202
11111111011111111111101aa011010101111101011011011111011111111111111111221200122111122210222101201112111111111111101110111011111111111111221111202021111021112121
10111111111110110111111aa111011000111111011111011010111111111000101011120112121201112121112012101222101011111110101110001111101111022212221212222201201112112012
11100101111101111011111aa111111111110110001111111110110110111110111101121210010112212122111211222111111111101111111011011111110110200221111221221111101110221202
11111111111111110111111aa111111111110111111111011111111111111011101110222222111110121210122002122121111101101111111011111111111101021222112202110221212102101102
11111111111110111111011aa111001111111101100111111111110111101110111111012121111221012121210100212012011101110111100111111111111110220121210020011100212011122121
11010111111001111111110aa000111011111111111101101111110111101011111111222111212212121020202221220022211111111101101111110111100110122201212011221211122122220202
00011111111110011111011aa011001111111100111111111111111001111101111111212221211101010120111201211112011011111100111011111111111101122022022222112111211122020121
11111111101111101111110aa101111100001110111100111011110111111111100111110211112101111201001202222212211111101111011111011111111111011012122101010001001111000222
11111011101111111011111aa110111111111111111111111011101111111111111111011112122121101111211102121210211101111111111111110111001111120111000121121111101111202212
11111111111111111101110aa011101111111111111101101111101011111101111101122101211111121221221010111022011111011101111110111101111111222111212222220020212220121111
11001111110101111111011aa111111101101011101011111010111111111111111111101221201122212111011221211121111111111111111011011101111111022121120121200222111212012221
01111101111111101011111aa011111111111100111100111111111010101111111111102022120101121000111102112010111011101011111101111010100011121201101221222102210212211200
11110111111111111110011aa101011011101100111011110011111111110011011100102120111212122121122121012012111011111111010101011111001111201221220210111122220102121211
00011110111111111110111aa010111111110111011101011111011111111111110110101110112210222221020102112102101110111111111101111111111101011221222102011221121021012021
01111110101111111011010aa010110110111111111111100101010111011111111111221121201121221120112111122001111111100101011111011110101111110112222220122022212021222222
10111001111111111110011aa110110111110111111100111101101111111111111110212211222212110212122012112120011111111011111111010101111111220122021121222220222222221202
10110101101110101011011aa011111111111101010111111111111100111011011111011101120212102222211210120212211111111110111011011110111111221122111222122220212222121112
11011111111110111110110aa111111111011111111111111111111110011001111111120211220212112102222122212112001111111111111101111111111011202021100212102002011111100220
11111111111011111111111aa111111111111111111010111101011011111100111000110111101110101011101111101111100111011101011100111101111111100111210101111010112210212211
11110111101111111110111aa011111111100111111110111111110101111001111110010011101111101111011011101110111010111111111111111011111011111111100122111122101112112211
11110000101111111111111aa11111111111111111111111111011110111101111111111011111111110111111111001011aaaaaaaaaaaaaaaaaaaaaaaaaaaaaaaaaaaaaabbbaaabbaabbaaaaaaabaaa
11111110111111110111110aa11111110111101110111111111100111111101111111111101001111110111111111101111a000110111111111101111111111101100111201220012111002122000121
11111111110110101111110aa01111110111111111111110111111111111111111111111111101000111111111011111111a111000111111111111111111001101110101110121112212202022012111
01110111111111110101111aa11111111111111111110011111101010111110111111101111101111111101111111111111a111111100111111101111111101110110111101212112111201222012111
11110101111011101011111aa11110111110001111111111110111101111010111111101111011101111101101101011111a111001111111100011111111111101101011112111110210221022212111
11110101111111111111111aa10111111110111111110111111101101110110111100111111111111111111111001011111a111100111101111011111111111111001110212002000222110221221212
11111110011111101111001aa11111111101111011111011011101111111011111111011111110101110111011111011011a111011111101101100111110110111101000212220220022120212101120
01011101111110011111011aa11111011101111101101101010111111101111111011111111111101111110111101111111a101111100111011110111010110111011011122110002112101122112222
11111111111111011111111aa11110011111011111110111111111011011111111101111101111011101111110111001101a011101111110111011110111010111111001122112021111021122022120
00110010110001001111111aa11111101101010011111111101011101101011011101111111111111011001011011111111a110111111111011111111101111111111111112101221010211111112011
11011011111111111111011aa10100111111111110110111011011111011110111101110110111111111111110111111111a111111011111111111111111111110101111121211110112121220211211
11101111111111111111111aa11111111111111111111001011101111011111100011111111111111100111110111011111a111111111011111101101110111111111111112002122122021200211221
01110111111111011110111aa11011111111111111011111011110101111111111110111111111111110101111011010111a110001100011110001111111110111111000112021012222221221221221
10111111111111111010111aa11001101111110111011101111110111111111100110111111111011011100111111111111a111111101110111100111111011011110011012221210122121121212221
11111111110101101111110aa11101011111111110010111111111111101110011011111111111110101011111111110111a101111111111111111111011110100111110112111222220021221021211
11010111010100101111111aa11111101101111111111101111111111111111011011011111101001010111111011100110a001110011101101111111111111111111111112221012011021102221221
11011110011111111111101aa11101111111111111111101011111111110111111001111111111101101111111110011111a011111111101011101111111110111111111101101222011001120012111
11010111101011010111111aa11101100101011011110001111001111111111111111011010101111111111111111110010a111110111111110111111111111100101111022110211111122121200221
11011011111111111111101aa11111111000111111111100010111111111111011111111110111111111111011111110010a100111110001111111111110111111111100211111011102210201111121
11101111101100111111101aa11111111111111011110101111110110110111111110111111011110111111110101111011a101111111111111101100011111111101011222121122201112122111011
11011111001111111111111aa11100001111111111001111111100111011111111111011000111110101000111111101111aaaaaaaaaaaaaaaaaaaaaaaaaaaaaaaaaaaaaaabbbaabaabaaabaaaaaabaa
11011111011101111111110aa011101111100111101111010111111111110111111101011011111111111111101011110010111111110110110011011101011111111111021000222122102122211111
01011111111101111111111aa110111011110111111011011111110111111011101011111111111111111111101111111111110111111111111111111111012111110122221202022222222222101121
11111110111111111111111aa111001111001011111111101001101111011010111011111111011101111111111111110001010101011110111110111111210121202101122120011202220222012121
11111111011011110110101aa101111111111011111001111101111111111010110101011111111110110111111011111111111110010111111111011121221121110202112121221012012122021121
01111111011111011101111aa111011111111011111110101111011111111111111111101111000111001110111100111111110011111111111011111102112211222120021110111222111021001110
11101101111101011111111aa001101011111101111110111101101111111110111110222112011122221101212122212011111111011111111111110122221211112211212211200121111221111111
10101111111111111011011aa101100011111011111111101111110111111110001111020112211100122222112202011102110011011111111111010121111221202102202111120111121110111011
01111111111111010101101aa111100110101011111100011111111111111111111110110021122212020101210101000121111111111101111111111012211112210221102011112220011211110001
11011011011011011100011aa011011111110111111111111111101111001101111111100212100021202222202212010102222201121221120101111121220122210111112022221201112021111110
11111011111110101101101aa111101111111111111101110111110001101011111012220021011101221212212220122212222100211211111111101112120210222101201112111221111221110111
11101110111111011111111aa011101111010111011111110111101111111100011112001201112222212022122222020122121211012210211111011110222111111012022210212101211011111111
11111011110001101111011aa101011011111111111111111011111001111101111011211121021121112112222202122212110111202122011111111122221011010201202100120021210221111101
11111111111111111101111aa111011010101111111111111110111111101101111111001001102020202122022022122222100020121021012101111111112021002111222102100112221101110101
11011111111111111111111aa111111011110010101111011100111100111110111112110211111112102112221222102121222221212122212111101120222222021111102210120011022111111111
11111111111011111011111aa101011111111110110101101100100111010011110111122011200111200212122202102122120110220102112101111102101201220120121021212201221211111100
11111111010111011110101aa111010110101111011111011101111101101101111112011112221102122120222221221001202011022122120110111112112120212122222220012112202111011111
11111111101110100110011aa111101010111111111111111111011101111101111111011001021112222120210202222122022110102110122111111011121122202112222212101101012210011101
11111111111101111111100aa111111111011111101101111111111111111110111112201200122120222112210112022100200112210111012101111120022102022201122012222122021101111111
11110101110101110111101aa111111111101111101101111101111110011111110002101220111022222022221210022022220210112202220111111112202022122022212101102010011211011101
11111111111111111111111aa011111011111111111011100111111110011110111112211111211112022222220122101220210022202202212221011122022222212200111212002122102011111111
11111110111011111111111aa111110101111111111111111011111111011101111110111221021201102100210222121220212222221201221012202022222201211021212111212212210020101111
11100100111110111111011aa111111111111011110011011011110111111110101012122212222101211202202220222221200221202112110211212220201202021121112221212220210101011111
01111010110011111111011aa101100111101010111110111001111111111010111011211101101221221221021220222020112200222110002122222002212211100101201222111121212111111111
10011111111111111011110aa101101111111010111100111101000110011001011010111222112112122220222220220222022222102222022222022101212200201212202122222120210111101111
11111101111110101111110aa100111100110111111111100101111101011111110111222201210221211022222222212220221122102222222120101120212022121011000121222200112220011111
10111111101111011111001aa11111101101101111111111101011111101111011101112212022202012211222022222bbbbbbbbabbbbbbbbbbaaabaaabbbaaabaaabbbab21122122022112120101111
11011110100111010110111aa11101111110111111111111111111111111111111101222111111111201222121222122b222222220011022022122202022221202101211a22212021211001220110001
11111101100111111111111aa11111111110011100111101010111011001110111111022222022212222220202220222b022220102022120221111121122200222102220b12022110122210121111111
11011111111111101111111aa01110111111011111111101111011111110111111101202120112211121221221222220b010221202222121202120022102222022220221a11101112211122101001010
01111011111111011110110aa11011111111111111111111111101101110111221121122212220212200002222122221b202122022222112010121221112221222211120b22202112111102011111110
11011110110101111101111aa00101110111111111111100111011111111111122102222201222202221222200020022b122122220222221222220200122222201122011b01212222121101011111100
11111100111011111111111aa11110111111111111111111111110010011111222222121120012222220222222222222b221022211221202222212110222220022012122b11020212201110101111011
11101111011111111111111aa01110101110111111111111111111111111111222212101102212212222012222222222b122220201222222022101001211222122211111a11111111011111111011100
01111111001011010011111aa11111011001101010101111111111101111111010212201001220220221122122222212b122220102221222202002120110122112211011a11000110111111111111111
01111111010101110111110aa10011111100101111111011101111111111111222221122222222200221222022112110b112222221212222221222111210202122211110a11101110111110110111111
11011111011111101111111aa11101111111111101111110100101110101101021020212121222122120221202222212b121220022200222220211112210121121101111a11100101111011010101101
11010111111101111101111aa01111111011101011111111010111101011110010122211202202122211212112022102b112222122222122022122212112211220110011a01011011111111111111101
11111110011001010111110aa00011011111111111111111011100111111111100221020221220211120222220212021b120212221222201122012212101021222000111a11011111111111110111011
11011111111111111111111aa11111111011111111111011111111110101111222012211011122120010220222210110b222021210211210022012122211111022111011a10110110111011111111111
11011011111111010100111aa11110110111111111111111111110110111111221210222221211222012212202222211a111021210221222100121211012111212101111a01111111111111111111101
10011100111111111111111aa11110111010110111011111110111001110011211011221102210121201211121212111a111121002101122021111122120121121201110a10011110110011111111011
11011111111011111111101aa01111111011101101111111111111100101111012211221001001110101211111211201a000111122021110022211121212122202011111a01110010111101100111111
11011111111101011111011aa10111111010011101011101111110111110110122112101120122212211201012121100a110111020111012212211110002212122111001a11011111111111011111001
11001111111011011111111aa11101111110111111101111111101111000111220121221001111120222112112102211a111021101222110021202021012212121111111a10111111101100010010111
10101111011111101111111aa11111111110111111001111111110111011111221110210002102122222110211211100a111121121211111110122111222100202211111a10111111101111111110101
11111001011011001111111aa01011101111111101111011111101111111010222201211212210011020212122212111a111002021221110222122010221210121211111a11101111101011111111111
11111111011111111111111aa11111011100111110111110001011111111111100222201112111202121022222020110a000202012202222022212212102112121111011a01011111111111111101011
11110111111011110111111aa01011111000101101101011111111111111111222220212212202110121212012010211a101012021121200212102122120212222210111a11111111100010110111110
11110111111111011100011aa01111111111110111101101111111111111011000212122211202221211221111122211a110222110212202121201212111221211101111a11110100111111101110111
11001010011111011111110aa11011101011111101110111111111111111011210111112001120202111002211222010a111002101002111201102211111211212111111a01100111110011111110111
00111011101111101111100aa11101100110011111011001111111111100110011210201122011021111121022022111a111111110111111111111101111101010110111a11111110110011011011011
11111111111111111110111aa11011011111101100111111111010111111101011220112012112221021210112022211a111011101111111111110111001111111101111a01110111011101110111111
11101011110111110001011aa11111111110111100111111111111011110111102012200221012221211001121221211a101111110111100111111010011111111110101a01010111111101100111110
11111011101101111011111aa01111101001111101010111101001110010111112212201122211220211220120212211a111111101100011111101110010011101101010a11011101111011011111011
00111111101111101110111aa11011101101101001111111100011011010111201121121122221221221221011122201a011111110011110111111010001010110010111a11101111011111111011111
10111010110101110110111aa11111011011111101101011100011111011101111212110222112211110211011101110a111111111111010111111101111111010111101a11111110111110010111010
00010011111111011001101aa11111111111111111101100111111111111101212120012222000212220112222102111a111111111011111111111101010101010111101a01111110111111010111011
01111011111111011111111aa11111001101011111101011111110111110111112211021002121111022121221112011a111111110011111101011110110111111111111a11011111110111011110111
11011100101111111010111aa10100111111011100111101101101010111111222122221112222122211111012112111a101111110111111111111111111101111111011a11111011010011110111101
10011111101111111111111aa11111111011011110111011011110110111111022112201102112210221122112212111a111110101111110101101111111111111011110a11111111111111111111011
11111100110111111101011aa01111111111111111111111101110111111110111011111111111010110111111100010a111111111111111011111111111111111111111a11111110010001111010110
01111111111111111110111aa01111011101110111111111111101010010110011111111110111111111001110110111a111101110101111101111111111010111110111a11111110111101110011111
11111111111111011101111aa11111001011111101111111101111111101111101111110111111101101111110100011a111111110110111111111110001101111111111a11100111111011111101111
10010111111010101111110aa11111111100111100111011111111110111111110011111111111111111101101111011a111011111110110111111101111111110111111a11111011011111111111110
11111111111111011010111aa11101111100111110111101110111010111111111011110111111111011111110111001a111110011111111111111111111111010111111a11011111101101010011011
01111101111111001111110aa11110101000101100110111111010111111010111110101111111111111111110101111a101011110111111111111110110111111011110a01111001011101011011101
