2 75
143 55
78 98
151 42
145 5
137 70
84 74
99 77
115 88
85 8

11111011101a11011111111001101111110011111111101111111011111101111111112111120b122100211220121212121121111111111111111a110111111111022011211a21121111210111121200
11110110111a11111111111111011111111111111111101111101101110111111111002221222b022210221110211121022001011111111101111a111011111111222121220a22122111222222120212
11111111111a11111011111101111101111111111010011111111111111111111011112212022a212221012122222221222121101111111111111a111010101111012010111b21222211122221112101
11110111011a11111001011111111111111011111111110011111111111111111111111201121a202202001221111212211210111111111111110a011111110110222122112b12220102120122110200
01101111011a11111111110011111101111111101111111110111011111100111111112022012b111220122022010222110111110111111111101a111011011110111112020a11121211222211211211
11111111111a11101111111011011111101111111111111111111101111111110101002121202b111122212210200001102111111111111100111a111111011111212212121b12221221012221102202
01111011111a11111111111111011101101110110010011011111111011011111111102220211a121111222102112100222101001111111101001a110111101001212122221b01210221020212210211
11111111111a11101111011111110111110111111111111111111101101111111111112201221a122012100011212220201211111110111010111a111110111100112222121b22101221112021212210
11111101110a00101011011111111111011111111111111111111111011100111111110022101b122101212022112122111011110111111111110a111011111111112012121a22101212221212122112
11100111101a10011111101111001101110111010111111111111110111111011111110211200b012121210001222122111001010111111011100a110110111011122111122b01212212220212022202
11111111101a00111110111011111111111111010111010011001111111110111110111201122a221221121212110011211211111111011100101a111111100100120100121b12002200001212210111
01100111011a01110111111111111011101111111101111011111001111111111011101222221a121001221122121120102011010010010111101a111101110011012000201a21112222221212011112
00111111111a01111011111101111110111111011110110111111111111111111111111020202a222212021011122122112221111011110111011a101110111011001221221b21001022212222121121
11111111011a11101111001110111110111111111111111111111110111101100100111002111a122121121122201111212121111111111111111a011111111011121101022b22121212120122110211
11111111111a01011001101111110110111110111001011110101101111111011010112201010a210212212212100122122101110011111101110a111110111101212221212a01102111211111212111
10011110111a11111111110110111111111111111110111101111111111101110110010112021a111221222121021222021211111110011111110a110110110111212101120b12222202120112022111
01111010101a11111101111001111101111111111110111111111101111111111111111111111a211001021221020110211111111111011111111a0aaaaaaaaaaaaabababbbb22211110212111202211
10111111111a01101111110111111101111111110111110011110111111111111111102221101a101000012102112100122220111101011110010a1a1111111111120201011112120012021102210111
10101101010a11110101101111111111111111011011011110010110111111110111011111120b121111020212120020221111111111111011111a1a1111110101210111222122211211011111200112
10101111111a01001111111011111111111111111010111101111111111111111100111022221a211220111112211211101221111111011111111a1a1111111110011112111022111211221102010022
10110010011a11011111110101111111111011111111011101111001111110001101012101222a111001101202122111120211111111110110111a1a1000111111110012222222211210112210022020
01011111111a11111111011111110111111111111101111110111111111011111111111021100a111102221212120010110021110011111011110a0a1101010111211211200211221022222211220201
11111111110a11101110111110011001111110111101101110111111011110110111112112121a212121122112112220201210110011111100101a0a1111111010101101122211021121011020011022
11111111001a10011101111111010111111111111111111111111110100111111111011010211b122122101211022211122021101111111100001a1a1010101111110102122112221222221101001111
10111110111a11111111111111110010010111111111111101111111001101101111110121221b212110212111100022022221111101011111111a1a1111101111021222121211112011222122111201
11111110111a11111101110111100111111001111011011001111011110011110001111022022a121112221211012211212021111101010011111a1a1101110101211020220112222221121111012222
11101001111a11111111100111111111101111100111000111110111111110111101112210200a011202122122012211002211101111011111101a1a1111001111211121011211120120211021020112
10111101011a11111111111011111010111111001011111001111100111111101111111110110b011201122122202110220221111111111111111a1a1011111111202211100202212221212212122222
11111101111a11100001101011111100111110110111101101110111111111111111112111220a221012220210122002210101101111011111110a1a1011111111121112222012222212220222110022
11111111010a10111011110110110100111111010110110111111111110111110111110002002a201122200012210121110121111110101111111a1a0111111010020012221212212222222101211221
11111111111a11101101110111111111111111111011110111111111101111111100110021021b111220222121120012002211111111111111111a1a1011010111222121220222121022022212002022
11111111111a01111100111111111111111111011111110111111101111000111111111111111a110011011111101111101011011111110111110a1a1110111110101111221221101211021022122112
10110011010a01001111111101101111110111011011111111111111110111111011111111110a111101111011111011111011000101111101101a1a1101111111101111112200211221121112222112
11001111111a01111111111101101111111111011011110111101111001111111011111101111a111111111111100011111011101111110110011a0a1011111110101011121121221112112222210222
11110000101a11001110111111111101111111111111111101111111011111101110111010111a101001101111111101111111110111111111110a1a1101011101111100211221202201012122022112
11111111111a11111011111111101111101111011111111011011010111111001111111110111a110111111111101111101111101110111100101a1a1001111100111111102112011022120221211102
11111111101a11111111101011111110101111111111111111111111111101111111100101011a111111111101101111111111011111111100101a1a1110100111111011010221222112101111012011
11111110001a11101111110111011110101011111111010010010111001111111101110101011a001111110110011111110111101101101110111a1a1101011101111111202210222112112122022011
00111110111a10101101111111101111110111111111101111010010010011110011111111011a111111010111111111011101111010010111101a1a1110111100101111210111002210022101022022
10111110111a01001011111111111111111111111110101111111101011111110011110111011a111111111011111101111100111111101110010a1a0111111011101111121222201121022212121122
11111000111aaaaaaaaaaaaaaaaaaaaa11011101111111000010011001101110011111111111PPPPPPPPPPPPPPPPPPPPPPPPPPPPPPPPPPPPPPPPPP1a1010011101110111122010012111102102220021
1111100111111101101111111111111a111111111111011101110111111111101010111111PP011111101101100111110010111111111111111110Pa1111110111011111221212000122112012211202
1111111111111110100111111011111a11111111101111111111100011110011110111111P010111011111001111101111011111111111110110111P0110001111111010011122110101120011022001
1111111110111011111011111011111a1111111111110011110111111011110101010111P1111101111111111111110101101111111101111111001P1111101111010110110212211022210201022211
1111111111111110110011111111011a111111011100110011111011110001110111111P11111101111111001111101101111111011011011111111P1011111111101111210200220221112202222221
1110101000111100111110110110111a111111111110110111111111111011111PPPPPP011111101101111111101111111111001111111101101110P1101110101110111210112212021120122011111
1110101111111011101101011101011a11101001111001111010001111PPPPPPP010111111101111111111101111111011110111111010011111111P1111010100110111121120212221201122111112
1111111111110111111011111101011a11101111011111111PPPPPPPPP0111011111101111010110111100111111110111111110111111011111101P1111101111011111010112211012022122001020
1101111011111111111111111111111aPPPPPPPPPPPPPPPPP0011111110011001011111011101101111111101001111101111101111101111111100P1111110111111110101011102012111212221211
1101101010111010111011111101011P110111101101011111101011111011111111101111110111011111111101110111111110111110011111111P1111010001111101111211101011110110011212
1111010101111110011111111110011P111111101101110111111110111111111111011111111111111111110011110011011110111111010010011aPPPPPPPPPP011111112002211112110011122201
1110111111111111111110111111111P010101111111111100111010011111101101110111111011011111110111111101110011111011111111111a1010111111PPPP11222122112112111220112212
1111111001111010101111110111111P111011101011011110111111111111110011111111110111111111111111111011111101111101011001111a11111101111011P0120221022122121222112121
1111101011101101110001111111111P010111111110111111100111110010111111110011110000111110101110101110110111101001111111100a111111011011010PP2P21P012220212211121121
1101111111011111111111111111111P101110110101011011011011011111111111111111011011111111111111011101111011110101111111111a11111111111111112P2PP2P12122112011220001
1111110001011011111111111001111P111111111011011111111110111111101000111111011011111100111111101101111111100111111111110a11122010111201112101221P2112222001220002
1111111101101010101111111011011P101111011111110101111110111111111010110111111111101011111111010101111101111111111111111a1021011211002200100202201202222021102112
1111111101110111111111111110001P100101011011111111111111111111001111111011100111001111111111110111111011101111011010011a1121102101221110001112001002122021121221
1111011111111001111111111101010P111111111011111110100010111110111111101001110111111111101111011111111111101101111111001a1112211122101210212122021211202110011110
0111101101111010111111111111111P111111111111011110011101111111111111001221112101212120001201212101221111111011111111101a1011110021202201120211011100100011111111
0110011111111111111111111011010P101111101111111111011110011101111011111221212111210100111102222102001111011111111111111a0002122121011111111221212121202211101011
1110000111001011111111110101011P111111001111111111011111111101111011122122110121102112121220021112121111011111011111111a0102211111112111022010212211101100111111
1110111010111111101111111101011P011111101011110110111011111010100011120121112112111221102222212202221221211101111011101a1022110112020211212211112110121210011010
0111111001111111010011111111101P111111011001111111111111111111111011112201210221011122221022002220221221221201111121111a1110211122221011202202100101212201101111
1110111111101011110111010111111P111101110101111101110011111010011111110210122220212121222221122221022112121122222201111a1110212101221012011210112111222220011011
1110111111011111111011111111011P111100110011101101011011101111111111112221210121220122221021220222202102121121211021101a0120010210021112001111211002110001101100
1111111111111111111111101110111P111111010011110111111110010111110111111001112201212221022122222211221112121221121221111a1111222021210210222211202111220011101111
1111101111111111111101111011101P010110111011101011111111110101111111101201222220220020222222120222012120122011221220110a1121112122112111000221022011211121110011
1110111101101100111111100111111P111011101011101111111111111111111111110122102221101222200222110211101121112220221021000a1111011011122212122222002202021021111110
1111111111111111111001001111011P111110001111111101111111111011111111122122121111220122002221222022221121112110011220111a1121002110210210212211202120202220111111
1101111111011101010111110111111P111100101110110111011110111111100111101121111121022212221220122000202211211120121221111a1022100112012112220111222222202121100001
1111111111011111110011111110111P111011111110111011111111111011101111111112211111121122220122022222221122212122201000011a1112102222211121202201011112111111111110
1111111100011111111111101110111P111101111111011111110111111111011011121201101102210121222122221012222101101120112111101a1121222022221220002020220220121211111111
0010011010111111111111011101110P111110111111111011001110111111111100102212020202110222211220221201020222122212222022011b1212222222212020122221112211111201111111
1011111111111111111111110111101P101111111111101101101111101110110111110211110222210122222021101122202022122122122211021b1212222022122122011111220112121011111111
11P1111111111111011111111111111P111011101101100101001110111011111111112011022022111211012220222222211121102221022001211b1122212222200011210212111121212021011011
11P1101111011111111111111111101P111101111111111110100111100011111111121211221020222112211222012210222222220021220220021a2122222002200122022211112101222101111101
11P1111100011011110111111101101P111111111111111111111111010111110011120002021221121122202202222121022022022222220212101b2022000201112212220210222121021111101101
10P1110111101111101111110011111P111010111111111110100111111111011001110111121121101212212222222221022222022202122212012a2112001210201112202220121221110120111011
01P1111111111110101110111111011P111111110111111101111111111011111111112211212222021102022222122210020110222221122121001a2102022220211112222221122222122221101011
aaaPPPPPPPPPPPPPPPPPPPPPPPPPPPPa111101111110011101110111111111110111110010122002011121202201221122111002202212222222110b0021202100212101120022102102010211111111
11111110101011111101100110001010111001011100111101111111111100111111121121001112121222020222220021221202012022220121121b1202222202221211110212022212021121111101
11101011111110111111111111111011101111111111110111111001111111011011121201212021022121221222021221000221122112220022022a2102211022222112121210122000021121110111
10111101111111101111111111011111010111111010111111011111111011112211121202112100220220022210222221202022222222122002111a0120221222212222020021221221012201111111
11011111011110111111111111101111111111111101010111111111101011022011212220200221222002202220200221222120201221220221202a1102222222211001020111221222121201111101
11111111001111111101111111111101111110011100111110001111101101122122122122022212121222202220220222220222202222221222102a0012221222212022211222121101102221101111
11111011011111111110111111111011101111111111110111011001111010112101021011220221001220222022200212222121222122222222210b2120101100011111100101010111100111110111
11101011111111111111111110111011111111011001011001100101011011122011022220222222221222222222221222222122212100222221220b1202201111111111111111111111111101111010
11101111011101011110111111011011101111110111111111011110100111020110122202112222121012222222220201220211202212222222111b2122212221211011011111111011111111110011
11111101110111011111110110010010011111110111111111111110111111120112120222002222212221012212212021221102212122212212200b2121202012101011110101111001111110100110
00111101111111111110111111111111101111011111111011111111111111102222212121020002020212010121121010222121122222002201222b1110221210101011101100111011100111111101
11011111111101111111111101011010111111011110111101011111110111112201112212200111120122222202101011020120202121212221222a0122221120211111111111011010111101110011
11111111111101101011011101111111111111111111011110011101110110122221021112111012200212101222211121202221222221122021100a1100212021110111100011111011100110111011
01111111110110111111110110111111001111111111111111011101110111002111120011200122112011221012211111102101210022111112102a1212011210111101111111010011011110111111
10100111111101100111111011101110010111111111111110111111111010121122022211022210122001222121111010110112101122121121101a0221011120011010111111111011101111010111
11100111111111111111111111111111011111110101111111111101101011101220012221121022120021012211111111112122210002001200112a2012111221011101111111101100111111011110
11011101110111111010111101011111111110110111111111111011111100012001121121212211111012222212020101001211221002220010021aabbabaaababaaaaaaaaaaaaaaaaaaaaaaaaaaaaa
1111111111111111111111110111010101111100111010101101101111111110021002011221200112211121120222111011212220211111122000221211220201011111110111110111100001111011
1111101111011111001111010011111111011011111111111110111111111110022022110211111220121211200211111101021120001212101012122012021122010110111011111101101000111110
1101011111111111111111011111111100111111011111111111111101110110022202112221221200220121112122111111222021220011112110121002212022111111111111111001111110101100
1111100101110111111111111100111101111111111111111111101011100101110220222002212021211121222122111101102222222111111122111212211220211011111110111111111010101101
1110011101111100011110110111111111110011011001111011111100011110221222122212221122201120102221111011121221121202202012102221110112211100111111101101111111111111
1111111111101101111010111111100110111101111111111110110111010102022102112201001202122121002211100111102222121122011010112110101201211111111111011111111111001110
1101111111101010010110111111111110111111111111011111101110111101220021120112011220121012120112111100021211111111110021112221220111011110101111111011111101000000
1101111110111011110101101111110011111110111011111111111101111112101212100111122121120102002000110101111110111011011011111111111111111111101111011111111110111111
1111111111001101110111111111111101111010011111101111110011101102202120122212121221212202121200111111111111110101100011111111011111111111111011111111011111111111
1111110111111100111111111001110110111100101111111111111110111010212221212020010212222110220211111111111110111011111110111110111010111111001011111111100101110111
1111011011111110111111111010100011111101101011111111101011111111012201112201211222022021001121111011101111111101011100111011101111001110101111111111110011111110
1110011101111111111100101011110011111101111110111111100111010112011122121211022211012102211220101101000111101011110111111110111111010111111100000111111111011001
0111111111111111111111101111111101001111111101111111101010100111212222212101221121221112110201011111111111110111010000111111101011001111111111111111111110011111
0111111011111110110111011111111110111111111111011011111110011110201122202012111202112112201212111101110111111111011111110111110111111111111001111111111011111111
1111111110111110111111111101111111011111111111111110111111111111122220111220021222122111112011111011101101111111111110110011110101111111100101111111101111111101
1101111011111110101001111101001111111111111111011111111101111112201121222122021210112102011221101101111011111111111111111110111011111111111110101010011111111111
101111000101111110111111011111111111101aaaaaaaaaaaaaaaaaaaaaaaabbabaaabaabbbbabbbabbabbbabbabaaaaaaaaaaaaaaaaaaaaaaaaaaaaaaaaaaaaaaaaaaaaaaaaaaaaaaaaaaaaaaaaaaa
111010101100111111111111101111111101111a011111110111011101111111111110011011011111111111101111010110001111111111111111110111110110111111101111001101101111101111
111110111101111111111111110111110111111a011011001111111111111101111011101111001111110111110110111101011111111111011111111001111111010111110010111111101011011110
110100110111011101111111111111111111011a010111010111101011111100001111111111111111100101110111011111111011101111111011111111111101111101110101110111111111101111
111110101010111101111111111111111111111a111111011111111011111111011101010111111101111100011111101111101111010111111011011111101110110111100111111111011111101110
100001111001110111011111111100101011111a111111111101111100110101111101111110101111101111110101011110111100111111100111111111110101111011111111011111111101111111
111011101101111110011010111111111111111a111011000011111011111100111011110111011111101111111111111001111001111111110001101101111110101101001111011100001010111111
