155 68
7 78
78 98
151 42
145 5
137 70
84 74
99 77
115 88
85 8

111111111100101111101111111111111111010a1111111101011111010001111111112201212001021102011121111122201a101100101011111101011111100111a121120221110201211122111121
101011110111111111101111001111111111111a1111101111111111001111111111112202221111011120220020210001121a111111110111011110011010110112a020112102220212222121020101
111101111111101011011111011101111111110a1101101111100111110011011011112120111112110022101112011211020a111101111111111101100101111100a221010221221211220102202222
110111100111100111111111111111111011111a1111111111110111110111111111112021102122221222022020102221222a111101011111101111111111111122b221121122201200122011220020
111111110111111111111111011110111111110a1111111011110101011101111101112222120210112212002112122222221a111111111111011011110111111111a211202222211110201221002110
111111111111001111111010111001111111111a1111110111111011011110111111101112212202122122001220102020212a010011100110110111110011101111a021012111102112112122210210
111101111110010111011110111101101111110a1111011111111011111111101111011121120221101012112121211220212a010111111011101111110111111121a101102abbbbaabaaabaabaaaaaa
111111111011011111111011111110010011011a1111110111111111111111111110110122111112112210212112211100210a111101111111011000111000111120b222111a22211001122211222212
101111111001110111011111111011001111111a1111010011001011101111111111002111211002222211012112121212022a101011111111110101111111001011a121101a12220010000201222112
111111111110111111111101110011111111110a1111111011101101101111111111012211121221011120111212122121211a111111111111101101111101111122a220111a21211201111122221122
111111111100111111101111111001111010111a1111111111111101010111101010112202212011102112012112101212110a111111111101100011111111111112b112202a22021221112111011221
011111111010001001001010011111110001111a1111001111111111111111111110112021122101122211011112020220222a111111111110011111111110100001b220121a12122002020011221221
110011110111011111110111101101101110111a0111111111101110101011011101110120111200211121211222112220021a110111101011111111111101110122a122002b21220220202122222112
011110110111111111001011111110111101110a1011111111001111111110111111101111122210020221022211021111102a101111101010110111100011111102b011210a12120222212111122111
100101011111111111111111101111101101111a1011111111101010111110110111011211101221021222222210221122120a101111111111111110111111011111b112210b02220112011200200101
110111111011111101111111111110101100011a1111010111111110101111111011011120200212222112202011212222111a101110111111111111111111011122b022110b22022112212221221121
111111101111011111011111111111111011011a0111111111011101001011011110011201011201211220221121122022211a010111110101111111111111111121b201121a21201121111211111021
100111111111111001111111111111111111111a1111111110111101110011111111112221101120102011012101002121021a110111011010110111101111101111b011022a22122022022212101102
111011000111111111111110110011100111011a0100111011111110111111110111112201110212212222212221101112121a101111111111110101101111111122a112202b20121112222211020202
011111111111111101110110111111111111011a1111111111111111101110111111012122211021210111210211101210221a101101110011110101111111111122a111022b10102122201002221211
010111111111111100101111111111101011011a0011111111111010111101111110012011111112221222100000202100221a111110111101100111111010111121b221122a01011010102101211022
111101101100111111110110111111111111011a0001101001101110111111111110111112101122120210102012121222112a111111100101111001111101111110a012212b02121120120212120201
111111111111111100011111101110101011101a0111111010111111011111111111112120221220211120102211202110112a111011111111111111011111101122b112101a02210012210111212112
101111111100110111111011101111111111111a1110111101111111111111111110102022112202211001110022011122220a111001101110011101011111111001b222110b10122121111010222000
111101111010111100110111110111011111111a1011111111110010011111111011110212121111221122122220211222200a110111011111111111111111111010b102221b11121020100112112002
111111101101001010010111011011001001111a1111101101101101011111011111111212011222210212121120101102122a111111111111110111111111111111a121111b21121000122202121212
011111001011111011101111011111111111111a1110111011111111111101011111112120211120102222121120211111222a001011100100111111011111111122b011102a00211121021112211200
111110111001111101011110111111101000111a1110111011110110111110111101111111012102122222210222121120212a111111011111100011110011101111a002012a02012222112222200110
111110111111111010111111010101111010111a1101111101111011111101110111012122102222220220201221021222201a111110100111110111011111111112a121210b01210201222112222202
111111101111111111111111110111111111110a1100011111101110111100111111111201102121211222111202211221211a001101111111111100111101110120a122122a22222122222101221221
111111111111101011111111111101111011111a0101111111110110111101111111110120220212221202212110021021202a110111110111100101011111101010b222220a21120111220122022222
011110101110111010011101111110111110100a1111111011110111111111111101011111110100111111110101111110111a100101011111111111111011001111a111120b21221122111102111110
111000111110110111011111111101111011111a1111111011111111101111010110111111001011111111110110111111101a110111011110111011111101011111a111011a21210210102121112120
111011111101011111111110111110010111110a1110111111111011111101111111111111101111101111111100110110111a110101111110111111111110111010a101211b00210122202202211222
011111101101111111111101111111011111101a1011111111111111111111111111110001110001110111100111100111111a111110111011111111111111110111a111102b20111122111120120221
111111111101010111111111111111001101111a0111111011111111111111101110111101111101111111111111110111110a110111101111111111110011010111a111022b10021011012021212111
111110111111101110111111111111101101111a1110111111111111110011111111011011101101110101111111011011111a111111111110011101111111110011a101211b01010101011102021122
111111100101001111100101111111111110101a1111011111111101010101111111111111111010111101111110101111111a101111111111010111111111011011a111122a20122111122010100212
111110111111111110111100011111111111111a1111101111111111110101001111110111110110111011111111111111111a111111111111000111011111110011a101121b12112112112221111120
1111101111111101111aaaaaaaaaaaaaaaaaaaaa0011111000100101111010111111111110111111011111101111111111111a100101111110111110011111111011a101201a11112211212201222121
0010100000111111111a111111111111111111011101110011110111111001001110111111111111011111111010111111111a010100111111111111111101111111a110122b22012211011121212210
1111111111111111011a111111111010011111110111001110111111101011011110111101111111011101101111111111011a101111111111011010111111111111a010022b02222121111221211012
1011101111011111111a110101111110111111110111011010010111111111011111011101111111111101101110100111010a111111111111110011011111111111a111221b02121221201010220112
1011110111111111010a111111101101011011111111111111011111111111111110101011111111111110111110111011111a111100111111111111101110111010a110012b12021011111011112121
0011111110101111111a101101111111011111111111110111101110111011101111111111111111110110110101111101110a111011111111011110111111111111a111110a11212111221011222211
1111111011111111101a111001111111111110011111111101111111111111111011111101010111011111110001111011111a110110111111111011110101111001a101102b11221100102020001112
1111111101111111111a101111111111111111111111111111110001111110111101111111111011101010110011111111111a110101111111101111111011110000a111121b11222111001122222122
1111111111110011111a110000110111011111111111111011011111111011011111111111110111111111111111111110110a101111111000101111111111001110a111200a11212201211011121212
1111011011111101001a111100101101011011110111111111111011110101111010111111111000111101110100101011011a111111111111110111111101111101a111210a12102112220121121100
1111111110101011011a111110011111110011110101110100111000101111110110111101110011111011010101101111110a111011111101001111111110011100a111122a01111112010211202211
1011111000011111111a111111111111111111111111011101101111111111000111111111111111111011011111111111111a111011111111111111010111011011a111121a20112021111022212121
0110011011101110111a111011110101111111011110111111111111011111110110011100111110111101101101111111111a111111101110101111111101111111a011222a12202220002121212001
1110101111111111111a111101110101110000101101111111011111111001101111110111011111111111111011111111111a110111111111111111011101111111a011111b22212110121112100221
1011011101110100111a111101111111111110001111111011101011111111111111111101110110111110011010111111111a111111111101011111101111111111a011121b20010210112121211021
1101111111110111111a110111111011110110001111111101011111011111011010111111101010111011111111110011111a111111111110111110111111111111a011011b22220210222222202020
1111111011101111111a011010111011111111011110101110111111101001000101101011111011011111111011101111111a111111010011100111010012212210a001220b22122222111222221222
1111111111111111011a111110111111011111011111101111111101101110111111110111111110101110111111110111111a111110111111110111110122222221b111022b00221000210201120212
1111111111110111101a011110111111100011011111101111011111111110110111111111110011111111010111011111111a111111110010111111112021101022b201222a02020222022200212211
1110111011111011010a011111111110111111101101111111111011111010111111111111110101111111111101111110111a011111111001001111101011000220b011111b12102211220011011110
1101110111101101010a111110111111011111011110110111111101111111111111110111102220212211002222122222121a111111111110110110110112202020b202211a11021222121101010011
1111011001111110111a011111111110111111110111011111110110111111111111120200122102010210011221211021111a011011011111111111111112112200b210221a11111220222221111111
1111011110111011111a101111111010111110011111110111111010010111111111121122122122110111211112022122011a111111111110111011112112211120b122211a11021112122221111011
1111101100111111011a101101111110111111111111111011111100110101011111022112212202110122022112222020021b221112022211200011100110122120a012121a11212201020101110111
1011111110101110111a101101010101111000110111111101111110111111111100001111100112201120222212220221121b111212202201101111112102212101a111111a22112121022220111111
1011111111111111111a101101110111110110001111111101111111111100011011001112201211211022222200221022221a201222210022011111112110022110b221110b22102221102001111011
0111111100111011011a001011111011111111110111011111110111111000111111100211012021112221111222200220220b122221222222211111111111210120b121122a11111000012211101110
1110111011111111011a111011111110011111111110111110111111110101100111022120221112212222111200200000220b102011212120010100112020112211b202001b22011121111201011111
1111011110111111111a100111111110111101110111111110110111110010011111020112011220112100122222221222211b221000110110211111111210211011a111212a02102011202211010110
0101101101011111111a110110111110100111110111111011111111111111111111111211110222211011222022122222121b101211222211211111010122211011a202202a21211121201221001011
1111110011001111111a111111111101111111011101001111111111111110110111112120211221021222020221022122020a211202221112211111012122002101a121012a02211120210211111111
1111111111111111111a011111110110111111111111111110111011111101011111012122021211021102220120201121221b121222021221111111100102212112b001002a22122201001101111111
1011111111111110011a111110111100011010011111111101110111111101111110020111221122222121201022122002222a221012022002211101010000111211b021211a22021022011021111111
1010111111101101011a001111111100111110111111010101111111111101111011121121021122212212122120212222220a112122220221201011112101102121a111022a10122202102100111110
1111111110101101111a111111111111011001110011011111110011111111111001112021211111121222112221221022222b202200122222011100202201220001a111101b11112211021121111111
1110111101111101111a110111111101110011011001001101101011111111011111122222221120012122212222221121222b221222212221221211122220220221b211111a21101121112111100111
1011011111111111111a111111111111011011001001101101111111111011111111111020120122121211222121202122220b222221222212000222112002222221b110122b02222012111220110111
1111111001111111111a111111111001101111111101011100111111101101011111121211212111001102222222222121122b201222220221211112022220012222a122011b12220200221221100111
1011111100111111110a011011111111111111101111101111111111111111101110021111122101101212221121022221220b221122221121202002222011122012a112101a11111220112021111111
0111111101111101101a111111111101111101111110111110111111111111111101111211000111012000112122222102201a222121202200212222111212210220a111122a20212111202011110111
1101111111000011110aaaaaaaaaaaaaaaaaaaaaaaaaaaaaaaaaaaaaaaaa11111110101102202110012222022220021012222b020222220112001011220201212220b020121a11122212122020111011
10011111011111111110111011111111011111111111110111011111011a11111111121111211222121122222012222222221a211221222222121211010220221211b212021a11221120202201111011
10101011111011110011011010001111010111111111011011111111111a01110101102221221122201112012220122221020a022011120110221202022012222222a011221b21211112202221111111
11111111111111111111001100111111111111111101111111111001111a10111101122200100011020222222222222002201b221221221211011021222212200222b220212a00121210122220110111
11111111011101111111011111100111101111101111111111111111111a11120112222021022212222022222202222122121b102212222021211200121202212020a212011a20010200210021011111
01110111111011101111111110011111111111111111111111111111110a11112210202212221212022222210222221222222a012122120212210212020222202112a102122b01020212012101110111
11111001101111111111111111011111111101011110111101111110011a11122122222202222222212222222122201220221a122012220212221101212222122220a212122a01112122210111111101
11111111111101101111101011000111111011111101111111110111110a11111122112222222220222222222122222122102b010122122222120121201002220020a101011a11111111101110111101
10111111111110011111110111111111111111111101111111111101101a11111121122221122111210022021020222200102b221021022112021110221122222211a111111a11010100111010000111
01111011011111111111110111111110111111101101100110111111101a11022101102202202022021122212202222122222b122211202200102120210101212201a111011a10011000011110111111
11110110110111111111111110101100111111111101011011111111101a11121101122022220220022102212112222202212b222222212222222111101111021201a101111a11110011111111111011
11011111111101011011100111011101111011111000111111000111010a11122222212122021101200202222001021011121a210002002220111212120111021211a111111a11111111111111101010
11011111011101110111111111111111111110111111111111111011111a11112122210122202122211122222022202121120b022121212001122212122211211021a111111a11111010011010110110
10011101001111111011111111111111011110001100111110111011101a11010211102122212212021122202122222222012a212222021220222210221121101111a111111a11101111111111111100
01111011111111111110011111011101011011011111100111111111111a01121212111122000011222120222101011111102a101111111012201222200221221211a101111a11111101111100101111
11111111111111111111111110111111111111111101110111110011111a11110220121111212212112112111201211111112b111110211122111221222212112221a111101a11011101101111001110
11101011111010011011111001111111111111111111111111111111111a11122122110212222121211220202212121110111b211120121110112212102121112210a111111a11111111011100110100
11111101110111111111111110101100111101111111111110101110111a11111200021111022120112121110220121111111a020211012120122211002102200211a111110a11111111111111111101
11101110111011111011111111101010101111111111111011101111111a01011111111211100112210201202200110111112b201211022111100201221212202101a111111a11111101111110111111
11110101011111110011011011100111110101111111111111101111110a11121102101121101212021122002111221111110a012220101112012111121202212211a110110a11011011011010111011
11111111011111111110111101111111110111110111111111110111101a00121112222012210122111110020212010111111a221212022222112210222122110201a111011a10111101111011111111
11111111011111001110110111101101011111111111101011111101100a11001221010201110002121022112211221110112b212222122101021212110220002021a111110a01111110111011010101
11111111101111110111100111111111111011111111111111111101101a11120221102212211210010110122121111111112b012211110202211101121221222211a100111a01111111111111110111
10111011110011011011001010111011111011110010111111011111111a01112021111120202222212212110221120101012b221011222111102212112110211211a101011a01110111101111000110
11001110111111111111011111110111111100101101111111110100111a11122121202212202222222200021102200110011a001000102021222112101221201201a011100a11011101111011111111
11111111111110111011111111111111111101011111110011101111001a11021100112022211221211001111111201110111a111111111111111101111011111111a011111a11101111111011101111
11011111111111111011110011110111011111101111111011111111011a11121111012220221121011110012121101111111a100101101111100111011000011101a111111a01111111011111111111
11111111111111011011111110011111111011111111111011111111011a11112211022121111122110222221202111111111a000111101111111000011111111111a011111a00101001011011111111
11111111001111111101111110111111111111101111111010111111111a00111112111022122222112211201000221110111a111010110111111111111111111111a011111a11011111101111110111
11110111111111111011111110111011111111011111101111111110111a11121111121220201210120121201122100110101a101010101010011011111010001111a101111a01111111111101011010
01111101001111110101111010111110101001111100111111011110111a11112111101220102101012012021201101011111a111001100111111111111110111111a111011a11111111111110111110
11111010110101111101101110111111011111111111111101111111101a11121201101012012211112200022211120111111a111100110111110111111101011110a111111a11101110000101011110
10111111111111101011011111111111111010111111111101100111101a10122002121101122212210001210210211011001a111111111111010011111111011111a111101a11011111111001101011
11101111011011111111111011111111101110111111111011111110001a11122121122100102221221210211222220010111a110111111110111111101011111100a100111a11010111111111001111
11111111111011111110101111110111111101011100001011111111100a11111110112102022212111212012221111111110a111111111111011011101111111111a111111a01101111010111111011
11110111010011111010111111111001011101101111111101111101111a01011111111101110101110111000110111011111a110111111111111010101111111111a011111a11011111111110111111
11111101011100111101111110111111101010001100101010011111110a11111011001111110111111111101111101101111a111111111011111110110111101111a111110a01010111111111111111
11011011110011111011111111111111011110110111111111111100111a10111111110111111111110111111010101110111a111101111111011111111111111111a111111a11111010111111111111
11111111111011110001111110111111111011111101011111111110110a11111111001111101101111011111100101111011a100011110111111111111111111111a110111a11111111110111011111
11111111000111111111111101011011011111111111101111110111111a10111111011111111111111111101011101110101a111011101111111111110111011111a101001a10100111111110110111
10110111101110110111001111101101100111110110011111111100101a11101111110111110111111001111110001111111a110100011111111111111101110111a111101a01100111111011111101
