4 11
31 110
122 49
126 101
64 67
119 18
56 105
111 104
8 43
26 34

11111011101101111101010111101111111111111111111110110101110101110111101111111111a111011001011111111a111011101111111011011101111111111111101110111111111110001100
11111111111111100111111011111111111110110111011111111001111111111100111110111111a110111001111111011a101111111111110111001011111101101111111011111110111111111111
11011001011111111101111111111001001111111111011101011001111110111111111111111011a111101100011111111a111011111111111111010111011111100111010111111111011001111111
11011101110110111111111111111111101110111010111101101111101011111111111111111101a111111101111011111a111112111201112121102221112211221201111110111101100001111011
00101101111111111101011111110111011111111101110011110111111111111111111110111010a111000110101111111a111112121202020112221122022112121121110111110111110101111110
01101001100011111100111111110111100111111111111111111111011110111101111110111111a101111111110111001a011111002111202110102201212220112111111111011111111110011111
11001011100110111101111101101111111110011111111111101111111111111001001101110011a101111111011100101a000121122112010212111121122012222201111111110111111011101111
11111011111111101011110111101111100110110011111000011101011011111001101110111111a010011110111111111a111021211200122021211111212122011211011110100111110001101110
11101111111111111101111111011111100111111001011110110110110101111101101111111111a111110011111100101a110100210121101211101211210112211121010111111100110110101001
11001111011011111111110100111111111111111111111111101011111111011111101111111111a011101111011011111a100121121221122221201100222101212211101111111101111111111111
11111111111111011011111011110110101111011001111111010011110111011111111111010111a111101101111111111a110111210011112221110122021122212021110101111110111110101111
1111P111000100101111111111111111110101111111101110111111110111111110111011110111a111110111111111101a110122222222121102112112012111122101011111101111101111110001
1110P110111101101101101111101111011110111111001111111111111011111111111111111111a100011110001111111a101001202011112120022011111221021011101101011110010101001110
1111P111101111111111111001111011011111111111111101101011110011110111111111111111a111111111110111110a011122111120122121020110100101121111101111111111111111111111
10101P10100101111011111111111111111111110111110011111101101111111111111011101111a111111000011111101a111111201222001212222221121022220021101110110111111111101111
110111P1011111111111111111111110110111111001110011111111111110111111111101100111a110101111011111111a111100011121222012212121220120222211101110111110111101110011
1111110P111111111101110001111101111110111010011010001111111101111101111111101110a111111111101111111a111001112202101121202212011011211021111111111101101111001111
1111111P011111101110111001111101111110111111110111110010110111110111110111111111a110011111111101111a111021111001221211102022101111101211010aaaaaaaaaaaaaaaaaaaaa
1011111P011110111110111101111111010111011111010111110111101011111111111111111001a001001010010111111a111121121222102220112202112211122110001a01111101110101110101
1111110P101022121201010010011221120221212211110111100011110101111110110111111111a011111111111001111a111102011002011222112110121212112111111a11101111110101010111
1000111P111110022210220201002112202121222201110111111111111101111101111111111011a111111110100111110a111020012212021112201222220101011011100a11111110010101111001
1011111P011122202221120120102102111102120111110111111010111111011111110111111111a111111111011110001a011122000001112221201020122201021111110a11111111101111111111
1111111P111011212222122211212122222212212211111010010011111111101111011111111101a111101110100111110a111122021112221222021121212200121021111a11101111011011111011
1100111P011112222201101212012112020102211011111110011011101010001011010111111111a001111010111111100a111101101120012212211110011221112001111a10111111011010001110
1001011P111021211111000111111222222221110211111111110011111111111111101101111111a111111111011111111a111122220112111212021210202222220111111a11110111110110110111
1111011P111110212202222221211121220011120111111111111110101001111111110101111101a110001001111111101a110112112200211012111122200012222021111a10100111111010010111
1110111P101200021012022121110000222202112211111110101111100101100001111001111011a111111111111101011a111120221210022201212222211221212211111a11110111111100111111
10111011P01012122022221221221222112112102101011111101111011111111111111011111101a111110101111011111a111112221101022010112012120010111201110a11111111111011111110
111121212P2210012000122222022021120021111011011110111111111111010111101111111111a011111111101110011a111010222112212220202000121011202211110a01000111111111001111
112210202P2220101222110202102121221222221111110111111111100111011111111111100101a111111011111111111a100112212211011112121211101021112220111a11111011110111111001
22012212P02222100122011211122220110101210210111111110111100101101110010100111001a111111011101101111a111101120112112121120102122212112110111a01111010011011110111
02011222P10212112202002001221022111001011011011110101110111111101111011111111101a011111110110101011a111112012010222212212122221101212110111a11011111110111111110
121222011P2021220222112122222202210211000011111001110001110001101111111011111101a111111111011111111a110112011110202001121121121021000221111a11101111111111111111
0102111222P222122222212202122221022010112101111111111110101011100111111111111111a011111111111000100a111120022002212210021201011201011021111a11111111111111111111
baababbbabPPPPPPPPPPPPPPPPPPPPPPPPPPPPPbaaaaaaaaaaaaaaaaaaaaaaaaaaaaaaaaaaaaaaaaa111111101111010111a110011000222012220211200122221222201211a11011101111011111111
12112121220012222022021122122120111200P122110110111111111110101110011011111111111100111111111111111a101111112102120221111121012111212121011a11111111100111111011
01112222022222112010021211221211011112P020001100000010111111011011111111111111111111011111111111111a000110111210101212212111210211212021120a11100111111111111101
21211211001002022002020022022220212022P222011111010011001111110011111100111111111011111101111111111a110111122111211111212112122212022120221a11111111101101111111
22220020110222112222222221222220021212P220011101111101011101111111011111111011111111111111111011111a111101112221002221110210220012210101221a11111111111111111100
221222111220022212002122222222200201122P21011111001110101101111110101111111111011011111111111011110a110110122121100111101212121211222020120a10110111111110100011
012002010222220212202221222022212212201P20110110111001011111101111111111111101111111110000111101101aaaaaaaababbbaaabbbaa2121202112212111211a11111101111111111011
121221122122202120120201212222210121110P1111111111111111101110111101111111110100011111111111111111111011111200221001112b1121121221201112111a10111111111111111110
201112100121221001012102222222221212111P1211111111111111111111111111111111010111111111111111111011011111011122202101202a1100211110112210111a11111111111111011110
212201122011002120021202201211112212220P2001111100111110111111101101110111101011111001111111011011111111110102222221121b1112220111222212111a11111110101111111111
211111012022010122122222022202101010121P1111010101111111111111011111111111111010111111101011101110011111111121022001022a2020111202121222211a11111101011111111101
212212222121120122221222122022212020001P1011011011111111110101111111111011111111111110111111111100111110111021102212122a2121212121010212021a11111111111110110111
12221101222122022002112102222222221210P02211111111111110111011110111011111111111111110111110011001111110111010210121110b1211222112121202011a10110111101010101110
22212121210222220010121121122220112222P11111101111111111111101101101111111111111110111111011111111100101100012021121101a1112112221021102111a01001110011110111110
0210112202210020222102202202222020122P021011111111101111100111111111111001111111111100111111111111111111101221122201210b1212120221011210111a10100101110011111111
1011202022202210221222220102222220120P212211111111111111010101011111111010110110111011110011111011010111111222222121021a1221202210221112110a10101111111111110110
1122210021011121222220222110122111111P011110011111110010111100111111011111110111111111001010111110110111111112112201112a2111121021121211121a10111111110110111110
1002101212220210201112122022022100011P111111111100011101010011111101111111101111111011111111011111011111000122012100201a1122201201111110011a10111111101010111111
ababaaaabaaababbbbbaabaaaaabbbbaaaaaaaPPa110111112222200121120120102112121022120111111011111101111111111101202120101210a2011110012012210101a11101111111111011001
2222102011212212221112122111121011111001P111111110211111021122120222222121110020111111111101111111111111111021122212121b1011011112121211221a01110111111110101110
2220102111020112011211112201212110111111P010111012022112111222202211212211112211011000111111100011111111111221112212111b2111211100111112111a11100111111110111110
2121112120112021212201102212111001111111P111111110211020102121212112112112212222111111101100111011011101111222012111211a0001000011212111121a01110111111101101101
2110212201120021200222220222201111110111P111101111111221002101221212211111221221111111110111011011111111111121201212121b2201112112111002111a11000111111000110111
0022111110222021011212112211122111101010P001111111222221121212202121100122112000100011101111111111111110111221211112221a0022010121112202101a11111111111101111101
2021110210122211211212121022100101111111P111111012201122221220201021220122122012100111001111111111010110011021121002122a0221120121111121210a11111110111010111010
0111111111101011111011111111111001111111P110111112211102222222112101121120201101111111111110101111111111111121111220120b0111211221222121211a11011101110100111111
1011101111111111111111011111101111111101P11101011021220121111220221111012122001baaaaaaaaaaaaaaaaaaaaaaaaaaabaababaaaabab2200022211000222201a11110111101011111111
1001111111111111111110110101111011011111P01110111220221202110212121022022122222b11101111111110110110111110020012020112112121201010120121201a10110111101111111111
1111111111111011101010011011001011011110P01110110012211210011210110220202211021b11001111111011111101011110120110220221201122022022011212011a10101111110111101111
1110111110111111101111101111111111111010P11111111221001111121121000101212221012a11111111111111111100111111121012020222122210222220222222210a11110001101110111111
1101111101111111111110011111011111111111P11111001211122221121021112101212111110b10111111111111001011111000102222211222110221120201021212221a11110111111100111111
1111011111111111111111011011111111110111P01111010211001222012110201222002102211b11111111101110011011111101111011110001111111101110111001101a11111111111111111111
1111110100111011111111111101101111111100P11010110112110222222212121212211211022a11110111011101111111100111111111011111111111010110111001111a11110111110111011011
1100000111111111111011100101001110101111P11100110120220212221111211012112101111a11101111111011111101111001111001111010111101111011111110110a10110111110111111111
1111111111111111110111111111111011010010P11110111212222120121220221110000011110b11101111101111101101101110111111011111111111111011100101111a01101011110111111101
1111111111111111111110111101111100111111P11111111002121012201110202211101211121b11111111010111111111111111110111101111111111101101011001111a01000111101110110110
0111111111111110111110111101011111101110P11111101110200212221120211010211212212a11111111111111111101111111111011111111101011110111110111101a01110111011111101001
1101100111111111111111111111111011111111P10101111111011112212211210102220010210a11101101111011111011101011111101111011110111111111111110110a01011011111111111111
1101111111011111101011111110111111011111P01111011121121112220212111212102122001b01111011101111101111101101111110110111101111111111111110001a11101011111011111100
1111111110111101011011101111111111001111P11111111221010201220002112212011112011b11011011011111111101111111111111011111111011100111111111111a11111111110111111011
0111011111111111111111011111111111111111P11111111120211002021222112221220122121a11111111111111011101011111101010111100111111111010111101111a11011111101111111111
1111111100111101111111111111101111111101P11110011202222110212000122222102212011b01111111101111111111111111111111111110111011111111111111011a10111111111111101111
1101011111100111111110011011101111111111P11111110112212102200111012111120022212a11011101110111111111111111101110111011111111101110111111111a01111011011011101111
1111110111101101111101111110100101111011P11101110210012112010111201100221111211b01111101011010101111111111111110110101011101111111111100111a11110100111101101101
1110111110111011111100111111111111110111P11101011211100211212221021211211202211a10101110011011111111111110101011111111110111101110101111001a11101111111011011111
1101110100111111001110111010110111101111P00110110021122111201122222122001010022b10111001011110011001111111111111111111111111011111111011101a01110111111111111111
1111101111110110111111110111111110001111P11111011021122220202012012012012122110aaaaaaaaaaaaaaaaaaaaa101111111011111100011111111110111111111a01110111111111111110
1110111110001110110101110111111110001111P1110001122211112110120001021122022111221111111011111111101a111111100110111111110111111111111110110a11101011101110111111
0011111111111011110101111101111111111111P1111111102112022221120111101122112122011111011111111111111a110101111001111111011011101111110011111a10111101111111011111
1111111110111101011011111101111110111010P0111111101111011110011111011111101110111011111011111110110a110111101110101011010111011111111110011a11111111111110110111
1111100111110101101011111111111111101111P1110111111111101001111111111111111110101001111111111110010a111111010111011111111111111101011110111a01101111111101111111
0110111111111110010101110011111100110110P1111101111111011111111100111111111111110101010101101011111a111101101111111011111010111101011011111a01111101111110011101
1101111110011111011101011111111111111111P1111001111011111111000111110111111011111111111001111110110a110111001111212022202120220221211112201b11101111111111101101
1111111101111111011111111111101111110111P0011000110110110111111111011111100001111010111111111100111a101101111102122022121102222211111012120a20011101111101011111
0101110111110011011111100011111111111011P1101111100010111110111110011111111011111100111111011011111a001111101112001212212121011212221211221a21111111111111011111
1111111111110011011111111101111111011111P1101111111111010001111101111011110111101101110011011110120a212010122102022012122112202022200112201a10111111101111111110
1111111111110111110111111101011101111010P1211111201021112221212001012202111011110111110111011110221b001200212202202222202222202122221222211a11111111111110111111
1011111011111100100111111011110010111111P2112111211211012211122001010110111011110111101101111101012a121220112002122222221222222200121222121a21111101010101110111
1111111111011111110111011101111011111101P1122222222222220121120201111212100011111111011111110001121a112111201012221110222222212212212211120b11110010001111111111
1101110111111101110111101111101011100101P1202001211110211102201122102212101111110111010111001110122b112222221122222122210222102201221101012b11101101111101111111
1111111110111011101111101111101011011111P1221112221100201201121111220110101101111111011111011110120b210010102221200022222010222010210021112b02001111111111010111
1110111011111001101111111110111011011100P2211222022201201021222012222101001111110111111110111111122b101002222022212222012221211011211220112b21011111101101111011
1111011101111111111111011111111111111101P1222202111022120121220122121221111111011101111111111111101b220112122012221222022122222012221202101a22111111011011111111
1111110111111111111111111101011111111111P1210120121100122021122101102121111111011011101011100001112b221110122111002112222221212122211102120babaaaaaaaaaaaaaaaaaa
1111100011111111111011011011111110111111P0002201101102012001122111102100111100111111111111111111210a221211112112220111020222020112112121021011101101110111111111
1010101111111011111101111110101111011101P0201101220022011021222201120220001011111111110001110101101a120112110202100121021122022111212110201102110101101100111111
1111111111110110111001111111011111111111P1021111012222122122221020220210100111101101111111111111110bbbababbababababbbbbbabbaaababbaabbbbaabbbbaaaaaaaaaaaaaaaaaa
1101101111111111111111111111101010111111P11221122122011121022011221111211111100111111111111011000220112212211022020212222202221022121120220201111011111101111111
1010111111111011111111011101101111111011P11222112211112221022002111212220011110101001010011101101110222002200120102202020121022111222201012212111001111111000111
1110101111111010111111110111110111111111P12211210111101201122111222222121111011111111111110111101220122220112222222122211122222210122121221110111111100011111001
0101111111111111101101111111100101111100P11111101211021100201222010212201001111111110101111111012211210122112121221222121212122010210102020202111101101011110011
1011101101011101111011111110111011111101P21210222112110120102221211111111111111111101101110101112022021002110200222222220002202121212110121221111001111001111100
1111111110101101001001111111111111111001P22211111210111221111211120000001111111010011111111110111102112102111222222220201202122210221222221201111011101110101111
1111001111001111111111110111111111111111P22111101101111221120012212100121111101110111111110111112210102211122112001221202000222200120122212110111111110111101111
1111111101111011111011101111111111001111P21111212212111112101222202021121111111111011111110111112212111102102201222020201011201020222102101221110110111111110111
111111111011111110111111110010110PPPPPPPa21112211110002221110110220102211111111111110111111111101221121121011201012222211222220021122021222100110111001101111010
1111011010110011111011011011111PP1111010a00111112102122212121210202120220111111111011111111101112121212011122200120221202221121111012211122202111111101111111110
1111111001111011101111111111111101111110a22201111112121111022220022210211100111111101111110011111212122212011121221222102222122010011112101022111111100111011111
0111011111011100111101011011111111111111a02120111101210122102221010010121111111110101001111101100102211212120122222222220101222112112212220221110111111101111111
1111011111110111110111110111111111111011a20120111111211222100121221122211111111011001101101011110100121211201022221220211220221221222022022201101111111110101111
1111011110111111111011111111101111110111a22102101112211202202000022122011110111110111111111101112122011111200222202122102110222222210022121121011111011111101111
1110100011111111111011111101101111111011a12121021122211122221222221200221010111111011111011111111210002221012020222110022222012221110220120022111110111111111011
1110111001101111111110111101010111111111a01112221212212221122211010102221110111111001111111110012122220112222112012211012122212110111121212120111110111111101110
1111111111111111111011110111110111111111a00202021002211112001221121211001111111111100101111111112212121110111122111122202220122111111111111010110011011111011111
1111101111110111011111101110101111111110a21202210101212220212002222222201011111111111111111111100210221112221121120020200111120011111111111011011001111110011011
1111110111101011111101101111110011101101a21021212221110221101220201012211111101011110111111001112221112121221202010121212122022111111010111111111111111100111111
