4 11
31 110
122 49
126 101
64 67
119 18
56 105
111 104
8 43
26 34

101111111011101011110111111111101110111111111111101111111011111111111111100111100111101111111111100011001011111011111111a111111101101011111111a01110011111111111
110111110100111111010011010110110111011111001110111101111111001111110111111111111111110110111011111111110100111011111111a011111111111110011101a11111111110111101
111011111111111001111111111111011100101111110110001111101011011111100111111011111101001101111101111111101111111111111111a011111111010101011111a11011111111011110
110100100101111110001110010101111101111101001111111111101111111011111110111110110101101011011101011110110110122201012011b220212212120121100101a11111101110111111
aaaaaaaaaaaaaaaaaaaaaaaaaaaaaaaaaaaaaaaaaaaaaaaaaaaaaaaaaaaaaaaaaaaaaaaaaaaaaaaaaaaaaaaaaaaaaaaaaaaaaaaabbbbababbabbbaaaa100112212212121011101a01100001111111111
1111111011111101011111111111111111110110111011101111111101111111111110111111101011011110110111111001111121212110110111201121021211122111111111a10111100100111101
1010111110010110011011111001101111111011011111111011111101001110111101111101111111111111011111011111111110122122112210121011210112211111111110a01111111101110011
0101111111001101111111111111101101111111101111111111110111010111101111111011111110111111101111111011111122210011211122112001210120122211111111a10111111111000001
1111110101111111111111101011101011011011111110011011110101111101101111111111011110011111111101111111111111121101101111200212111220102110111101a11111111111011111
1110111111111111011111111111111011111111110111011011101111111111111011111111101111101111110110111011001112222201220122220111122210122020111110a11101110111101111
1011011110111110011111011011111111110110111111111110110111001111111111111011110011111111111111111111011120012021212122111222221111211111111101a11111111110111111
1111111111010111101111111011110111110111111111111111111110010111111011111111010110111111111011011111111100201001020102211111102221021201101111a11111101111111110
1110111111111111111101011010111111011111111110011111101110101000111111111111011110110111111101101101110100220212220121112221120212121211011111a11111111111110111
0101101011010111111111111110011111111111111111101111111111111110111110111111001111101111111000111010110120210212222112121211222202201121101111a11111111011111111
1101111011101110111111110011011111111111101111111110101111101111111111111110111111011111111110101110010121110222122221211110221111122211111111a11101111011111110
1011111111111111101101111111111101110111111000001111111111111111111111110101111111100111111011111111111021022101222221211021202120221001111111a11101111001111111
0110110111111111111111101111111011111111111111111011101111100111111111111111111111001011011110110111110012120122211200221001211111211211111110a01111101111111111
1011011101111111010100011111110111111111011101111111101110110101011110111111111110111111110011011111110011122211222222111212211212211021111111a01011111111101111
0110101111111011101110111111111111111111111111111011111111111011111111111101111111111111110011011111010111021022102120012221022211222211111111a11101011011101011
1111111110121021002220221100211211212101111110111111011111111101011111010011111111111111011011111111111112211021212221010121222101212011110111a10111111000111111
1111111101101121212121111211212211122120100111001111111111111111001011111011001111110111101111111111110111022121122112201011011101122121111110a11110111011010110
aaaaaaaaaaaabbaaabbaaaabaababaaabbbaaabba11111111101101111111101101111110101111000111010111111011111111112111011021110110122110122220101110110a01110001111111111
1111111000112221121212211001202010222201a11111111111111111111111111111111001011110101011101111101111111101022211221111122012220202022110011111a11111111101111011
1011111111111110100212020001010102012220b11101111111110011011110100111111111111101100111010111111111110120111222212022222121101211021111111111a11111011111111000
1111110101111212201111100121001200002221b21110111101110011011101110101110111011100111110111001111111010112012212120211211202022122100221111001a11111101110111111
1111111110021201211201112012002111120120a01011101111110001111111111011001111111101111111101101001011010111212111022211120122212022112200111110a01011111111111111
1111111010111121221122222122112221120112a01110111101101011111111101111110111100111111111111010001111101111211122111121202221102121201111001111a11111111101000101
1111110111020102221022121120111101221202a10111111111111111111011110101010011111111011101111010111111011112222211100110212201010210102211111011a11111111111111011
2110010202122212222212112202202022211112a21111011011111011110111010111111111100111111111111111011111111112121121111100021212120121221101111010a11101011111111111
0112221121220010210222202120220122111211a01111101111101111111011111111100111101111110111111011111101111011200221022122210201201202122221111111a11101111110111110
2222112110100210212112222221200222222121b11111111011110111111111010001111111011111111101111111011011111101122101222220001121201202122021101011a11111101001111011
2202221111102212202021222220022201211111b11111011101111011111111011111111111111110101111111111111100111100221111102022111122222122010211111011a11110111101111110
2001211222102222222220002122220221022102b11110111011000111111111011111101111011111011111110100011011111112212221221020212102212202202211111111a11011101011101101
2101112121122021212102002222120022022102a10101011110111111101101111011111111101110110110111100010011101021121220212221201211212212111101101111a01111111111111111
0221101110121221220222222112012121212020b11011011111110110101111111111111111111111111111111111011111011111121021122000122202021010212121211111a11001111111111111
2111220122122202112222221202221000111202b11101010000101101101111101111111111010110101011111011101111111110112220211211222112121020102222220111a11111101111111011
2121211220222222020221220201221012121101b11110111111111011101111101111111110110111111111111111111101111110100221201202112211101022111202121110a11111110110110111
0020102121020001211202202222222022112112a11001111101011000111001001001111111111111101001111111111110111110121101021102112110212011210020211101a10110111111111111
1211012211110202220212201222220111022111b01111111111110111111111101011111101111111101111111110111111111111112011211221101220122121222022211111a01100011100011101
1101122101110121221220012222222001102122b11110100111101110111110111111111111111111110111100111111111111011112011112122122021221102102112221111a11111100011100101
1010221211122022120202022022220222011202b21011111101111110101111100110111111011111111101001111111011111011100220211120111222202210222210021111a11010111111111011
1122211211222111220002211111220122212221b1110111110111110111aaaaaaaaaaaaaaaaaaaaaaaaaaaaaaaaaaaaaaaaa01011121011210222111121110122122222221111a11111010011011110
0222202112022221202201212020222101211211b2111111111011110111a111111111110111101111101111010111111101a01111112010220210102220011121102210001111a11111111111111111
2112221111200222221222200020212001101222a2111111010111011111a111010111111111111111111111011111111111a01111121110212112120101120112111102211011a11011111111011111
1212220122202202102222220020210121121121a2101101111111111110a111111100110011001101101111111111111111a11111110002122012211220112022212102111011a11110111110110101
1002012011210222022220220122221200002212a1011111101111111111a101101101111111111111111011001101110110a11110102212001212012212111222121222121111a11111111111000011
1111201122222220122210210021212210122002a1011111111011111110a111110111111111110101110111111011011110a01101120022210101222121121211222201120111a00110111111111110
0010222121121020222010122202111112212022a1011111111111101101a010101111111111101011111011111111011111a01111112112210111121202202221221102211011a11111101011111111
1212221211222222222122022121022021211220b2011110011101110011a110111100011011111110111100110110011101a11111121121212212222220112022102212221111a10101110111111001
2112220002112112202202202222220212020111b2111111001011011101a010111101101111010111110111111101111111a11111111112111001111021122102201111211001a11111111111111011
1112212221211211220020120111102111111111a1011111111111101110a111111111011111101101111111111110111011a11101021202111121221221111022210110211110a11111111011101111
1200211222111010111111022002210111111111a1010111111110100011a101111111001010111111111111011111101111a01101000222012021122122200220011121111111a11111111111111111
2202201211011111021202212101221111100110a0011111121121210221a122101120122211010100011111111101101100a11111121212001122201212012022111011210111a11111011111111001
0202212011022212102121211220201111011101a0111011102212110012a012221112121121112210110001101111011111a11111110111222122211102211212201222121110a11110100111011011
1022001121011210112222212212021101111111a1011011122210122000b012020011101221222211111111011110111111a11101121200010110121002121012111121200110a01100111010101101
1212111212102222112212222202110111101110a0111111021222110111b212021211222211001011110001110111101111a11111112001121102222212212021221001211111a11101101111011111
1211222212211201111110122111120110111001a0011101112220010200a001121021022122120201110111111010111011a11110011121211111122121211121221202111111a01100111101111110
0112101000000022221102002222122101111111a1101111120222222112b110101221210120121111111011111011111100a01110122010120222211121120012212121021110a11101111111110110
2001222012222222201201222102011111011110a1111111122122100200a000122022221112212211111111111111101000a00111102122101112222112210220220221021111a11111101110100110
0111110111111101100111001001101111111101a0111111101202020122a012120221121021112210111111100110111101a1011100102202221222aabbabaaababbbbbabaaa1a11110101110111011
0111111111011011111111111001110110101111a1010001111110101121a202222112112220221011101101011111111111a1111111002101212002b0022122002212011111a0a10111111111110110
1111111101101110011101101111111111101111aaaaaaaaaabaaaaaabbba111122011111101102101111111001111111110a1111112212122212012a2120120102022101111a0a10111111111111111
1111111101111101110111111110111110100110111100110121212122221111021122021001121111111100101101111111a0111102201122221202b2100202221112121211a1a11111101111101011
1111110110000111111101110111111101100110111111111011011112112011011212121212021110110111111011101111a1110112012211111110b1111212222212111200a0a10110111011111111
1111101111110111111101110011111111111001100111011121222202021222222211011011102100110110010110011100a1111100002022110012a2222110101121120111a1a11111011111010111
1111101111111111111111111011011101101111111110111121001022212112210121102211112111101010101101111111a1110101111111111111a0111111010101011110a1a10110011001110101
1111001110111111111110110111001110111111110111111212122221112201122111021220112211111111111111001111a1111111111101111111a1011110111101101101a1a01110110111011001
1111110111111110111111001101111111011111001111011112112212111121221110212220221211111111011111110101a1101111101111011111a1101111111101111111a1a01110100111111111
1111111111101111010101010111111100111110111110111122111022220212222221011122221011111111011110111111a1111110100111111101a1111101111111111011a1a11111111111111100
1110111111111011110111111111011110011111011111011220221212222101222112211021221011011111111111111000a1101011101011111111a0110101001011111100a1a11111110111001111
1100110111001111111011111111111111111111111101101112110121222122210120111111220210111111110011111111a1111111111011111101a1111111111011110101a1a01011111100111111
1110110111110011010111111111111111111011111011111112201021212111022222111221200210110011100111111110a1111110111111111101a1111111101111111111a1a11111101111111111
1111101111101111011111111111111111101110111111111200112021212101201211212201121011111111011111111010a1111111111111111101a0111101101111110011a1a11111111111011111
0111111111111001010101010100110101111111111111100110112212220111111121200211220211111001111100111111a1111101111111110111a1111101111111111111a1a10000011110011101
0111110111111111110111111111001111111111011011111012221122112220010122212110222201101011111111111110a1111011101101111111a1101001111111111111a1a10101111101111111
1111101111111101101111100111111110011101110111110212222122221202020101121212201211101111111011111111a1110111111111110111a0111011101101111111a1a01111111111011011
1111111101110111011011110110111101111011011111111122221210110112100022102121111211111110111111111110a1110001101111111011a0111111011110111101a1a11111111111111110
0011111011011111111111111011111110101111101111110012021202122122012001022122112211111111111111110111a1111111111111011111a1011010010011110011a1a00111111101111111
0111110101011111111111111111101001001111111111100121110212021201211011112122211111101111111110110011a1111011111111011011a0000110111111111110a1a11111111110011011
1111010101011111111111101110101111001110111111011211212201221112202201110121220111011110100011111011a1110101101111111111a1111001111111010111a1a10111111111011110
1110111111010101100101111001011111111111111111111222212222101222111011202120122201101111110111111111a1101111111111011111a0011111111110011111a1a11111111010111101
1110110111111010111101101111111011111101aaaaaaaaaaabaabbbabbaaabaabbabaaabbbaaaaaaaaaaaaaaaaaaaaaaaaa1111111111011111110a1110111111111111110a0a11110111001111111
1010101111101110111110011101011111011101a0111011112222110222012012120012021022111111111001111111111111111111111101110111a0111111111111110101a1a11010110010011111
1100111111001011111101111111111101011111a1110111110111111111111111111100110011111111111111111111110111111110111111111111a0000101110101111111a1a11111011110010110
1101111111111001111101100001111111111111a1111111111101111010111111111110111011101111111111111000001111110011111011101111a0001011111111111110a1a11110010111011110
1100111011101011111110111111101101111101a1111011101101011111111011110011111101011101111100111111111111110111011111111011a1011111000111101110a1a11011001111110110
1111111111011111100010101111111001011011a1111111010011110111111010011111011111011111111010111101111110111111111002110112b2020010210110102212b0a11111101110111111
1111111111111100111111011111101110111111a1111000111111111111111010101111011111101101111101101111111111111010111101221221a2212022122201120201b2a11111100111100101
1110111011111011111111111011111111111110a1100101111011111011111111111111111011110011101100101011111111111111111210112121b0120222221122220111a1a11111110111101111
1110111101110111110111110011110111111010a1111001111111111111111110011111111101111010111110011110111220112101121221222021b2122221110212102201a1a01111110101101101
1111111111111110111101101111111011111111a2011002212112221220222121111112111110101110100111111111100100211211121220202021a2221002221110201121a1a01111110100111101
1111111111101111011111011101110011110110a2112221220211012002112212221110111111110110111111110010011221210220021222220210b2102202200011222120b2a11101001111111101
1111111111101101011011111111111011111011a0201112120121112110222201021221111111110101111111111111202222211212222222200212b2222221212101121112b2a11111111111111110
1110110110111111111011111111011111001101a0021121100012122022202101122112101111110111111111011111212120101122122211212120b2122221111221222121a1a01111011101111111
0010001111111101111111111011111101001111a2112212102211120122120112110201101010111110111011111110121222112211111022202222a1112210122020211112b2a11011111011100010
1110101101111111010111111110011111011111a2122211111121212011012020110112101101100111110111111111202212001101011112220022b2212111201001021000a0a11111111011111101
1110011111111011011111111111111001111111a1101110212112110201112221110022010111101111111111011011222022110201110220022121a2220002011110121112a0a01110110110101111
1011101111111110001111010111110110101111a0022112122210102201211212200012110110111011011111010101102110220221022220211212b2200220212121022012a2a11111011101111011
1111111111111101111111111101111101110110a2121112111211221110101122211021111111111111111111111001021111221110221121022212b2202021210220012220b2a10111100110111101
0111111111011011111101111011110111111111a2021200212111221012210211102002011110011101010111110001020222211122120212222222b2222222212112011121b1a11110111110101111
1111101011111111111111001011111110110101a2221220110221111111220202120021110111011011101111010111222100122210212120022222a2222212202221102110b0a01101101100101101
0110101101010111111011111101111011110111a2210012100121120111212212221211110111111111111111011110200120202011212211221102b2222201121122111121a1a11111111111111111
1110111111111011100101011111010111011111a2201110212121121222220022222211111111111111111111111101102121001201220022222112b0220212222021210211b1a11111111101111111
1110111111111111110111111110111110101110a2210020220201111211211110112112110111001111111011111111201222202211120220222021b2212021102110202212a1a10011001111111111
1010101100111001111110111110101110111011a1210120211211220102022212200122111011110111111110111011120221110102121221110212b2111102022211001101a1a11111111111111110
0111101100101110111111111111111011101101a1102221222112111021221101112101111101111111100111101110212210201122101221210212b2022020212101221212b2a11111111011111111
1001111111111111111110111101011101011111a2221021102212201122101121121121111011001101101111111111221021202211112222002210b1222111200211110112a1a11110111111111101
0011100100011111111110110111011111110010a0001201101120102221011211012212111111111110011001111111012211202012110200122202b2121202000121010212b2a11011111101111111
1111111110111111111011111111111100111111a1221222202220221201212212221112111111111111111110111111212121222212011022222222a2122222012120210011a1a10001111001111111
1111111110111111011111110111111111111111a2111222122012221001111212112222111011111001111111101101221101121120100212211122b2100120102121112120b1a11101111101010100
1111101001111101111010111111101011011111a1112210221221010212010211212121111111111101110100111110210001202102011102222222b0122210221112102121b0a11111111011001110
1010111011111110110001011111110011100101a1112202112221111212201122221012101111011111110111110111001211122212020202201020b2112020222011221111b1a10100101101111111
1011011110111001110110111110101011101011a2222210120111122110212100122110011111111010111110011100021222120101111002102212b2220112111121202121b2a11100111011111111
0111011101111011011110111100111011100111a1021011122012220221110220001212011111011111101110101101221212101012212202022220b2122100111221122211b2a11001111101110011
1111111111111111111000011111110111101111a2211212211110012122021222122201111111111111111110011011111101022210011022201201b2212210222022121010a2a11111111110111111
1011100111011010111101111111011010111111a0121222012111100210121122211122111111111111111111111101112110101112221000221222b2122121122121221201b1a10011101011110101
1111111111011011011111011111111111001111a2122002101102202122102102212011101101111011111111101111121211022211112202022011b2202222111021202100b2a01111111111100111
1101110111111110011101101111100111111111a2211210221011112200221211112011100111111101011111111101222000212101112111222102b2101111110111011111a1a10110101111111111
1111111111111111111111011111100111111011a0111212222202112122100120021222111011110110111111111011221221201010102112112021a1220121111011111110a1a11011111011111110
1111011101111110111111111111111111111111a2012111000110122122221221100122111111110101111111100101112212112212101022012221b2111121011111111111a1a11110011111111111
