72 14
5 107
122 49
126 101
64 67
119 18
56 105
111 104
8 43
26 34

0101101111111110111111110110111101111111110111111111111a1111111111101101110a110111111110111110111011111111101101111111111111111111110110101a11111111111111111111
1111111001111101011011111110110110111111111111110010111a0111111011011101011a111111111111111101011111111111111101111011111101111011011101111a10111111111101111111
0011111111011011101111111110101101111111111111111110001a0111111111111110111a111110111111111111111101110101110110111101111011111110111111111a11011111111111001011
1110011101011111110110111110111111110101111111110101110a0111111000111100100a101111111111101101111111111112020112112221121110201212211101111a10011111011111111011
1111001111111111111111110111111111111111111111111111011a1111101111111111111a110111111111111101101111101102201112012121021211212210112221101a01101111000111111011
1111111111111110110111111111111111111101110101011110010a1111101011111110111a111101111011111011011111101102221222010122111011222121102101111a01111111111111101110
0111111101101111111101011100111111011100111111110111111a1101111111111111111a101101111101001111111111111100020020212111211120112022111120110a11100111101111111001
1101101110101111111111011111111011111111111101011111111a1011011011110111110a111110111011111111011111111110102201021002122221211012112111111a11101100111111111111
1110111111111101111111110111001111111111010111011011111a0111110111100101111a111101111111101111111111111101211110222100122122221221110000110a11111111111110101100
1101111111110111111111111101111111011001111110011101011a1111111111111111000a110101011101111111101110111101012000221220211111212212012111001a11111111111111011111
1111111110101111111011111101111011111010110010111011011a1101101001111101101a111111111111111111111111110110022220010012222121202120210210111a11111111111111101101
1111110111110011111111111111100011101111111111011111011a1111101111110010110a011011111111101111111011011021221121022121101211200202212221111a11111110111111011111
0111111111101111110111111101011010111111111111101111011a1110101001111111111a111011110111110100000011111021101121202010001122011112111010011a11011110111101110111
1111111011001111111110111111011111111110011110111111111a0110011011111011111a111011101111111110111111111121111102110112122110121021111200110a11110111001111111101
1100111111110101101011101011110111111111111011011111101a0PPPPPPPPPPPPPPPP11a110111110111110111111111111121010210221211211121202212222111101a10111111111011111110
1111100111111011111011111111011011011111010111101011110aP011111101111111111a110111101111111110101111111111022211112201202210122012222011110a11011001010101011011
1111011111101011111110111101111111101110110101111111011P1101111111101111110a100100001111111111010111011100212122120211110100101122111111110a11111110111010111111
1110111111111011111111111100111010110101010011001110110P1101110011111010110a100110111100110110111111111112112121110022212211012121111201111a01011101101110111100
1111111011111101011111100101111111011111100010011110111P1111111101011011101a111110111111001111111010111011220002212122221202202110222220111a11111111001100111110
1111011101111101112101211201122211112212101111011111011P1111011011111111111a01111011111110011011111aaaaabbaaaababbababbbaababbbaaaaaabaaaaaa11111101111110101111
1111111111111110100212012212120110111102221110101011101P1101101101110111111aaaaaaaaaaaaaaaaaaaaa101a011001111211112201111222211220121100101111111111111111011111
0110111111122200100221220211001222121220201111111111101P011101111111110110111111111101111010111a110a011112210101212122221121210012020201110111101101100011011111
1011111110112022011022111111222011211022000111111111111P111011111111110111111011111100111111110a101a101121211210221222211101010021210111111111010111111111101110
1111100111120021221201122000120222100112011111111111101P111110111111111010101111110111101110111a111a111121102222021222212112112100020111111011111111101111111011
1111110011110221111012202122211222201112100111101111111P110011101111011101111111111011111101110a011a011001120222211020121211122222201121101111110111111101111110
1111111010122022100221111012122221102222121110111111111P010111100111111011101111111111101011110a110a111100101111201021201022001112111120011111111111011111011111
0111011011111211221121112222112111211201021111101111110P111101111110111011011101111110011110011a111a101112021212220211222220111102201110111111101111111110110111
1111111111112102120112101122211122222020201111111111111P111101101111111110111111111011011110101a101a111122212111212112221021221121221011111011111100011111111111
2212021001102212202212021102222011221210211111111100111P111111111110111111111010111110111111111a110a111122221211221212210020211111222001110111001111011110111010
2202010122122222122102222102011221222211121111101111011P011100111111101011101111111111111111111a111a101122122111202121202220201222121101111111111011111110111111
1121121011121202222211120122021111200122221111110111111P000111100110111011111111111011011111011a111a111110110220010022001221111102112101111111111111111101111110
1021220112122120022222102212222121222211211101011111111P110111111111101111011111111100111111011a111a101110201212211211121112221211111121111111011111111101011101
0112112012222022020212000220222001121211221111011011111P111111110011101111101110111111110101110a011a111122111210121022112001200221120001111111011101111011111101
2011211100210212212002222222221210111122211101011111100P011111101111011010001101111110111011111a111a001111122021212211121020021221122220001111010101111110011111
2211202022221201222122101220222122220210201111011111111P111111110111110111111101111011111010111a011a111111122221212222011211000201202010211111111101111111110011
2222000212122222220200222020210022211112211001111010101P111010111101111111111101101111110110111a111a111111020212112122102022212110211101011111101001101011011111
2002222201212221202222221012100121012221211111101111111P110100111100111011100111101110111111110a111a110010120222202221112222101020220122111101101111111011101101
2221202112222202102121122222222222202211121101111111110P111111111011111111111111111101110110111a111a011111022120110210222212211212211221221111111111111111111111
0112121122022220222022202022222121112221121111001001111P111011111101111111001111111111110111111a011a110111111222211200201002120022210200111111111011111111111110
1222102100122222222221202220220121011110210111111111001P101111110111111111011111011110001111111a111aaaaaaaaabaabbabbbbbb2012210011112221221111110101101011001011
1200221200222202221202112020210012102212111101111111011Paaaaaaaaaaaaaaaaaaaaaaaaaaaaaaaaaaaaaaaa11010111011001121122220b2110222102202220101110001111111011111111
12122111110200221222221222220222122012000201110101111PP1110011110010111110111111001111011111111111001100011011210120211b0111112121212200000111111001100111101110
2112012110012200010112002000110020212212110111011111P101111111111110111111111011111111111101111000111111110110101221222a2222210111110212111011111101111101111110
221022102112210122222221220220122102212211111111111P1111110101011101101111000111110111110111111111111011001111020010102b2220102121110111121111011111111011111110
02122211021210222021221210020222002100120010111110P11110101111111110111111100111111011111111111011100111010010212011202a0122112011111111110111011111111011110011
0221110111001220222122020221122221122001221100000P111010101111100111100111111111101111011111101111001011111202211111202a1201201222021221201111001111111111011011
122220122211202222211220222222222222112220111111P1101110111001111111111111101110111111111111111111111111011121112112022a1122111200021220121100111111111111010111
11212222210221002212221022012221212021121211111P11111111111101111011101111101101111111111111111101101011110111110121110b1200121212021221121101110011111111111010
0112222220002202022212221221222122222021110101P001110111011111111111011101111111111110111111001111111111110111122220120a1211110201122220111011111111101101111111
122121011112220220202222122022221122212112101P1111111111111101111111110011111000111111101011111101111111100011212122221b2101212112122102011111111111110001101111
12211202210202200220212222121011101111111111P00110111111101111011111110101111110110111001111111110101010110221102122211b0222222101012211211111001011111011011111
1221102112110000011121102010211111011111110P111110111111101111101111111101111111111111101111101111110111111222112021201b1221212210221211121110111111011110111111
210212222122000221112111112121111101111111P0111102111111201122220212101212201201111011111111111110011110111102111222221a1112122011212221101011111110111111011111
12222212221222221112220211111121111111001P11111101222021112122211121221211220211011111010101111111111010111122222112211b2120020111012111111111111111111101100011
1111221222011201122110011012222110110110P111011112102110022001111222222200112012110110111110111010011101111210111011020b0122021111122012221011110111111111011111
02212201221210221122201221202101111110PP1111011112222111021220111122212221102212101111111111110011111111010112201212110a2212021221122222110001101110110110110111
1022121120121221122021022212222011110P110111001111120012122120022122022211020211111111101101111111011101100001122101102b0222122210001212101111110111110101101011
021211022221201021112112211221201111P1111011111111211120222011212102111101221020111111110011111111110001011011011011111a2122102021021222021111111011111011111101
10222011220122211211112121211111111P11101101011111221111010111021121222200220111101111101110101111011101101120222220021a2101212020001120100111011110001111111111
1110111100111110111101111111111101P111101111111112112012222111121201211012201121110101111111111111111111101212122212122bbabbaabababaaaaabaaaaaaaaaaaaaaaaaaaaaaa
101111111011110011011111010111111P111011111110110211222212120211111221202210000210111111101110111111101010111122101101002112122120212010021101111101011011110111
01011011110110011111010101010010P1101111101011111212211201222110122110120110220201110110111111110111101101012112202201212111102010122211021111111011111001111111
0011000111111111110010101111110P11111111111111011021020120022110121210112202111111110110111111111111111110021112102202120122122021202221201110101101101111111011
111111101111101111011110111111P101111111100111111212101112120000111120021220221211001110000111111110111010121201202102112221011111222222211111111111111101111111
01111010111111011101011111111P1001000111110011101011022211211202011222110210012111101111011111111111111100021202112021212102020011212112121110111111101011110101
0111111111111001101101011101P01011110111111011111122201202211121022111222212011211011111111111110101110111110110111111110111010111110011110101111111101101011111
111111111111011011111111011P111011111111001100111012120211212210221112122122100111111101111110110111011101111101111101110111111111110111101110010111110111110111
11111010111111111011101110P1111011011111110011100110201111212111202211110001210211011011011111101111111101111111101111111111111111111100111111110111111111111111
1111101111111111010011111P01111111100111111111111111110202222012211021002211212011111111111101110011111001111110111111111111111111111101111101011111011000111111
001111111111111101111110P011111110111111111111111120201122212220212120200210112001111111111001111001111110011100011111111111101101111101111000011111111110111110
011111110111111111111101P111111111101111010011001001111020002112121011012021202111011111101011101111111111101111001011111111111101111111011110101100111110110101
11111011011111111111110P1010111100111111110111110210102021101010121011212111112211011111111111101011111111101111110001111001111111111001011111111001110111111111
1111110111111111111111P10111111111111111111111111120211202021211101210221202021210111111110101110111111101101111111101111111011101011011111101110110100011011111
110111011110111111101P110011111111111011011111011221220111012111022220121122211211101101110101101101110110011111110111111110111111101111111111111111111111011111
aaaaaaaaaaaaaaaaaaaaP1111111111111011111101110111112121212111221211012202121122211111111111111111011111111101111001111111111011110110010111111011011111111111111
11111110111111111111P1111110111111111011010111110221121202202122010021120021101211111111111011111101110111101111111111110101111111111010110111011111110011011111
11110111111111111111P1111111101110101111111110111020211101112222100021120210120000111001111110101111001011111100101111101110110101111110011111011111011110111110
10011110111111110011P1111111110111111111111011111110100121021221112012222210222111111110001111111111101110111111110111101111101111111110111111100101111011101011
01111111011111011110P1110011101010111111111111011212210212211200222111121112210011011111110011010111111110111111101111111000111111111111110111111011111111010101
11011011101101111111P1111101111011101111100111111121112121100222201112211121012211011101001aaaaaaaaaaaaaaaaaaaaaaaaaaaaaaaaaaaaaaaaaaaaaaaaaaaaaaaaaaaaaaaaaaaaa
11111111101111111111P0000111111111110101111111111112021121022201002222102022200101111011111a01111110101111110101111011111101100111111111111011011111110111111111
01111101101111100011P1111111101110111010001111111021222211110122221111011201201211101101111a11110010001111001111111111111111111111111010111101111011111101011110
10010101111101100001P1101100101011110100110110111002212102210101211212121111202211100011111a11111111111100101101111111111111110111011111111101011111111011111011
11111001111111111101P1111111111111111111101101011101111101110101110111011111111111111111111a00101111101011111011101111111110111111011011111101111111111111101111
11111011110111101110P1101010111111111111000110011100111101111101011111111111111101110010111a11111111111001111010111001001111101001110111111111011101011011110111
11111110011111111101P1111110111110111111111111110111101011111111110111100011111111000111011a10110111111111100111111111110111011111111111101011111111111111111100
10101111101101101111P1100000110101111111101101101111010011111011101111111110011110111011111a11110111100111111112100110222021220111102212211001111011110011111101
01110110111111111111P1111101111111111111111101111111111111111111100000111111011101110011111a11110111110111010112221122110211022210121211120001111111111011111111
11111111111110111010P1111111111111111111111111101111010100101111000101111011010011111111111a11111111111111101112120111112212111121120221121021111111111111011111
11111101111111111010P1100111111111110111111111111011100101111011111111111110101111101111101a10112221121112111222221112212220222211102121221112110111111111111010
00110111011110011111P1111101011101111111021120211200221021102111212220221111111001111111111a01111222222211001122121222212201000222201112211221101111111111110100
11111101111110111110P1010101111110111101111210012110220212211021212012211011111110101111111a11111221122222211222202222102202202121220111010220110111111111111111
10111111111111111111P1111110110011111111012220210101111100212111221120121011101010101101111a11102111210222201122222102022200012012222212121222101010111101010011
10111011111011111111P1101111111011011011001211022002112211122212112202201111010101111111001a11110101200000111000222102212122222201211112021102111111111111101111
11111110111111111110Paaaaaaaaaaaaaaaaaaaabbbaaaaabaabbbabbbaabababbbabbaaaaaaaaaa1111110101a11111002112200111010200012221221022210102011112011111101110111011111
11111110111111110PPP111111111010001011101220121221220110111122102220202211111010a0101111101a11101122210000121101212111001110002121020011111222011111111111111111
111011111010111PP111111111010111111011011012211222121122212122102112112210111111a1111111010a11112201221022010112220022011011022221221212212221100111111111111111
10111111100101P11111111111111111111111011012021122211122201122221122201211011111a1110101111a11001112210011100222222210221112221121121202221222111111111110110101
0111011111011P111111111111111111011111111010020120120100211112221012112001111111a1101110111a11112102200122122120022220222221222111111212112112101110101101101010
111101011101P1101010111111011111101111111221220221000211211001112212210111011111a1111110111a11112121112222222222211222222222222110122121122202101111111110010111
10101111111P11110011111011111101111111111221211220101122101022212222111111111011a1111111111a11110211222001012121210222222212220112222210101012111111111111111111
1110111111P100011111110011101111011101110212220102120101020222100212222010111111a1111111011a11112102112011202201022202220202222210201122222221111011111111111101
111111111P0111111111111100111101100111111212110111212101221112112211011111111111a0101110010a01101202021111110210002121222222011110122202112211101111111111111101
11111111P01111111100111010011111110100011011212012111110110202202110221111011100a1101001111a11112220121212112011202122222212121220011201110102010111100111111011
1111101P111111101101111101011110101111111201220221211222112011112122110011111101a1110101101a11112101111111211000222021202222212021101022101122111111111101111111
110111P0111110110101001110111011110111000121221202001110021000202112221211011011a1111011111a11102121212200211102211022222220122212121111212221111111111110011111
111111P1011101111111011101101011111111111221210011210112210111222121100111110111a1001011111a11002020000110121102120222022122002222021010212112111011110111100111
11111P11111011011111111111111111110111111112221212212122210222011220111201111011a1011111111a01112022211021101100222221222021200112022100102212111011111001111001
01111111111110011011101111111100011101101222121122222212122121211000021211110111a1100111111a11112211122201112112020222120221210102121011201222111111111111111111
11111010111111101101011110111110010011101111202012012011122211022010120011111011a1111111011a10011110121112121122222002200022211212010202210102011101110011100111
11001110110101111110111111111101111111011011212111112210112211012121111211111111a1100111111a11112221110021211212120222202120212001121221000210111111011011111111
11111111111101110011111111111111111101111002212121221120222121211201111201110010a1011110110a01112121111102112022210002022200222111021221221210011111011111101001
11101111011111111111010010111011111111111101110010210212020202122001102111011011a1110110101a11110220021121111102111022112101022020111122222021101111111111101111
11101110111011111110110101111101010111101120211011211112011012222011211111011111a1110011110a10112220121222112210222221222222020011122122211121011111110001111111
11111111011111111010111011111010111111110011221100211010002201121211012111101111a1101111011a11111112112122011112212200221122212210212212022012101111111111011111
01101100111110110110111011100011111111111110201212220011120202021211121211100111a1111111110a11012120022221211122022112222102222112220212201211100101111010101110
10111101011011111111111010111111111101111201012012121112100121122111122211110111a0111111010a11111012220100021021221020220201000011121211110202111111111101101100
11110111110111101111111100111101111111111122212100121122212112211022011011111111a1111011111a11112202112220121111011210201220111111111111111011110111111101111101
01111011111010111010110110111110111011111222122122112121120121202211101011011111a1111111101a11111212111202112210111121221112222010111111010110111101011111110111
11111111011101111111111001101010011001011222102220101200001221200111221011101111a1111111111a10112121221112212220002020211112221111111111111010101110101111010111
