80 119
104 11
122 49
126 101
64 67
119 18
56 105
111 104
8 43
26 34

1011101110111111011111111111011110110111a111111111111111110110111111111111111111111101111010110111a110110111110111111111111011100111110100011101a111011101111110
1010101111110111111111011101110001111111a101001011111111111111111100111010101111111101111110111110a111010011111101011111100111111111111011111111a011110111111101
1111111110111111011110101010111111111100a111111110101111111110111111011111111110111111011011011101a100110111111111010110011111111111111111111110a011010111111111
0111111101111111011111111101111111111101a010111111111111010111001111111011101111100001111111110111a111111200222102121212222021202222111111110110a111111111111001
1111111011110111100001011110101110110111a111111111100111101111111110111111110111111111111011011111a110112022111220112221222102220121222011111101a101101100110111
0111001101111011111101111011111111101011a100010111111111111101111111111011111111111111110111101111a111110211111020122120220210111102111110111111a011111011111011
1111111111111111111011110011111111101110a111101111110001111111110001111110111111110111101111011111a111012121211212222011221111222112211101010111a111111111101111
1111101110111110110011111011111111011001a111111101111111111111111110011111011111101100111011111111a011112020110201220120021221210101212111111111a011111111011111
1111111111100111011111111110101110111110a110111110111111111011101111110111011111011010111011000011a111110111201221101222220012012211212111100001a111011111101011
1100010111111111111111101111101011111011a111111101111111111111111111110111000111110111111110111101a011112121202001111012210110020122202111111111a111111111111111
1110101110101111100111111111110101110111a011111111101011111110110111100101011111111111111111111111a110112212221112020211122101012121011000111101a111111101011001
1111111111111100111111111111111111111111a111111111101111111111111111010100110101111011011101011011a111111101020212112221212002210211211101101111a111111110111101
0101010011111101111100111001101111110111a011101110011110111111001110111111111111110111111111111111a011110221111222011202201122112020110110111111a111111111110110
1111011111110111001111011101111111011111a111111111100011111110011111101101101111111101001011110111a111111110211222122111002201112221121011111101a111110101011101
1011111111111011111101011111101101111111a111101111111011101101110111110101110111011110111111111111a111102011111121121120102111120121101111111111a101001111111111
1011111111011011110110111111111110111101a101111111011111111111011111110011110111111011001111111011a011112011220011122211011212112100122010111110a111111111111110
0111111111101111111111110011100111010011a101111010111111111101111001111101110111110101111111110001a011111212111111100121102222112120221111101110a101110110111110
1001111110111111111111111111111111001011a011011011101110111101011111101101001001111111111111111111a111110112221111211110212220101221111111111011a011111111111001
1101111111111111110101110111111111111101a111111010111110111111110111111110111101010110111110111101a111011211221102001021202102210002112011111111a111111111110111
1111010011100221221222110111121222222210a211111101111110111101111101111111011111110111111101111101a111011122212102122111121201102100001111111111a111111000011110
1011110111121122221221121100211201001012b201111111100011100111110111111101110111011111011111110111a111111112222222000111210212220202212011111111a111011111011110
1111111011101112211112121011221221110021b111111001111111111111111111111111101001111110011101111111a111101120210020112220012022121211110011111011a111101011110111
1011111111112202121212121222022102221010b101101111110001101110111111111110111110111111111101111111a111100210221211122220122122221112211110111111a111011111111111
0010100111110100222102201222110002220211b011111111111111111001011111110111011110011110111011110111a010102011222211012212120221012022022111111111a111111100111110
1111111111110112111022222011200101111211b001101011111111111110111110111011111011111111111110011111a011110112221122220210221022200101122111011010a011111110011111
0111100011022211112211102112102211102212a111111111111110011111011111101111000111111110111110111101a011112012102222200102120121221111122111101111a011111111111011
1111111111112100110110222120210212110210a010011111010111100111011011111111111110000111111110111111a111010122221101222111201112201211212011100111a111111101011111
1111010111120111121120200102221022111221a111111010111011101011111011111101111010111011111111110111a111112210222221212212121110222100121111111010a111111111111011
1122102212202221122212020021121102022110a211111001010101101011111111010101011111111111111110101111a101000021212011122121111101220202212011011111a111111111110111
2221202220112222220202200022222211212101b001100111101011101100110111111111011110111011110111111010a110111211120110221021000200122101022100011110a110011111110111
1212211120222021221222221120122211222221a010100111011111111111111101011110000111101111110111110111a111012002122110202112010222122202102101011111a111101111110011
1202211220020101222122212112220120211000a001110100101001101110111101101111111111110111110110111110a111111011221011111120121122122200202111111101a111111111111010
2012201122122122222221222122222212102012a210111011010110111011111110111110111111111111111111011000a111111220111101121111122110100021222001111010a111111111011100
2212201201122122122022020220202020222222a211100111100110010111111101011111111111101110111111111010a111010112211102222002121201121012020111110111a111111110101111
2222121100212222222202222202220122000122a200111111111011111111111111111111101110111101111111011111a111111111222221121222212101011120121001111011a101110101111111
2022120221102102222221222200122212122102b001111111110111111101110101111111011111111111111101111011a111011111120221022022221002102022012211111100a111111110111101
0111121202122222120222222100211221122011a111111001111010111010111111011111101110111110111111111110a111011111001112021202021221220221012120111111a111001110111111
1212121122212222202222022212212200122222a011101011111110110110111111111100011011110101111111111111a111111111102210210010102222002122121022111100a101110111100111
2012211122122102112222101021010121120221b201111011111011011110111111110101101111111011111011111111a111110112200102102111022111201212110121111111a111011111111111
2112121121222002122220222222222222111020b111101111111011111011101111111111010111111111111011101011aaaaaaaaababbaabbbabaaabbaabaabbaabaaaaba11100a011111111011110
2022122210111022222202022200202220211021b0110111110011101111111111110011101111111111011111101101111101110111122112112111110212221221002212a01010a110111101111010
0212002020210112221222202012002201121102a1111101111111111011011111101101010011111111100011111111111111011110100021200121111221210211112112a01111a011101110011111
1120211021102122022111222122211102101011a1111011111011010111111111111111111111111101111011111011001111011111101011102122111222121222211112a11110a111001111111111
2020212121112122122222021211122212011101b0101111101111111001101111111001101101111011111111011111111111111110111122012020110211222010210012a11111a011111111111101
0222221222202222202020222021121201211221a2111111111011100111101111111111101111111111111110111111111110111112011120002022221000221011022202a10011a011011101111111
1010121111122221222112022202220112122221b2111111111011111001111011001110111011010101111110111111111111011111212212120212011022210111222010a11101a110111011101101
2121111202122221022022122222202211221112b2011011110011111111001110110001111111111111111111111101111110111100200220111011020220102022111222a11111a110111111101110
1120112200120001222222212110222112201222a2111111111111111111101001101110111111011111111111111111111111111112011212100211111201110211112220a11111a111111111111111
1112000121100122222222221222121110002001b1111111111111110101111011110111010111111110011011111111111011001011202022122212122100111221211012a11111a101011111111011
0011221012222212222222020222221202121002b2110111111011111111111111111001010011111100011111101011111011111111201112121011122202221111010012a10110a101110111111101
2110222200112210100212012011202111111111a1011111111111011100111111101111101111111110111111110111011101111002221221221122210102121022211222a11110a111110111111110
2201211201112202121200112022210111011110a0000110110111111111111111011011101111101111011111110111111010011112202210121020121212111222121220a11000a111100111001111
1011022211212200210112111221111111111101a1011111121211112220121111221222121110111001111110111111110111011112202202122221212012222220221022a11111a111111111111110
2111112122111121112021022212011111111111a1111111100221222011212202201110222121121011111111101111010101111112111220122211001101211211111122a10011a111101111011101
2102012221110210102012202221221001111010a0111011011110212000102102112210112010111100110111010100101111011112012201220201221111212210212102a10001a011101111101111
1120102100202212112212022022111111111111a1111110112021122220120112121221001112121111100111111010111111111112202111112101201222221111022221a11110a010101111101100
2212021110102111221121112221110111011111a1011111022122100102202210222102110221011101111111011011011110111112100120220222221011012212112201a11111a011110100111101
2121200221220220122211221212020101110011a1001110111221022110221221121011212102201111111101100111111111111110010020200211122222222221210221a11111a010110101111111
2212012001211022002202212112101111011111a1111101111112111121000222201111102021101111111001110111111011111111221110021000022201222221111112a01110a111110110110101
1111110110011011101110110111101111011011a1101111000122112121121201210111112202111111101001111101110111111110221011200211212221120222021022a01100a111111111111010
1111000111111111111111110011111111111101a1111111120012200201111212110012211222111101111011111111111111000112122121110121010002111120122212a11111a111010101111011
1111011111111111111110111111110010111111a1110111101122020122211111102011002002211111111111111111111111001101211121110212002012112212121221a11011a110110011111111
1110111111110010101111111101001011101011a0111111101022212022212212120111221121120011111111011111111010110101210101122222220222111220210122a11111a110111111111111
1100111111101111101111100111111111111111a1111111121221020011121221212211221111120101111010110111010111111110221222122211001211102111120210a11111a111100111111011
1111111111100110101000110111111111101111a0011111112121020101220011102221201211200111111110101111010111011012102101121111122201200012222222a11101a111111011001111
1010110111011011101101101111111101111111a0111100121121011012221122212202202121021110111111111101111011110110111111111101111101011111111111a11110a111111001111111
0111110001111010011110111111111101110101a1010100120121110112112212222120121122111110010110110111011100111111111111101111111011101011111110a11111a110111110011111
1101101000111110101111001101111111111101a1001111112112120000221120112121122201111001111111111111110101111111011111111100111111111011110011a00111a111111110101111
1001111110101011111011111110100111111111a1111111122211121121211220122211101122021100110111011110110111111111111011110111111110111110110001a11111a101111110111101
1010101111011111100100111111011111111111a1011111121121021022001102212111102212201111111111101101110101011111111111111111101110111111111111a10111a111111111111101
1011111011111111111111111111111111111111a1111111110111120120121222212221012201211111111011111111011111111111101001000111110111001111011110a10110a111111110111111
1101111111110110011101101111111111111110a1111010121012222110212222012211012222110001011011111111101101111111111110111111110011011111111111a11111a111110011111110
1111111111100111110011111111110101001110a0111101111022002201220211212222111220120111011111111001111111110110110101111111111101101111011110a11111a110111111111011
1110110111111011111011111111110110111111a1111011122020210120221200222022210121101001111100111111101110111111110110111101111111110111111111a11111a100111111111011
1011110011111011011111111101011111111111a1110111121122011121120121122220010012211111111110011111111110011110111111111111110111111101111111a11111a111111111111110
1011111111111110011111111111111111111011a1010010111022201222212102001121101212001111111011110111111110111101111111111111111111100110111110a11111a111011110110111
1011001111111111110111111001111101011111a1110111110211121211111211221221211212111111011111111111100111111111111111111011111111111111100111a11101a111111101101111
1111111111111111101111111011111111100111a0111101101200111021211211120211221022211011111111110111110111100111111010111111101110111111101111a11011a111111010111111
1101110111111011011101101101111111011111a1111111121222102212220221102220010111221011001101001111011010101111111101011111111111011101011011a10101a011111111100101
0101100011111110010110011101110111000100a1111111112112002202202121110122121210211110110010111111110111101011111010111111111111101111111111a11110a111111011111111
aaaaaaaaaaaaaaaaaaaaaaaaaaaaaaaaaaaaaaaaa0111011121211110111210012121021221001211111110111101111111111111110111101101111011111111111011011a11111a111111111100111
100111111011111100110111001111110111111111011111122211102222122012211012222101101111100111111111001110111011111101011111110110111110111111a01011a111111101110011
111010101100101111110111111111111101010111111011101212111111221210212221212110111100101101010111011111110010111111101011011111100011011111a11111a111101110110111
aaaaaaaaaaaaaaaaaaaaaaaaaaaaaaaaaaaaaaaaaaaaaaaaaaaaaaaaaaaaaaaaaaaaaaaaaaaaaaaaa111111111111110111111010101111110011111110010111110111111a01111a110101110111110
11111111110110101111101011111111111111111111111110111110111111101111111111111011a101111111111111111111111111100111111110111101110111001111a01110a101111101110110
00111101111001111111111111101011111011110111111100111101111001111111111111011000a101111111011111101111011111010011111011110011110111111111a11110a011110111111111
11111111011011100111101011010111110111111101011111110111100111111101111110111111a111111110111011011000001011101100202001000011120220111111a12211a111101111111111
11111110110111111000111011111111111111110000111111111111111111000011111101101111a111111111111011111110110101011112112210110020111211012212b22211a111111111111111
11111111111011111111111011111111011101111110111011110111111111110111110011101011a001111111111111110111101111111122111220111101211101201201a02111a111101010111111
11011000111111011110001011111111011111111011100111111101010101011111011111111001a111111111101101011201212202201222222111210022011210210221b02210a010101111101111
11111010011011011111111110111110111111101222112000112111110222122101110111111100a111110111111011112111021120121221222212021211222202122212a02211a111011101111101
11101111111111111111111111111111111111101221122122222112122021210211021211111011a111101111011111111101201121102212220120101222211222201212b21110a111100111111111
11011111110111011111110100011111100011111212211202012111201201100220101210111111a101111110111111112012102212201222021002212202221211210201a10110a011011011111111
00111111011010011111111110111111111011111111212211212122110112020121120211111110a111011111100111202210211121221111220120202222121001121202b01201a100111111111000
11111111110111110011110111111011111011100001221122102112011212012011102211111101a111111111001111120101122101012222222222222222222102111121a12101a111111101011111
00111011111101010111111111101111101111111111211101121202011001011012100111111110a010111111111111120212201222211212220101222022001111221111b22201a011011111110111
10011111011101001111111011111110111111101011112221111211010221102022111111111111a111101011111111112122020212111212012212222220212222020101b20211a111111011011111
11110111111110111001110111111011111101111202122122211111112021121011120201100111a101111111111110211012121221111221220222202222211002200212b22111a111110110110111
11111111100111101101001111111111100111111122102111212111211212111222010211111111a111111111110101121112012211112202222220102222212022221112a11111a111111110111101
11111110110111111110111111111111111111111212121201022221221110210122222110101111a111111111111101022110112120021200102002221002222101122202a21111a111111111011101
11110101011110110010111110110111111111111222211121111012100222122211002111011111a001101111011111021202111220011122202112121122221010112021a21111a101100111000100
10111011101111100111111111011111000111110201101002111122202011011012120111001111a111111111111100221121111012212121212212220201221102010212b00111a101001101111101
10111111001011111110111111110111111111111212220221221211121120112122212110011111a111111111111111222121202222102222122222201222210200100011a11110a110111011101110
10111100110110111111111011101101101111010102121121211112220210112111221010111111a111111111111111122120121110120212111022220222121111212202b10211a111110110001110
11101111001101100111111101110111001101110221110121111001221121222120021211100111a110110111111111202201011222112202022202222212111212112112b02001a110111110111111
11111111110111111111111011110100011111110111020222211202021200111111222111101111a101011111110110221222201121012222202211022112222112010121a11211a110111111111110
01110110111100110100111111111101111111111111021000100121202022122122212200010111a111110111101110112222011220222212122200022222112122111210b11001a111111111110111
11111111111011111111110110011111110111010011112201121101110211221101220011111101a101001111110111112022011120012222222221220022121200111211a11210a111111111110111
11011111101111101111001011110101001111111101002211210222222202121012102111110111a101110011011101100020021111010122222122020221202101220011a11011a111111101111111
11111011111110101110111110111111111111111002121111202212111212002021202111110111a011111111111111212001211112112221211022220022211101110121a22111a011111111101111
01111111011111111111110111011111101110111021212112221121121112110002120011101110a101100101110011110112022121111220111212212222211120121021a01211a011010111111111
11110110111111001001101111111110111111010220202221202111121211220121210211110101a111111001011111101101121112212222122211222201211022200120b22111a010111111101111
01101100111110111101111110100101111110111211111201202011212102122010212211111101a010110010111111212011222212201220012021222122221112120121b21111a111111111011111
00100111011111111111111111101111101101110011112210101121220102121121221000011111a101110101111111111200120020211002122202020202222112001120a22211a111110111111111
11111100111111011110101101111111111011110112202111002210212221122120122111111101a000111101111101202222111121112202222212220212120121222222b20011a011101010111111
10100111111011111011110010111111110011101211120102101122222020120111111011111111a111111001111101112222211112112200002122202012212121211001a12111a110110011101110
01111111111111011111111000111011111111111221101211022012011121222022202111111111a101111110011111212122222112112202222120221222021101110221b01110a111101111111111
11011110000010110110111111111111111101111102111221212111021102111220102211100111a101111111101110021012212200111122012120101222211111111110a11111a111111111111111
11011110111011111101111111111111011110101002111211021021012210200221221111101101a111111011111111222211121100121111012221211111111100111101a11101a110111111011101
11111011100001110111111100111111101101111220211112022122212001121020200211111111a110111101111101101111211120111211220102012101211111101111a11011a111111101111110
