4 11
31 110
122 49
126 101
64 67
119 18
56 105
111 104
8 43
26 34

1111111010101110100111010000100111011111101111111111111010111110101111111a1111010110111101111101010a011100111111011101101111111111111111001111111111111111111111
1111111111110011111110101111001111011111011001111101111001011111111111111a1111111111111101111101111a011111111111111011111111101111110111101011111110101111001111
1111111100111111111111101011111011111110111011111111111011111111110011111a0011111111111110111111111a101111111111111111111101111101011001111111110001011110111111
1010111111111110111000111111101011110111111111111111111111111010110110111a0111110011011011110111111a110011021021220112211222111210011220111111111111111110100110
1011111111111101111111111011111111110111110110111111001011110111110011111a1111011101011111011010110a011112221222101010222210112101121210111111111111111110111111
1011111111100101111110011111100111011110111101100111011111111111111110111a1110101011111111111001110a111121121022122112211201021201121221011010000111111111011011
0111111111011110101011111111111011101111111111110111111111100101111111110a1111111101111111011111111a110121021202111211222101112012112221110111111111111111100110
1111111111111111111101011111111111111001100111111011011111111101011110110a1111110001111101001001100a111112010022121122121022112221212211110110111111111111111011
1000101111111110111111111101110111010111111111011011111111111011101111000a1111111111111010110100110a111111112120211021012222112200111000110011111111011110111111
1111010111001111111111101011111111111011111111110111111111011111110001111a1111101110111111101101111a110111221211111221101211121211122021111110111111010111111111
0110011111000111101111111111111010101111011111111101101111111011111111111a0101011011101011101111111a111120122222222111212110211122100121111111101111111111011100
1111P10111110111101011111111110001101110111110111111001111110101101100111a1111111111111001011100111a101122012202111222200121011211202210110001111101111111111111
1100P11110011111111111011111011101100111111111111111111111111110110111011a1101101111101111111111011a111111211210221022222120221020221121111111111111111110111111
11110P0110110101101111111011110101111111111100111101011111111111101111111a1110111111111111111111101a111111221211012221211212211012112211110111111111100111100111
11111P1110111110111111111111110111111110111111110010111110011011110011011a0111110111010011010111110a110122122100011212221222222101110101011110111011010011001111
11110P1111111111111111111111111111111111111111110111110110111011111111111a1111011011111011111111111a111120222011222020111112210111212111101110111101111101111110
10111P1111111111011111111110011111111010111111101110011010111111011100111a1111011111011111111101101a111120221122011121121222212220201010110011111101111111101101
11111P1110011110111110111110110101111101110111110110111101111100111111111a1111111011011111110111111a111121220111211210221102022212222220111111011011111101111110
11111P0011110110111111101111111111111111111111111111111100101110011111110a1111111111111100101111011a001022122220102121120111012220111111111111111110111110111111
11111P1111122000122210211212221111121020221111100001110111111011011111011aaaaaaaaaaaaaaaaaaaaa11111a101102001011211011011221201112111111101010111111011011011111
10101P011101121212222110212202212120110022101111011001111111110111101000111111111111111011111a11010a111121112220211122212122122111021121111111110111111111101011
10111P111112101122102021211022222021101202111111000111101110101101111111111111101111111111101a11110a110111122021212021211211221212211221111111101110111110111111
01111P011101111220111111112122011122020211011111110111111100011101111111101111110101111111111a11011a111111121221110001221001001112012210111111111111111111111111
111110P11111101122111122010111010200201221011001111111111111110110111111111101111111011111111a10111a010110121120022012212121002221210101111100111010111111111011
011110P11101000221110102221110101210121012111011111111100011111111111110111111111111011111011a11000a111120111111021122222021011122121110111011011111101101110111
111111P10112222202121122220021121222012221011111110101110111101111111111110111101111111101111a11011a010011122111121101021112221212211010111111111101111111101111
111110P11012121112121022100122222222111201111111111101111011010011011110111101101110110101100a11111a111122111012001220200122122121101101101011101111111011011111
aaaaaaaPPPPPPPPPPPPPPPPPPPPPPPPPPPPPPPPPPPPPPPPPPPPPPPPPPPPPPPPPPPPPPPPPPPPPPPPPa111110111101a11111a101101221011011201000120100212112121110111111101011111011111
21221111001012222212012222020220012220010211111111011111110111101011111111011111P101011110111a01011a111001221101210211220120211111002220111111111111110101111101
10211212111102222212012220012221102201010111011111101111110101111111001011111111P111110101111a01011a111110112110021212210111121210012201111011001111111101111111
21202112220020220101101220122221101101122111110111111111011010111110110111110011P100111111101a11101a111111222102211011121222012201212201111001011011111100001111
22211201120121122202202212220020220212201011111111111111110110111110111110011110P101111110111a00110a111020211121112121122221112001111120111111110111101111111100
11222121201012222212211221200222111201112000111111111011111111110111111110011000P101111111111a11111a110112111111110021110212011111022211111111010100111010111111
11121212201222211211221120202222122211012100111111101111011101111011111111001101P111111111111a11111a001120122221001022122110022212121021011110101111011110011101
11210221212212021212022221022021121121111111111110111010111111111111111111011001P111111011010a11111a111011112121020120112201102112110111201111111001111011111111
11121211222122222220120202122222021101121111100011111011001111110111010111111101P011110111111a11111a111110012001201122211010122221200211110011111001111100110101
12212211220222221221212221020121101101102111111011111111011111110111110111111111P011110011111a11111a100011120210221022122210001020202222110111111101101111011111
01212221022101221022002010020211222221021201110111111111111110011111111111011111P101111111101a11011a010111112122210121111201222022222212120111111111111111101001
01122111210122022122212222222201012102121011111110101111011101001111010111101101P110111111101a10111a100111112211212121222021222202112111101110111101010101101111
22002110212211211222122212112012021011021111011011011101111001011110110111010101P111111001111a11110a100111111221212122012111021021220120201011001111011011011111
22212220111212222222200221222021122211222210111001101111011010111101111110111111P111111111111a11111a110111111211212011222211222101220112111111111110110110110011
22221122211220221022222211221222112100221001011011001111111110111111111111110101P111111011111a11111aaaaaaaaabaaaaabbaaabaaabaabbbbbaababbaaaaaaaaaaaaaaaaaaaaaaa
22202112122112020220212211220002202211021211110101101111111111111111101111110010P110111110111a111111101100000212220202212111212202011211111101000010111100111100
21112211222201122222222110222102022022102201010111101110101111101110111101101010aPPPPPPPPPPPPa111111101111120120101122212211210120211211211001101110101101101111
11220111121212101201222202211211012122211201111111111101101110011111111111101111a111110111111P110111111111102211111022122102012120011021200110111111111111111111
11211122222002010022102012220211210110111211011111111111110110101011010101101111a000111011111P111111111101111221121221212111122122101001121110001111101010101010
11220021210122100120222022222221121011221211101101100111110111111111111111011111a100101111110P110111101011112021021100121102000200220110211110111111111111101111
bbabaaaaaabbbababbaabbbbbbbbbbbaabbabaaaabaaaaaaaaaaaaaaaaaaaaaaaaaaaaaaaaaaaaaaa001111111111P111011111111100121000212102112020202021112021111111011111011111111
121121121022222112022221222222221221020211011111101100111111111011110111110110111111110111111P111111110100121011120211211101111011021201121111111110111101111100
211121211012122211222011102110211012212200111111101111111111111111001110011111110111111011001P110111110010111221112211222200012210211220110111111001111111110111
101021112121220001121210221202211110011111101101111111011101101110111111111100111111101110111P111111111001101120202010102222112211112221101010111101111011001111
202101020101102001101201110220111111111111110111111111111111111011011111110101100111111111111P110111110111122212202010111112021102101102201011111111101110110111
010121201021121112112120101220211111101111011111110011200211111121112210112121121011111111110P010111111111102002120212120210011222111212221011111101011110111110
111111200012020002202020010201011111010111110101111220022122012210212121110222211101111111101P110011111110111111101012120001111212111110011110111111111001111010
000211200021212111012121002220211111111110010110110221100201000202202101201111010101110011111P111111110111112212011111102022122022112200121011101011101111110010
001111120122121121121211200001010111111101111111112110121222201002021211112121121111010111011P111111110110122002221221111121110122112111101111111111111010110111
102201221121021022221110210111011111110101111110112111221220211111002012112212011111111111100P111011101001121221010211112212121010221011011111101101010101111110
211222212101222021021202202202201111110101110101121220201211212021011222122120110101011111110P110001011111111011120112112221122111112100221110111111111110011101
202121110101222121111012202220011011111011011011121011112211021000212022021121201111110010110P111111110111121222221121100211112121222110121101111101111101011110
101011110111111101010111111111111110111111110011100111121102112101202011120021111111111111000P011111111110101221120111111021222211122112211011101101110111011011
001110111111111010111111011111110110111111111111021121121201110211221122122110111111101011110P111111101111121101200122211102201112011211120111111111110011111111
011111101111011101111111001101001111011111101111112012022212220121100021002220111101101111001P010110011111101120202120222222000220210121010111011111011111111111
011100111110001111101000111011111111110111111101112200111112212122112022202111111011111001111P111101010011122121220111112121022210121122210111111000110111011010
010011110111111111111111101111111111101111110111021211111022211021221022102211220011111111011P010111111111112221112212210202021222122221201111111111111111101000
011111011111111111111101111111101011111011010111111122121012211210120121221212111111110111111P111111101100112012121111111212122100112101211111110111111010011110
110111111111111011111111111111111111111101111111101111111101110111010100111221220011111111111P110111111111110111110111111001111101011111101111111111101111111111
111111001111111111110111011111101111011111111110121121202211211121221001012100220111111111011P111011111111111101111111011111111111110011011111101111111111111000
111111111111001110110111111111111011110111111101112022012120011201211200001212221111111011111P111111000000111110110111111110111111101111111111111011110011111011
111111111101111111111111010111111111111110111110102021002222210121121120201111121110111111111P111101100011111101101011011111101010011111111101111111111111101011
111111111111111011101110101001111111111111111111112101120212022101101121212201111110111011111P111011111101111100111111110111111111011111111110111101010110011001
111110001101011111010110110111111111101111100101121111022111110220101210211211110111101111110P110111111111111110101111111100100111111101011111111101110111111111
001011111111111110111000110011110110011111111011111220202111211011210222101110221111111111111P111111101111110110111010101111111011111111001111111111110110111101
111010011111111011111111111101101111001111111110122210122010022101021122221022201111101110101P111110111001100100111111111011111110111011111011111110111111111111
111111011111111011111100010111111111111011101101122212110200121020221210112021221110111111111P011101101111101111111111111111111111011111111011101111111111111111
110111111010111111110111111110111101111111111111101221222220001010211020022121111101101111111P111101111101111111111111110110111111000111111010000111011111111111
111111111111111101011111011111111111011110111111102222212211012201121122122021221111111101111P111111111010111111011010111010101001111111101111111101111111101111
111110111111111111111111111111011101110101111111112222011101122021221122020221121110001111111P111111001111101101111111101001110110111101101111011111111111111011
111111110110101111010111011111111101011111100111111212022101112210211110121201211110110111111P111111111010111111110111111110110001110111111101101111111011101011
011111010111111011111101111111111101101011011011112100120212211222022022111101211111110111111P110011010101111101111011111101111110111011101111101111111111010110
110001110101111011100111111101011111111111111111122111222112211101221110022122110001110110101P111111011111111aaaaaaaaaaaaaaaaaaaaa111011011101101101111111111110
110111110011011111011111111111111111110111111101120110222212221121101101012102010011111111101P111111101111111a1110111111111111011a101101111111111111010111110110
011111111111110111101111111111111111111110111111102222022212111121111011101212221011111101111P111111111011011a1011111111111111111a111101111111011111111111011011
111101001101111010111111101111101111110101101111121111211111020111211121222122010111111111111P111111010101110a1111101111101111110a111111011101111111101110111111
111111111111101110111111011010111111110011110101110111111110111111111111101111101111111010111P111110111111111a1101011111101101111a111111111100101001111111101110
111110111101101111111111111010101101101011111111111110111111111111111011011110011111111101110P111101111111111a1110111111011111111a101111000110011111111111110111
100111111111111111010101111111111111101111100110001110111011110111111101111010110101010111000P111111111111101a1111111111111111111a111110101111111111111111011111
111111100111111111111111110101111011011111111111111110101111010111011011010011110111111111111P111101111111111a0100120112201202022a212201222110111111101000111111
011010111111101101111010111011111011111111111100111011111111111111111111111011110110111111111P101011101111111a1121000211222202211a110212221221111111101110110111
111011101001111111110110111111111111111111111111111011110111011111111101111111010000001111101P011001101111011a0221122122021220201a222022102112011111100111101011
110101111111010100111111101111110111011111111111110000101110010111111111011110011011011111100P111110221012011b2222222222110222100b121210012021111110110111111111
101101110011101111010111111011011111111112102122111122112112221222012222111111111110111111111P110102212012112a2222102220212021011b121110111021111011111110111101
111001110110111111111111110111011111110100211220221002222222112112121121111111111111101111000P111022121102011a0122221222221201202b010111112211111101010111111111
111111111111111111101111111110110111000111221002111111221002122122222202111110111110110010111P111211212011222b1200022222122110212b112102010221111111111110111111
101110110110111001101011010111111111011112111222220120222222220221222221111110111101011110101P110122112121201b0221222122120211221b110010212221110111011111111111
101011101110111111111111111101111111111012122002221000001220111122021212111111110111011100000P102022112212221b1100220122221222222a012201022001111110111111111111
111110111101001111111111111001111111011111011201100222221221210212211022111111111101111111101P112222112120111a1221112222010112101b211101120222001011111110111001
111111101111111101111111101110111111111012201222021122011122110122111221011110011101001101101P011111201222020b2021110222221200222a121110022212011101101001111111
110010110011101111111111101010111011100111112001121221211101121002212110101111111111111110111P110011102121201b0222112221212122222a110011202111111011111010111011
111111111101111111111110111111011111111102122022221112220222222202121022111111011111101110101P012001211002201a0202022121200222111a010010211212011111111101111111
011111111111001101101111111101111aPPPPPPPPPPPPPPPPPPPPPPPPPPPPPPPPPPPPPPPPPPPPPPPPPPPPPPPPPPPa112001212212122b1222221222121212210baaabbababbaaaaaaaaaaaaaaaaaaaa
110111111110011111011011010101101P101111112012001120112101011222001010211101111111101111110111111212121211102a00222221202112220211221121102111100111110111111010
111111111101100101011111011111111P110111110220212001101012211112100201201101111111111111101111102122222202111b11222202102212222111122122010121111101111100011101
111111110011111111111111101010000P011111120222122101221122120222111212111111011011111111111111110201112122211a01022000210222121112012011010211011111010111110111
010111111111110111101111001011110P001111112102022022101112011122111202111011011111101101101011111221022200211a21221222220222022120202222220010011111111110111101
111111110110111111001111110100111P011111011200212222022121002111201021011011111111011011111101101210111210110b12222000022110122201120202112011011111111111111010
111011101110111111111111111111111P111111000112121011121222102112022210211111010111100111110111010111101122212b12112221222010220221122021221222010111111101101111
111111111011111110011111101111100P110011121110020022020212101121021122211111011111111111111101112201111012110a21122122220212022021211122222210111011111111111011
110111111111111111111101111110001P111011112201212110100201121211211221021001111111101111110100111221121212111a22222222121110211210112102220002011111111111011011
100111010111100011111011110111111P111011111102212010222002222212222011201111001111111110101011011111122011020a21022220122202022212221212121120101111110011111100
111011111111011111111111111101111P110111100222221011121011122102212201110111111010111011011110102020111111220a12220222201222220001021021211111111111101011100001
0010110111111110100111111111110PPa101111111211212122112112021222110001111001111101110011110111012202222121201a02211202121120222122002120111022101111111011000111
110011101111111111101111111010101a011011112212112222122101120210120120221111011010011111101101112012211212120b12212200222222212201111212011211110111111010111111
101101111111111110101111111011010a111111122021212221021120101122011222121111011111111111110101110122201220221a22211222222022120211101021112102101110111111001111
101011111101100111101111111101111a111011100101211220121202021120011202221111111111110111111110112021202022112a11020001001111120012222101122110101011101010011111
111111111010111111111111111111100a001111020210221102012011222022112001201100111101111111011111111212221122100a02222222220002212211121102122212111111101111100110
111111111111111101111110111111101a111111021112201001111102211202122221111101111011111111011101102210022012202a22102111202220202211201121112012111111111101011110
000100101111111111111111100010111a111010122210211221112222102212120121111111001111111011111111111010122011021a12221212202122212110112212222012111011110111111111
110111010111110111111110111110101a111111121011220221222211211121121220121101101101001111111111001222122102120b12212022221022201111111111111110111111110110111110
101101111110101111101111111111111a111111121221121222020101122220212122221110011111001111111101110120111122121b02111121112210112111111110111110111011111111011101
011101011111111101111111011011111a111101100101120112122011201111202120111011111001001001010011111021120211010b00210121110202211111111011001111111111111111111101
