89 6
129 113
122 49
126 101
64 67
119 18
56 105
111 104
8 43
26 34

111111111111101111101011111111111110011111111a011011010011111110111111110a10111111001010111010111011111000111111001111111011111111101111111111111011110101111111
100110111111111101111111111011111101000111111a111111111010111111111111111a011111011111001111011111111111111011101011111aaaaaaaaaaaaaaaaaaaaa10101011111111011110
111111101111111111110111011111111111011011111a101111111001111001011110111a111011101111101111011111001010011111111111111a1111010111110110111a11111110111101111101
111111110111110101111110111011111110101111111a111110011111100101111010110a110010111111111000111111111111122020100221100b1110011110111221111a11011011000111010111
111110101111100101111111111101110111111111111a011011101111110111111101111a111001111101111111111111111110222221211021111a0101122222101111101a11111011111001111101
111111111110101111111010011001101111111111101a111111101111011111111101101a111111110111111111111101111111101002122011210b1222102021112111111a10111101110011111111
011111111110111110111110110111111111111111111a101111111111011101011110111a111101011111101111011101111100111102221112212b2122011010200221110a11111011111111110111
111001011111010011111101111111111111011010100a110111111100111111111111011a001111000011011111110011110110121121222221221b2111111121120011111a01111000111111010110
111111111111111111001101111011111101001010111a110110110110111011111111110a101111111010101001111001111111211222220011011a2111011211120121111a11111100111111100000
110001011110100100110101101111111111111111110a111111111101101111111111001a111101101110110111111111101111221122200220211a0121220112111211111a11001110111111111101
011110111111101111010011110110110111101111001a111001011110011111011110011a110111111111111000111111111111011220111100111b1211122211222211101a11111001111111111011
111101110111111110011101011010001011111111111a110101101111110111011111111a010111111011111111111110101011221021210111101a0010002221121021111a11111111111111111111
111011101101100111111001111111110111010111111a111100111011111011111111111a001111011110101010111111111111121212102112201a1102201021222021101a11111110111111111111
111111111101111111110101001001001111111101111a011111001110111111101111110a111111111100111011111111111111102002202102022a2112220110022221111a11101100101111011111
100111111010011011111110111101101101111101111a111111111111111101111110111a101111010101111101111111110111221112212021210a1212212212022201111a11110000111001111001
110110111111100011111111111111111111011110101a001111111111101110101111111a010101111111110111111111110111121212202121201b2001212021221011111a11111111111110111111
110011111011100111001010111101111111110111101a111101101111110011011111111a111111110111010101001110111011210121102021221b1222122212110021111a11110111111011011000
110110111100111111110110110011111111111110110a111110101111111110011111111a111111111111101111111011110011202201212222110b2111220111110101110a11110111111101011110
011101111110111111011111101111111111111111111a010011101110001111101111111a011110111011111001110101111101211210221222112a1200120222210011111a01011111111111111111
100111111012112112112020011122121112002211110a011101001111111110111001011a110110111111111111111111010011111012112102011a1211222202022111011a11110111111110111101
100110111011201122120201211122122111212102111a011110110111111111111011101a111011111111110111110101111101221111112112112a0212200220121120111a11011011011010111101
111111111102002112000121221010212222212200111a101011111011111110111111111a111110111010001110011111011110221020111210200b1221221112221211111aaaaaaaaaaaaaaaaaaaaa
111111101112011221121101022222110020210212011a011101111110111011111111111a011111101110101100001110110111122002112102122b2202111201212121111111111111111101111101
101110111102212122122110210201222112102221010a011111010111011111011010111a101011111001111101111111110110111001111210110b0211221212121100011011110111110111011111
101011010102111121222111002002121211211121101a111101111111010101101111101a111001011111011110111110001111222221000122220a1222210010221211111111011111110111101110
101111111111221212101202002110211111222122110a011110101010101011011011111a111111011111111110111111111111210202121101121a1101101110110220111110111011111011111111
111110110112221100121201122021112211110121111a111101111110101001111101011a111110001111111110101111111111011220122202221b1211000112121001111111111111111111101111
101111011111012202222210222102202210112222111a111110111111110111110101111a111111111111111111110111111110101120011120121a2112102122112111110110110111101110011111
110112120010020221121222002221212222222121101a111111100111011111111011011a101111011101111011111111101101112121101212102b1111101222112111101111111111111111111111
211221121122022212212121222222020221121211111a101111111101111001100111110a111111011011111111111111111111200022021122211b1212211212222011111011101011111111111011
112212020012222221220122202222012101222200111a110101111110110111111111111a011011111101111000111111111011221212112221110a1110121212102211111111111011111101010111
212211122121112122222222011202212221202201110a111111111111110110111111111a111111111101111011101111111101022112122112120a1200210021122211011111111111111111000110
212121021212102122220222200202002010201112110a111110111111101110110111011a111110100101111111110111111011111102112212122a0212002112122021101101010111111111111111
120022201210212112222220121122221012210210010a110011101110111011011110011a111011101101110011111111111100121011210011111a2120112220100100111101111010011111111111
222012210222222222002211120222212221201111111a101111111110111111011111111a111111111111111100110111100011111212111221210b0021212012012202210111111111111111110111
102121221102220222220202221222211121121120101a111101111110111101101111111a011110011111100101111101110101100121220021211b2121101122112211201111111111011010011011
211212022122102021010020222221100221111011111a111100110111111111110111100a111110111111111101111011111110101222200001220b1100022111121121010111011101011101011111
001102222112012221212210021201102121122111000a011101110111111011110111101a111101011101011101111101111110011202112111021b2222102121022122211001110101111111111111
220110220112021222220222202022012211221011111a111111111111111111111110111a001111111101111111111111011101111200121211211b1022012221111121221101011111111111110110
012122101221122222222222202120211100111211111a011111011111011010111011111a111111111001110011111111011101111201102100022a2011200012212211101111111111111111101101
122202120211122210221012111200212211022211111a110110111111101001111010111a111111111111100111111111111111111222211020111b2121222110200011121110111101011111111111
222200220222122022122222222212211211122221101a000001101111110011111101101a101110111111111011110110110111110012212122002abbaaaabbbaaabaaaabaaaaaaaaaaaaaaaaaaaaaa
211211012010100211220212222120212112121201111a111010111110111111011001011a11101011111101111111111011111111011111000022111221121011011122200111111111111111111011
212221021212012220222121122222120011121211111a111111011111011111111011111a11111110011111111001101001101111022222212221102211021010102121121111111101111101011110
210000111101212122220211002220111122210122111a111111111111111110111101111a00111110110110101101011111101111011102222011221112110111011022221110111111100101100011
221221121210121201022222220202221022212121010a110111111101111111110111111a10111111010100100111111111111101101221102110220112222202022112200111011101001111111101
112112121110222022202220022022212112120221111a100001111111101011011111111a11111111001111111011110101111111101212110011021212202021222221211111111111111111111111
221111120201221012022022221210121022210212111a011011011111111111111111101a11111111111111111110110111111111002122011020211001200120202112221111111111100011111101
201221122102200212022212122022202112022122111a111111101101110011101110011a11111111110111110111111101101110122122011211121222011111121221201111011101101111111111
122122110211221022222222212221221200022112111a110011111111111111111011011a11011111110101101111111101100011121220121100100210210221101010121111011011111111111111
121012111221221201010002011212200011100111100a101111111111101111101111111a01111101111111011101111110110011122102021111221121221121212120101010011111101111011111
122111212221112212210011222112211111111111111a110111111111111111111011111a10110011111011101110111110110111110011112220222110222102100122011111111111111111110010
200201111111200112112001101021000101111111110a111021100222021022112221012b12122210111111111110011111111111112121211122212021022212011011211011110111111111010100
002012201222220101101021111121111111100111001a111200212202200101222221222a11222011111011110111011111111111010122110022222021221220222212101111111111101111111011
210121011220001120110202122201211111111111011a111011112221220011102212122a21222101111111111111111101111111102101222111212112110121021121011101111111011111111011
210022210110212112120201020121111111111111101a111111211212101012121100012b22001101111111111111110111110111102210110121000002211220210112221111111111111111111100
111021121011221011002122222020210011110111010a111112121122111100021201021b10202210111001111111110011111101121210211221120222021222011222201000111101011111111110
111011110111211221122021122112011101111111111a111100122201122011112122222a21010111111111111111111111001011122022110111122112201212122122111111101011011011111111
211122112220011112011022112110111111001011101a111221102221012111010011121b01222010011011110111111111111111111121011210211220211211121120011111111111101101011011
111011101010111011111111111101111111111011111a011100221202212200111112021b11012101111111111111111111111010122211011221120212102022112211111110111111111111100111
111111111110111001111111111101011110101110011a111211202111102212212112211a22112201001101111111011011111111100200221121001021111011111022201100111111011001110111
110111110101100111111111011111010111101101110a111020221111220211110011112a22010111111110110111010111011100120102011211021112110012112211220111111111011111111111
111111111101111001110011111101110110111111111a111212111221021110120022111b22111211010011011011111100111111001220002110211011211202120221220111111010111101011111
101111011111110010101100111111111111111111110a110202002111211211120112111a22212210011101100100111111011101012121212012102212021002220122111111101111101110111010
111111011110111111110011111111111011110111110a110220211101210120222202121b10112211110110111111111111011111111000121210211212211112200111121110100111111100110110
001011111111011011111111111111111111111111110a111221111101100211121211120a21112210110000110100110111111111001111111101111110111100111111110111111111101111011011
111101111011111110111100110011111111110010001a111010021201201012221010012b12120111001111101111011011111001011111011111111111110111111111111001100111111110110111
011110110011111111111111111111101111100111101a111221200110221011122200022b21212111111111111101111110111111110111011111111110111011110111111011111101111110101001
111111011110100111111111110010011111011001111a111220121212222012111212021b12110211111111111110111111111101001111011111100111111111111011011110101111111111111111
010111111110010111101111101111111101111101011a111120120221210112002122120b11211210111110011110101101111111111111111001011111111101111110001011111111111111011111
111100111111111011111111101111011111111111110a011211221011112012220221122a21202211011111111111111111111111111111111111010111010011100111111011111111111111111111
011111011110111101110111111111111011101111011a111222220201022212100111221a00011101111101111110111011101111111111011111111110111110110111111111110111101101111111
010110111110101101111111110100111001100101111a111022110201010220022210212b22221011111111011111011111111111111111101011011111111111010010111111011111111010110111
111111110111110110111100111101111111111111111a011102201121112012121112012a21122201111111111010110110110101111111111101010011110111111100111001101111111111011111
111111110110110111111111001101111101001101011a101200210200201221111202202b11121211000001010110011111111101111110111011101111111110111100111111111111011111110111
101111011111011101111010111111111011101111111a111121120221221212202102221a01011211111110101001111111110101110111110111111111111011011101111111101111111101111110
111111111111110111111111110111111011111110011a011021101120202212000211110b22102111110111111111100111011111101101111111111111111101101011111001111111111111001111
011101111111011011111110101111011010111111110a101002221122121222110021011b21102210111111111111110111111111101111011010100100111111110111110101111101111001110111
101101111111111111110011110001011010101111100a111222221020212122222212010b22221211110111101110110111110101111101011011101111111111101011111110111111110101101111
111000111111111111011111111111111111111111111a100211211112110022102112020a22222011111110101001111001111111011110011011111100111111111100111111110111110111101111
110111111111110011001111111111111111111111111a0112112ababbabbbbbaabaaabbba01120210111110111111111111111111111110101111010111010110111111001011111100110111111111
011110111101111110111111111111111011111011111a0011121b2121202010211122101010120211011110101100111111111101010101011101111111110011111111111101000011111110011111
000111111110111111111111111111101111101111111a1111002a2012112221201020221111112111111110101001111111110001111111101010101111111111111011110111011111111101111110
111111111110011111011111111111111111111111111a1111111a1011110101011111111100100101010011111111111110111111101101011111111110111111111101111101111011111111011111
111111111010111001101101111111111110001101111a0100111a1111111011011101111011111001111010111101110111111101110111011111101111111110111101111111110101101011100111
111111110111111111101111111110111101111111111a1001111a1111111111111101011110111111011111111110011101001101110111111111111011111111111111111110010001101111111101
110110100111111111101111111010111100011111111a1001111a1110011110110111111011101111111011111111111110111010111112121121111111122102122101110221111101111111111110
111001000111001100111001111111111111111100011a0110111a1111111101011111101111101011101111001111111111111011110101202012110110202021101222121221101110110101110111
111011101011111100101101001111111110000101111a0111101a1111010111111111111101111aaaaaaaaaaaaaaaaaaaaaaaaaaaaaaaaaaabbabbbbbbabaababbabaaaaabbabaaaaaaaaaaaaaaaaaa
100101011111110111111111110111111111101111101a1111111a1111111110111111011111010a11110011111011102121201121212122021022222022012112210202102122111111111111111110
111101011111111001111111111111110111111111110a1120211b1012212211221211211101011a11111111111111112111021212221202222112111202022200112022012112111100111001101111
111110111110111100111111111111011111111112101b2111001a1211222110121210111011111a11101111110111011202202211111022012222221222222021121022222002110111111101011001
011111111011111111111111111110101110010112121a2010012a1222112202112011121010011a11101111111111011221202212012212201222121121122221211122212202110101011010111111
111011111101001111111111111011111011101111121b1201201b1012102112201221210100100a11111111101111101110022110201121220201120212221121200212212221110111111111101111
101110011110011111111111101100011011011012021a2210021b1122022022011221111011111a11101111111111112121212222122100222222222222021212011112122201111111101111101010
111111000111110110111111111101100111100011221b2011101b1210101220222122021110101a11111111011101001212022120121210122201222202112112201002212002111010110111111001
101111100111111111111101101110111111110110202a0011021b2112222122211021011101000a11111011111111100112222212202111022211211222012111001120112221111111011101001111
111111111001111110111101110101111111111110011a1020021a0021121020112112221111110a01111011110111111101120111222110122002202122122222210100221022110011100101011111
110111111010111011111111111111110011111111111b2002001b2000201112212210121011011a11111010011111110221121011101100212200120222222122210112102120001110111101010110
111011101111111111101111101111101111111111201a2221222a2212111121112222221011111a11111111111111102120122210210221220222222211222201122211120221111111111110111111
011011111111101111011111111111111111111011022b1021211a0121102011101211210111111a11011001111111100222212120221222012211100012222100222020121200110111111111111111
011111111101010111111110111111110011111102021a2112001a1220002220122101121111011a01111111111100110212121212111121122222222202022212112110212121111110111111101110
111111111111011100111110111110111011111102111a0222222a1011122022122122101011111a11111011111111101202022222101112212020222212122211122011212112111011101111111111
101111110111110111001111111011111101111110200b1211200a1212220110021200201101010a10101011111010111221011102222222112221212222200202201020111201111111111101101111
001111001111111111111111111111011111111111212a2101011a2022211122102000121111111a11111111110111112212122121122102221101110112122201122212122212011111101111110111
111111110111111110110111111011110001011100021a0011222b2201111202221211201111111a11101101010111111101121221011221022120201002021112122121110212011111110111011101
101101101111101111101111110101111111011112022b2220222b2102220200122202111100111a11101111110011111202221200120222222222020222201212211122111222011011101111100010
011111111011111110101111111111111111111011222a2221212a1011020211120112211111110a11111110011110112121212012121211222202222220222210112200212211111000110101111111
110111111101110101111101111101111111111110222b1121012a2112120221221221121111011a11111111111101011202202022222021020222120122211211012220001101111111111111111111
011111111001110111101101111111111111001112111b2122212a1021022221110211020111100a10111110111011102021021112012221102020022222022112122220121120111111111100011111
111111111111101010111011111011111011111110112b1221112b0122122121222121111111111a10011111111011102111210000222012022221021020221211111202121022111101110110111111
111111011101101111000010011011111111111101111b1102022a1112112202112121100111111a10110111111101011201111012122221120122222210212012201212201212111111111111011101
111111111011111101110111111111111110111111212b1100102b0211021221212020221110011a11111101111010011111111121001112222022122202122211110221012010111111111011111011
111111111111111011111011101111101110111112001a2112111a2011122112111201201111111a11111111011011111221211022011221212222211002101221112222212121111110111111101111
111111111101111110110111111111111111110100211b0101122b2120112211111122211101001a11111111111111112122120011121012220211222222211122010120212001111101111111101101
111111111111111111111101110111011110111110012a0111121a2011102002212111111011111a11111111101110112221220220222212021221122000221121012202222101111110111111111111
111110111111011111110111111111011111111011111a2111222b1121122200112222110011101a11010111111111111102012210101011201020221012212220111012001220010111111011001111
111111011101111110101111011111111111001111210a1211220b1112010112200121001101110a01101011111111111120211112111222200222111120110110111110011111111111111111101101
111010110111111111111011011111111111110111102a0111210a0210211121221110110111110a11111110111011111212021122221222111202201011122111111010111101111111001010101111
111111111111111110111111111111111111111111220a2001212b2211112022212112220111111a11111111111111111122122112221022011122020212120111100110011111011010110011101111
