108 109
58 17
122 49
126 101
64 67
119 18
56 105
111 104
8 43
26 34

111011111111111011111110111110111011011a111111111101110011111111101110101111100111111111111111111111111011101111111111111110111011111111011110100111111101111110
111111110110111111111111110111111111111a111111111001111111111111111111111110101111111111111111110111111111111111011111111001000111011111111001011111111111111111
100111111111111111111011111111011111111a111111111111111111111111110111101111111111101111111011111011011101111111111111010111111111001101110101011111101111101111
110111111111111111111011111111111010100aaaaaaaaaaaaaaaaaaaaaaaaaaaaaaaaaaaaaaaaaaaaaaaaaaaaaaaaaaaaaaaaabbbaaabababbaabaaaaabbabaabbbabaaaaaaaaaaaaaaaaaaaaaaaaa
0111110111110101111111100011111111101111111011111101001111111110110101011111111111110111111001111111000111200012222211121111101122111201111111110010111110111111
1111100101111111110111001111111110111101111111101100111011011101101110110101101111101111100101101100111012010101112221112222221211212210111111011111001111101111
0111111111100010101101010111011111011111011011110111111101101111111011001010111111011111010111111111011121011021222121222211011221222111110111011001101011111100
1111111011111111111111101111100111111111101110101111001110111110011011001101111111111101101011111110110111020022211122011121212202210221011111111110111101110111
0111111111011111110111110111110111111111011110111111011111111110101111011011000101011111111111111101101010200012000111121122221222112111101111111111101010111110
1011111110111011111001111111111111011110111000111111010111110111100110111111110111111011111111111011001111111112222120211012222022112211011011101111110111010011
0011110111101101110111111101110111111110111110111111011110011111101011111111111111111110111101111110111102202110211111212222122122220111110111101110111011110111
1110111111101111011011011101110110111011111111111111111111111101110111111111110111111011111110111111111101221212222200201222102122120221101101111101111111111111
1111111111111111110011110011110110111011011111111110001101101111111111011110111011111111111111101101111002220022122211102112201202010101010111111111111111111011
1111100111111110101011111111100101111111111111111110100101111010111101111111111111111111011111110111011101010122121202201121222011012121111101010111011011101111
aaaaaaaaaaaaaaaaaaaaaaaaaaaaaaaaaaaaaaaaaaaaaaaaaaaaaaaaaaaaaaaaaaaaaaaaaaaaaaaaaaaaaaaaaaaaaaaaaaaaaaaaabbbabaaaaabababbbaabaaaabaaaaaaaaaaaaaaaaaaaaaaaaaaaaaa
1111010111111111111111111110011111111111110111111111111111111111011111111110111101111101010111111100111111012011011111111122222221202211110111111111011111111111
1110110010111110011111100111111101100111111111101111111111111111101111101111011111111011111010101101011111221010122102222111221212202101101111011111111011110101
1111111010110111111111111111011101111011101111110111110111111101011111001011111110001011111111111111111112211202122111112112021110012220101111011110111111111101
1101011010001111111111110111101011111001011110111111111111111111111110111111110111111111110111111110101121121122012221120220122122021111001011111011111111001111
1111111011121112021121111122100122212111211111110110110111110110111101111011011110111101111111111110110122110202220122222021022102122211100010101101111111101001
0010111111021122212210211210201222222212211111110101110111001111001111111111011111111101001111111001111101212112121120122122112220201111111101111110111111110111
1111111101120110021211202211101220212212211101010011111111111111110111111011011111111011011111111101111102221200002011101201221111202201101111111111101111111111
0111111111112110201102112100021212111221111111001001101111111111101010111011101100101111111011110101101111101011212221222020112220111010111011111011111101101111
0111101101112111001221211001012221022111221110111111100011111011111111111111011111011111111111111100101111120211222122111111221102021201111111111011101111011111
1100111101121211020221102110211112121020110101111111011111110101111110111111111011101110111111110111110122122222220122221120201112111221011101101111111111110111
1111111111111110210112120220221100221222221111111111111010111101111111111111111111111111111111111101101110022002112011200202211222021021110111101111011111111111
1111001110111122102111211012221102111110211110100111111111110111111110111111111111111011101101111111111122111000011222212112210000202121110111111111101110111111
0111001110110012200210202101222202220212001101011101110111111111011111111111110011011011111011110111011111120111211210202221121121221100110111101111111101011100
baaaaabbabaaabbbbbbbbbbbbbbabbbbbbbbaabbabaaaaaaaaaaaaaaaaaaaaaaaaaaaaaaaaaaaaaaa1111111011011111111110102121222021021122010002211211111111110111111001101111111
20210020122121222222122110222222220000112100111011011011111010001011111101011101a1111101111111110111111110112122222222222022111210222111011111111111110010111011
22221122200220220001022220002210210122221011111111111111110100110011110101111011a0111111110111111111110112101202121121100022111222020121011111111111011110111110
21212011220220222201202202202011221111111101101111111101111111111010111111101001a0010111011101011111100110112121222111122102110122110121111110111101110001110111
12110111011122122200200121122121221222210211110101111111111111111111111110111011a1011111111111101111011112111222211001121220101012211121111110111101011111011111
01211102210020222212021222012212202211122101111111111101111111100111110011101011a1111111111101111111110112210222221122200120122110022220111111111111111101111101
21021211121022222222112212221111101112211111011101111101110111101111111111100111a1111110111101111110111001100212021221201210202112220121221111111111111001111110
12212222120100210220201221022120212102101111111101110011111110111111111011111111a1111101100111111111111101120222211220212122210212111122001110111110111011111011
12222112121211202122102221022221020221122010111011111011110111110100110111111101a1110111001111110011110100112222021101111120221111011112221111111011111111111101
12112120012121212212101102022012110211012111111101111111100111011110111111111110a1111111111111110110111110020222211201110100112022222112001010111011111110000111
12110122121212212220022200210222121122011011111100011101111110111101111110110111a0111001110011110011110011121112112210011121211221121210111111111110111011111111
22112120121221112101222121022222222112021101111110001111110111111111110111111110a1110101111110010011111011021121001122201221112011220121001110111111011101101111
10222202100221120122222221222201212211011210110101111001110111001011011111111111a1110101010111110110111011021202112111121212011211011212200111111100111101110111
12021211221112222212122021220222110200110211010110101111111110111111011111111110a1101111101111111101111110100122210211201221022022211111221101111111111111111111
21101210011222011112211021112220212110111211111110011111111111111111110111101001a0111011110101111111110111112021222101221210102102122011111011111100011101011111
20011100112220012010021222122222012201202211011111011101111101011111111110111001a1111010111111111101011010122012121011121122120200222222021110001111111110111011
21011120110221202002222002212202102201122101111111101111110111111111100111111111a1011111111111110110001111112211122221102011111212111110200110110111111111010111
02000111122222222202222202022002222022221011110101111111111110111111001111111111a1011111110111111111111111122112221221212020012111011122201101011011111111111101
21202110220222201221212022221222221012220111111011110100110111101111110110111111a1010111111110011110011110111112212212100122221011110122211101001111110011011111
12201101212210122222122122120200022212221211011111011111111110111101111110111111a1011111111100111011111111112101101020211122122210101201021011011111111111111111
abaabbbabaababbabbbbbbbaaababaabbbabaabaabaaaaaaaaaaaaaaaaaaaaaaaaaaaaaaaaaaaaaaa1111101101111110111011010122012212202210211212010102222121111111101100111111111
2121122001222021020202021002222111001222121001011011011011111111110111100110111011111111111110111011111111121102220002111100112022222220111101111111111001111100
2211222012110022101121211012122001111011010111111010101111111111101111111111011111011111111111111001111111000121220011000222002112222111020111111101111111111011
0222121122222221202001121111211101001111101011011111111111011111111111110111111010010111111111111101111011121101001210120010211220011220111111001111110111111101
2021201112101122122112010210202001111111111101111110222221121201022120212211022211111111111110011011111011102222210211222211222222112212201111011111011111110110
2212211201000122021101101122112111111111111111111100211120221102222121212121212211111111011001110111001011112122021002111221221221211222000111111111111110111011
1221121222212220100022120012222111111101111011111022100212122002211120212202121201011110101101111111111001002210120022222022110210010220111101111100110101011110
2022121111222211021212101020222111011110100111111111010222112122112120120112011201111111011111111111111011122111010121012210221221121102111111111110111111111111
0210222122121010101202112211101111111111110111111122102111012111001121220121221111011111111111111111010111000212022222111121012222110110021010011111111111111110
2111222222220101112112211102012111111010110110111122222111111020212010220122121111111111110100101111111111122200120210111222021221222121021111111111111110101101
2022100222112122012221221111120111101111111101110112211211222101112222011111102211111101010111101111111111110021211221202101111210112221010111111111111001001011
1111110111110101111111001111101011110010010111000112220112122001221011011222212011110111101011111110101111110212212221221112220111202122011111011111111101111111
1011100111111110111111011111110011110111110111010222101210101101220021100100112211111111111110111011010011120122222112122112211011121201211111100011111110111111
1111110111111111101110111101110100011011111111101122222100211221210112001212012011111111011111111001100011111110102212012121111101111001221111010011111111111101
1111110110111011111111111110110111111110110010011012221212212211022020122222210211011111001110111101011010002220121120121100220102202211111111111101011111111111
1111110101011011100011111111011111001111101110111112222221110112210200222221100011101111111111111000011111122201111010111211111220221202111011101100111111111111
0110110111111011111010111101111101110011111100111222021001001000122201011111121211111011111110011111101011121221022112101100010102201002221111111010101111101111
1111111111111111111111001101111111111110111111111111121112100101012021222012200110110101101100100111010101101110011101110111011100111111111111101011110101111011
1110011110111111111111101111100011111111111111111010222202212122211101122112222211101001011111110111111110111111111011111101101011110110111011011110011001010101
0011111111101111111111111111111100111011111111111202112210212111220012120221102210100010001010010111111111010111111001111110111011101011111111111111011111111111
1001011101111111111101111111011111111011011111110112202121110212212112021101011011101111111110111111111111111110111100010111101110101010101101101111110001110110
1101111111110111101100111111111110111011111011111210222112101222221012110102101110110111111111111111111110111111110101111001111111111111111011111011111101001111
0111111111111001011111111101111100011110111111111120111210202122001222000112121201001011110111111101111111111011111111111001111111111111111111010101111100101111
1111001111011111111111110111111110011111111011011012012012211122121212221011110201110111101111111111110111111111111011110001011111011011110111111111111011101011
1110111111101111111111010111010111111111101111111122222112102222111211102122022011111110111111011111111111111111110111010001111101111010110111110011111111111010
1011110111111011111010111111111111011010111111111102222022121112222211212001220111111111110111101101010011011111111110111100101111101110111111101110111111111110
1111111111010111111100111110111111111111111111111211112120020122111000111001112111111111111011010101111101111101110111011011101011111111111111111111101111010010
1101111110111101111111111111111111011011101101010111120211122220222200122221110211111110110100101111101111111011101111110111111011110111111011110111101111101111
1111111101111100111101111111111011101101111000011122110101110011102012021220121111111111011111111111011111110101101111111110111010101111011111010111111111011101
1101110111111111110100110111011110111111111101111220122112221012120012211221121200001011111110010001110110101111111111101111010011101101101111111011111100111111
1111111111111110101111110110111100010111111011011111122121101122220212122122210101111110011111111111111111101110111111111101101110111111110111110111111011111110
1111101111101111111111110110111110111011111110110212111011221220220221122210002111101111111111111111111111111011011110111111111111110011110010011100110110111111
1101111101111111111111111111111111111110111111101111120022021212121221212201101210111111111111111001111011111111111111110111111011110111111110101111111111101011
1111011111111101111110001101011111011111101111111002212122101212012212202101002111110111011111101111001101110111110111000111100011011111011111101101101111101111
0111010111111111111111101111010101111111111110111100021012021220210220122211222201111111111101101110111111111011101101011111111111011101111101111111111001111010
1100111110101011011111111111101101101010101101111110111110111110111111111011111110110010110101111111111011110011100011111111001111110111001111011110101111001101
0111101111111111111011111101011111111111111011111111111011110111110111111011101111011110111111111110111100111111111111111111111111111111101110101111111111111111
1101111110111110110111110101011111111111111111111110110110101101010011011101110111110111010110011101111111101011110010101101011110111111110101111111101101110111
1111110111111011111101111111111111111111100001111111111111111011101110111110110101110111011011111111101111110102211121101221220211221012112011111011000111011000
1101011111111110111110111111111111001011110111011111110111110111110111111111101111011011011111101111001111110110111011021111202120010211112211110110111101111111
0110110100101011111111111111101111111101111111111010001001111110111011111110110111111100011111010010111110011112111021221121122212210112121120011011111111110101
0111111010101111111111111111111111011111101111111011010110101110111111101111000011011110111110110212112110201012222222202221222222120212111122111111100101011101
1111111111011001101110011111111111110011112111002221022112221100111021211110111001101101101110111112221120222112212202122001211221111110222112011111111111011111
1011011110111110011111111111111111111111111020211220121112222100110122220111111110111001110111100002101120111221122022222020222211111100112012011110101110111111
1011111111011111111011111110111011001011122202221122101021122221222012110111111101111111111011102122212212212222212221110120020202121122121101111101110011111111
0111111110111011010110110101111111111111110211211121211022101212112222101111001101111111101111102122221202221112002110020020221022222210111221011011111001110011
1011111111110001111111111001111111110111122212120110110111202011210011021111111111111110111010111211221111211202222222010112111120201022222111111111111111100110
1111111111010111111010111111101110111110121111121202110120200100221012221011111101111111011111102211111121102210210211021222220012221221022112010101110111011111
1111101111011111111110101110101111011111101102002022122111001212121022221111101111111111111111101211202100000110221022202221221011210210110120101111111101011111
1100011111111111111100111111111111001111100111111120221121110120112102120111001110111010001011011122012001222021220121202022121221221120221222011101111111011111
1111111101110010111011111111111111111111121221222211111122122212201212211111111101111111110011111111112202011221020122222222201222221212100110000111110111110010
1011010111101101111111011111000111001011102221021212101212aaabbbaaabbbbaaaaaaaaaaaaaaaaaaaaaaaaaaaabbbabbaabbaabbbabbaaabbaaabaabbbbbbabaab221101111111111101101
1101101111111111111011110111011111111111121001020101011001a1112212112120111110011101011101011110111220220021211121212212022221222020211112a210011111111011111110
1111111111110011111111101001111110111111122122122222002021a1211102200122110111101111111001111111221122010011122211022221222212222121121112b102111110011111111111
1111011111111111111110111101111111101111112112111211122100b2020221021000111111110001111111011110221212110101221122221022211122012011210120a011111111101011111110
1011011111111111111111111111111111001111101010201121201221b0010102211112101111100111101101110111112102002112111221222212121122222121112021a222111111101110111111
1101111110111001111111110101111111111111111121121020101222b1002101111210101111110101111101110111002012222212212122111122222011121212121112b111110111110111111111
0101111101111011001100111111111111011111121221012011021222b2012111112210111010111111101111111110120222211111222202222002202120201221112201b112000111111001111111
1111111111111111101110101110111110111111102022022010212212a1122012222021101111110001111111001111211122212112221122222122001202211211012122a112110011101111111111
1111111111001101111010111111011111111110020121102111120122b1112212001111111111111111111111001111222211011001100210211211201022211212020121a102111111100110111000
1111111101010110111111101111111111111101121221221222101012a1120211221111110011110110111111111111122001111221222222221122202121220121112001b222111110111011011111
1111010110010111111111101111011010111111112022122122202211a1201122101022100111111110101111111111121122212122112222222112212220221222210101b110011011101111111111
1111111101111101110011001101101101101011110222211021212112a2222101210010111111101111111111111101211112211102101002221111012022222010121211a011111111010111111101
1111111011101011111001111111101111111111112011122211121212a1111210112021011111111101111110100111221110121221212022020222212021112111221111b202010111111110111111
0111111111111011111111111110110111111111102111102212221110b0221022212021011010001111111101111111012211111211121012011202012111221011011112b111101011111111111011
1111111111111101100111111111111111111111121211202110012200a1020221202122110110111111111110111111012100011222111212222202222222210112211012a202111011011110111110
1101111111100100011101111111111110111111111112202012111211b1222211221211111010111111110011111111102211021111211211210202022222222122222212b211011111111011111111
1110101111100010101001111111011111110110122002111212112211b0112111212122101111011111101001110111221201120122212221022222022022222121100010a102001111101011101110
1111111110101110110111111011001111111100010222221222222012a1221121101121110111111101001110111111121210211121101020202112002222202200222022b222111111111111111110
0101111110110011110101110011111110101111012200220202110112a0000210212111111111111001111101011111112112111222202222221212201120111111111111a110011101001011011111
1111110110111111111111011111100101011110122211021202221221b1210222011110011100111110111011110110111202121000112121201220011111110111011111a101001111111101101111
1111111111111010111101111010110011000111112102001211011200a0200020211222011111111011011011111111211111112122111122120021022010211011110011a111110111101100011111
