89 6
129 113
122 49
126 101
64 67
119 18
56 105
111 104
8 43
26 34

1011111101100111111111011111101111111111111111111011111111111101111101111110111101111110111111101111111111111110111111111111011111111111111111111110111110111110
1111011101101111011111011111010100001110111111111110111011111111101111011011011111111111111111010100011010111111110111111111111110111110111111101111100111100111
1111011111101111101011111111011111111010110111111110101100111111111100011111101011111101111111101111011111111011011111111011111111100001011111101111110110011101
1111100111111011111111011110010111110011111101111101111110111111010111111111111011100011100111011111011011212000212121112010220222222111111111001110111110111111
aaaaaaaaaaaaaaaaaaaaaaaaaaaaaaaaaaaaaaaaaaaaaaaaaaaaaaaaaaaaaaaaaaaaaaaaaaaaaaaaaaaaaaaaaaaaaaaaaaaaaaaabaaabaaabbabbbbbabbabaaabbaaabbaaaaaaaaaaaaaaaaaaaaaaaaa
1111111111111111101111111111111111111010111111111111111111111110011110110111101100100100110011101001111121121111111011211202112022212220011111111101110111110011
1111001111111001110111111000111111111101110111111110101010111111111111111111011111111111111101111011111102221011211102221200210122112011111001111111101100010111
1111111001111111101111110111101111111101101110111011110111110111011011111111111111111101110010111111011011201201222022122212002101022120111111011011110101111001
1101011001111111000111011101111111111101111111111100111011100111110111111101111110111111111111111111111122122112221221121110112100211101111010111110101001111111
aaaaaaaaaaaaaaaaaaaaaaaaaaaaaaaaaaaaaaaaaaaaaaaaaaaaaaaaaaaaaaaaaaaaaaaaaaaaaaaaaaaaaaaaaaaaaaaaaaaaaaaabbbabbaabbbbbbbababbbbababaababaaaaaaaaaaaaaaaaaaaaaaaaa
1100101011111110111101111111110111001011100110111111111011110111111001111111111111111111111111111111111102102221100222211111021022212200111111111101111110010111
1111100011111111111110001110011111111111111111011111111110111010110110100011111110101101111101111011111111111121222001011011121212221221110011011001111011111111
0101111010111110011111110101111011101111011111111111111110100001101111011111101110001011111101110101011102112121110012121022200002202111010011111111101101110110
1111111111111111101101111111111111111111110011101110111110111111110111110110110111111011011111110100011122110221101220222102202101201221001100101110111101001010
1111111111101111111111111001111111111101011110111111111110100010111111011111110101111011101111111110111100022211111022212112112112022201111101111111111110111010
1111110101111111110101010111101111111011111111111111111011111111101111111011111110011111111010111111111122122001021022211021101111120201111111111111111101110010
1101111111111101111001011101101111111111001011011011000100111101111111111011111111111110111110111111111110212121002112010211221021221120111101111011110111111111
1101111111101011111111110100110111111011101001100111011111111111101111111111110111111111111111110111111122121222212022202011120111021221101111011111101111111010
1001111101111101110111111110110110101101111111111110111011101111111101011110110111011111111101111111111101210002222121121012222021012100111111111001111111011111
1111111111121212110201212122212222211112120101110011111111111001011111111111101101111011111110110111101021012122122211011102102121201121110111111101110111111010
1111111101121120200101222112122102211122011011101111111111111110011010111111101110111111111111111111011012222212112222122022012112002021110111111100011111010111
1111111111102121200222101200121210212020110111111111110111111110111110100011111111111111111111110001001121022201222110221101100221122221011101110110111111111011
1111111111002121021211011122222222221121201111111111111110111111111111111011111111011111111011111111111022122121022212111211212102122120111011011111111111111111
1111111110122220022222222022222222221211221010100011101011111111111111111111011111111111111111111110110112101000111121221121211112220111111001111111110110101111
0111011111122102022211011002021102112112211110100110110111111101011101110111111111111111111101001111011001022010011220211012220121210011011111101011101111111101
0111110111112122210100021212222122011221101111010111101100111111111111111101110100111111101111111111101001200021122120222222102111121211110111111111011111101111
1011111011121001200011022010221100010022211111111011111010111111110110111101111110011101111100011111111121122221202121022221122100212121111111111100010111101111
1111111101111112122221121201211122201101000110111101111111111111011110110111111111110111111111100111101120112012100220021210021212000111111111111101111111111011
2202110211122202122212222022122210222200221101111111111110110111111111110110101101111100111001111111111102101211102222102122212201100111111101011101111101111011
2221202202212122212122120121212201012110111111110011111101111111111000001111011011111111011111101111010101211220112221220102221112220011101111011010010010110111
2222112212121222022222212222222110112221211101111111111111111111111111111111111011111110011111111011111122121021201222022211210210211110101001111111010111011111
1222011012222212202202210212022210112000221111111110111111111011001111111011011111101111011000011111101120211222110221211222122221122110111101111011101111111011
1211220102120222200011202022221121211021211111110111111111111111111110110111111111011101101011111111101112101221112221210222221111211020101111110101111111111111
2202112010102212111202201221212110202121121010011101111101101011010111110101011111111111110101101010011121122010010121120222022122211221111111100101111111101111
1222121120102020222002222102121112101222020111011111111011111111011101101111111111111111101111111001111111112002121112101020120002021101121111111011101111111111
0112222022020112222122212220212120100112120111110110111101111111110011111111011111111111111011100111111011111100011211121021221111002212100111111111011110111110
1120212222102222101202220022212222101202120111111110001010011101111110111111111111101011011110110111101111120201121112222101112122220221201101110001011011111111
0221112222210021200212202220222211111211201011011011010111111111110111101001111110110101111110011111111111121202012121221002222120110120011101101110101101001111
bbaaaabbabababbabbbbbabbbaababbbbbaabbaabbaaaaaaaaaaaaaaaaaaa111111111001011111001111110101111110111111111120101212221212111221101101222201111101001111111111011
122020221210221222021222200220221120012212101101011111011110a101011110110111111111111111101011011111011001122221121011211102122100022221210111011110011110111111
221112221012222021221001212211210221021011111110111111111111a111111111010111101111111101111110101111110011122021022021211210212112222220001111111011111101111111
220112021102202021101212022212101112020022111111011111111111a1010110111111101110aaaaaaaaaaaaaaaaaaaaaaaaaaaaaaaaabaabbbba220112012202112211111011111111111111111
202011110120212200122222222020222121011102110101101111011111a1111111111111111010a111111100011111110111110011122111222011a101200022122012211111111110111101111001
211120212221002002222122122212020022110212101111111111010111a1110111010110111101a101001111111011111111101112110212212010b120122112201221221110111101111111111111
102112222212222012222122102212201211021221111111111110110110a1111111001100101011a111001111111111101111111010021211211022b110110121211222111001101011111110110111
122022122222012212221212220022222100121212011111100111111001a1011111010101111101a101111111111111111111101112101010021020b112001221120211200111010011111010011111
211212120122012220221022212121120021222122110111011011111111a1111111111111010101a011111010111111101101111112210102102011a211222222022112020111111100101010111111
100212222112222022012021121222022112221110110110111101110111a1111110111111111111a011111011111001111100111110202221122220b112121012212122121111111111111010111111
120210100112221202021222121200211111012222111101110011111101a1011101111011111111a111110101100101011101101101002021220120a120021202120210220111111101101111111010
022121022112212221102201020202102222020012111110000011100100a1111110011110111011a111110011110011111011111112111212201222a022220102021210221111111110101011111101
202112102012122212012011011212111111111111111111111111101111a1111101110111111111a001011011111010111100111101212021122122a201111212112110101101111111101010111001
002122111111012221222012122010211010111111111110111110111111a1111111111111110111a111111111101111111111111101121101122101a211202111111121011111011111110111010111
220002102022111221210102212021211111001111011111122221221202a1022201102210111201a111101111111010110111101011210212110021b220212122111111111101011111111111110111
221211121121220212210211212011211111111101011111000121022110b2212122112112111221a111001111111111111110111112002000211121a002102012212210101111101011111011011111
212121122100212100211012110201111111111101111111122012112220b1112210222122012121a111111111111110011111111112021221011002b111012212022212111111111101111110011111
121020211002222020021222022120011111111011111111120122121201b0120222112112111121a111101111101111101010011111112021220221a001112220022221111111111101111101110010
210201102111121210202002120101211111111111101110120222112011b2122112111112211121a101111111111011101111101111010221011222a221211211021012200111111010010111010111
111222222120222222021201112222111111111110110111110211102221a1102120012110122211a111111101111111011000110111212220200212a222220211102222101110111111110111101111
212222112112211122112101211101101110111101110110120222212121b2202122202011021110a011011111111101011011111111112122221121b021211121111122111011111110101111110111
111111111101101111101000110011101111011011111111112121021121a1002112200201112212a111101110111111110110011111111220222220a110202210210121120110110110101111111111
111110111111111111111111111111111101111111110111011212211010a0112021022000122122a110111100101111001100101112222222212121b112122222021022101111111111011011011111
111001111110111011110111011111111011111110011111100021121120a1011220111212122012a1111011101111111111aaaaaaabbbbbaababbabb200202202202211221110110111111011110110
111111101101111111110111110101101111111011111111102211202212a0212100102110101011a1111111111111111111a11101122212001110022022121212022211110111011011111011100111
110111110111111111111101011111110111011111111111121222211120a1121002202022011212a1111111110011111111a11111100221122111112101212022111220211110111111111111111111
111111111111100100111111010101100111111110111111121112111212a2102222111210222211a1111011111011111010a01110111111121212101011221221212122211001111111110010011111
111111111111111101110111011110111111101101111111112112221111b1221202021222121001a1111111110011101111a10110111010001111011111101111001101010111110011111110101011
111111111001111100110110101111111111101101111011122001101202a2122221212121210221a0111111111011111111a11111110111111111101110111110101101111101101111111011111111
111011011011111011111110111011111011011111011111102011110202b1112022121212202020a1111111111111101011a11001010010001111111101111111011101101101111101111111011110
111111110101101111011110110111111011111111111110101022102212a1110211202020120200a1111111111110011111a11111001110110111111111111010111101111110011111111011011101
101010111111111111101111111011111101110110011111111112202020a2211112211022102112a0001010111111101001a11111110111011111111111101111110100011101101011111111111111
111111110101111111111110011111111101111111111111000010212102b0222220202111220122a1110101111111101111a10110111011111111101011011111111111111101111101110110011110
111111111100111111111001101111111111000111111011020212111221a2020102202111222112a1110011111010111111a11111111111011111100111011111111011111010111111111111111011
111111111101011111011111111111111100111111111011101121000121b1010202212211102110a1110111101011110111a11110111111011011111111111111011011101100100101010011110001
101110111111110111111101110111110110110111111000111011212212a2121221211210102200a1101101111111011111a11111111111111111111011111011011111110101111110111111111111
111101111101101111111111101111011111111111111011111210021222a1122212122102202210a1111101111111111101a11100011111101111011111110111101111111111110111110101111110
110111011111101111011111111011111111011111111011110220121210b0111022121221112201a1111101111110101111a11111110111110011110110111100011101101111011111111111111111
110011011101101111011111111110111111110111110011112222010012b2222222112102121112a1101111101111011111a11111110001111111111101100111101111111010110111100111111110
111011101011111011111111011111011111111111111110122221212111a2121222121122121211a1110111111100111011a11011111111110011111111111111111011011111101111111001111101
aaaaaaaaaaaaaaaaaaaaaaaaaaaaaaaaaaaaaaaaaaaaaaaaaaabbaaaabbba1101220210122222021a1111101111101110111a10111101111011101011001110111111111111111111110101010111101
10101111110111101011111011111101111111111111101112121202202102121222202211210102a1111111110011111011a11011111110111111111111110011110011001111011110111110111101
11111011111101101111001111111111111010111111111010010122221220111221111111212101a1101001101111010111a11110011111111111111111001101110111111101111111111111101111
01101011111111111111111110011110111111001111111101220202220212221121122202212220a1001101011111101111a10110111111111111011101111111111010110110101111111101011111
11111111111111001110101101110011111111111111011111021121011120101112021200010221a1101111111111111111a11110110111101011110110100111111111111111011111111110110110
01111111111111110101111111111111111111010110011111111111111101111111111010111001a0111110111101101100a11111011111110111110110111111110011011111111111111111111111
00111110011111111101111111011111100101111111111111111110111111111001100011011011a1111100111011111111a11111111001111101011111100110010100111111110011110111101011
11111110110101101111111111111110110001110111001010110011110111101111111111100111a1111110111111111111a11111101110111011111100111111111101111111111111111111011111
11010101111111111110111110101111111111111111101111011111111111111111101001011111a1011001111111111111a11111101012211022022112101221020122102212100111110100111101
11111111111111111011111111011111111111111111101101101111111111101111111001111011a1111111101011110111a11111111110221202112220002112111101221110110111010110011111
10111111011010111111111111111111110111111111011111111111111110111111111011101110a1111111111111010111a11111001111211112222101212122022021002212101111111101110000
10111111101111111011011111111111101011011011111011111101101111101101111101111111a1111111111110112112b10222102122012222202102221021200021212122111110110010111111
11111111111111111110111111111111111011111112220200011200200222211112212111101101a0111100101110111220a22220110112221201222222021212222220200222001110101111111111
11111001010011001101111111111111011111111122122112212002111010122112021011101111a1011101011010100102b12111021010221220222021210212111221110100111110111011110111
01111011111111110101010111110111110011110121012121112011100101112200211211110111a1111000111011111211a10010211112221022222202222021100221121212111110101111111111
10111001011111011011111011011011011111011211111210202022220121112112101211111111a1111111111111110111b22021111112122220120221112221022021122012101111110111001111
11111100111111111110111111101101111011011010221102001100102111011100120011110111a1111111111100110221a12222001210220012222202210112021201222211111111111111011110
11101111111101001111111011101110101111110211222011100122112111210121202111101010a1111111110111011221a20112112122210222222202211010120212111022111101111011110110
11011001011001111110101011111111011101101121200122200021212201120111101110111010a0111111100111112222b02201120012221212022220202111212201200201111111111101010110
11111100111110101101111111101111011101111221121202000012022102122101121111111110a1111110111101102021a21222121120211222212222212221102221122111111101101111011101
11110101111011111111111100111101111111011012201010122221211102111202112211111111a1111110111111111102b20012021212202221110022202210210211101211011101111111110111
01101111111111111011111111111111111110111111102122202100221211112221220111111111a1110011111111112221b10121111112201222202100202100112120002212111111111111111110
10011111001100100110100111011110010110111211002100212212020221111211201011111111a0101101111111111221a11211112212222222022222220212111021222202100111101111111111
aaaaaaaaaaaaaaaaaaaaaaaaaaaaaaaaaaaaaaaaabbaabbabbabbabababbbbbbbababbbaaaaaaaaaa0110111111111100202b10120102002212222021200201211221021012011111011111101111111
1001110110011111111111001111110111011111111220002112212111021012111121220111111101111111100011112212b21001112211112011122122222121110212111220000011111111011101
1101111011111011011111111111101111111111110022120101001202212112220202111111011111011111100111102100b11000020122212120000222222011010211221002101101100111111110
0111011011011111111101011111101110111111121112212020021121110111110121111110000111111111011111112021a22111222222202222222221101120202112011220111111111111111101
1101101101111101101111111111111111011110121212111011202212211110212111101111111110101111111111110212a11020012100222222222112220201210122021012001111111010100101
0110010111111111110001110111111111101111110112100222012101221121112222211101110111101111110110101120b21112020212222212212222012111120220121111101111111111111001
1100111111111101110111111111111011110100122110201122120121212020210200101011111111101111111011101121b22111222222212222221111120010110011221220111101011110111111
1111111011101101111101111110111111010111112212202120111012212220201220121111111110111011111111110212a21211111110222121221102022112120120102122111111011011111011
1101111110111110100111001100111011101111122210112221222101001221102221201111111110110111111110101101b21022112121121212222222222012110222121102011011011111110111
1101111110110111111111010110011110101111121122111101121112121022001012121101111111111101011011000021a11202212202121222212002121221122122202121111110111111111101
1001110010010011101111111111111110011111021212101221011021022120002202200101111110111111111111111222b10022222102202020212220202211121102120012111011011111110111
1111111111111111011111111101111110111111111122121101102211222211111021121011011101101111111001000102b01101112221202201002220221222001211122020110111111111101111
1111101110111101110011111111111111111101022112100212021011101111020222221110111101101111111111012221b20121112102022220222222212002111120122212011101111011101001
0111111111111111111101111111111011111110012211212111110212211201222221221111111111101110111110102102a12011212122120201200022202222112102002101111010111111101101
1110101111110111111111111111111011111111121211222122012121200122222122220111100011111110100111011221a02111200222202112010122012102111201211201111111111111111101
1111111111101011011111111111110111011111121121111111201120012120002021111011111100111101111111101221b21202110212222122222202022222121210212011111111111110011111
1111011111011110111100010111111111110011111110221120112121211021112122121111101111111111110110112221a21111022211121011110222120010101111101111100111011111101011
1111111011111101111111110100111011110101122002022111201212220201122221011111101110110110011111102011a12201210122222111211212022111011111011110111101111111110010
1011010111111001101111111111101111111010122120102120120100212120021222101101111110001111100001111001a02022122111102002200120212101001110110011101011001111110101
