142 45
17 105
122 49
126 101
64 67
119 18
56 105
111 104
8 43
26 34

0110111111111010101111111111111111110011a011101111011111111a1110111111111011111101111101001111111000111111111011111111111111111111111110101111110111111011001100
0001111100111111101011111101111111010111a111111111111011111a0111111100111111111011111011011001111111011101111111111011101111111111111010111111011111111111100111
0111110111111101110111111011001111110110a110111100101100011a1101111110111111010111111111111100111011111101110011011111111111110111111111111111001110011111100101
1110111110111110101101011111101101110011a111110101101110111a1111111111000101111001011110111111111110110101122112221001210121201122221221111100111111101111110111
1111111111000111011011110110101111111111a110101101111111111a1111111111111110111111111111111111100100110100022100021211112202222212212111111110111001010111110111
1110111111111111011110111111111101001010a111111101010101011a1111110101111111111110101011111111011011111110112212112111122020012111222201110111011111111111011111
1111110011011111111111111011111111111010a011111101111101111a1011011001110111110110100101110111111111010022222001221100022222100002121020101111111111111111110111
0111010110111011111111101111111111111111a110111111101110111aaaaaaaaaaaaaaaaaaaaaaaaaaaaaaaaaaaaaaaaa010110211112101212122122121121122121111010011110101011001111
0011111101011101111110111011111111110111a1111111011100110111111111101111111111010111111111111111111a111111012211012211121111222222210121111111111101111111111001
1111011111101011111111111110111111111100a0100111101111111110111111111101101101111101110011111111111a111112111011112112111222022021211211000111111101111111111011
1101001111011111111011111111111111111111a0011001110011010010111011111111011011011111010111111111101a111001121211202110112212020102112021101110001011011111111111
1001111011111001110011110110111110111111a1111111111111101101101110011110011111101101111110101111011a110111112111121202220122000111011221011111100111011011111010
1111111110111101010111111111111011111111a1111111101101111110111111111111011101011111110110111001001a110001101012111201011100201211110021110111111111101011011111
1010111111101110111111111010111111101101a1111101111111111010111111100101111111111100011111101111111a111102222111021122122021221212211201111110011001111111111011
1110011101111110111111111110110110111111a1101111111111111010011111110111000111100111110011011110111a101100111201221112102022100122011011111111111111110111111111
1111111111011111111110111011100111011111a0111111111111101111101010011111111111110111010110111111111a111101222210111001110222010022121111111111100110110110111111
0111010111001111101100111111011011110110a1111111101111111111111011111111110111111111111101101101111a111112112102011012020211101102222111110011111111010111111111
1111011110011111111010111111111111101111a1111111111110010111110101111111111101101111101111101000111a011112212211211220211211022221012211011111111101110111111110
1111011111111101111110111110111011111111a1110111111111111111001111011111111111110101111110111111110a111112021100111021120101221221210121111100111011111111111101
1111111111122221021222222212112122211002a2101110111111011110110111111111001111111110110111011111111a111112212110112102212110220020101011111011011010110110011111
1111110111112121111112112121021110221220b1011001010111110111101000111111111111111111111111111111111a111121002012112221201111110212221221111111110111111110100110
1011111111021112210211220222212222111111a0110100111111111111011011111111111111100011101111011101111a101102122111022122110202121210111111111111011110111011111110
1111110111112211121222121122120012222212b2101011110111011101111110110101111110110110111101101111011a001011112121201222021220112011012120110101101111111101111001
0111111111112211022112122222012022211020a2111111110101011001011111111111100111110111111101111110111a110101120121112012110212222112010101111011111111111111111001
0111010111100012210011110212220201200022b1111011110111100101111111101010111111000111111111111111110a101112111100212200121001221112012220011110110000111110111100
1010110111121101121102121222011011101122b1111111011111111111111111001111101111001001111111111111111a111102020201112202000122122211011211010011111111111101101011
1001001111102022021210221211222002121212a1111111110111111111111111011101111110111111111111111111111a111120011001101221122112210211121221111011110111111101111001
0011111111122100210122021200001211120122b2100111111101011111110111100011110111110111001011111111110aaaaaababaaaabaabbabbabbabababbabbbbaaaaaaaaaaaaaaaaaaaaaaaaa
2112221022220222222122212222112012122011a21101011101111111101100111100110011111111111111011111111000101112010121101022221100121120122211101011011111010111111111
1121222121121221021201222022102012101120a11011011111111101111111110111011110100111010011111111111001101122112110112202110021121101211120111111110111101111111111
2111111112220102222221012212201000112111a00011110011011110010111111010111001111111101111011111111111111111011021212111121011121111221210111111011111011101111100
2211100120112212212202022221201111121021a21111111111101100111111111111110011111110101011101111111110111111121012211212211012111112120221111111111110110111111101
1110222122202212220222222220202111211120a21011111111111110110101111111111111111111011010101110101101110022100112211211112112100122101211111011101111111011100111
1201221021020222022222221222222121002212b21111101111111111111111111111101101111101111111111111101000111012121022102020100110112221211021111111110111011110100111
2112222020022221122222220222222122212221a01111111011111111011011011111111111110110111111010011111010110111121211102200210211220121212021221110110111111111111111
1212011021212112200221122222200220211111b11111111111111111101011110110111011110111001110110111110011110011001000020202201221122111122222211111111101111101011111
1210210201221222011120222122020112012120b21111101111111111111111111111111101111110111101111111111000111110121101011221022222122202012222111111111111011110111101
1211210211120222102212010220221011201212a11111101101011110111111100011111111111110111101101111011111111111120010112221221110100111202112111010111111111011111011
2122210211011012222221020100221112212210a10111111011111101111011111100101110111111111011111111111111011111120112211111221112211211222221211111111111111010111001
2111222222221210212212022222222100122101a2111111111011111111111aaaaaaaaaaaaaaaaaaaaaaaaaaaaaaaaaaaaaaaaa01121022112021212121000212020011021110111101011101111010
0221011112122120222222120201222221020020b1111111011111111111101a110111111110111110111111111111101111111a11121121212201111212221022110002121111111111011101110111
2102110021221221221220222022222212111102a1101111111101101111111a101011111111110111111011011111110111011a01111220012201110202211221211021110001011111111101111000
2202220122122212022122222121222201220101a1111111111111111111101a111011100111100110111110111101111111111a11002111200211112120210112010022121110111101111111110111
1201202201121222222222210102220100102211a1111011110101011111111a111001011100101101111111110111010101101a11012201121222212212012121212120121111111111111111101111
0111212211022222221121221202222120221120b2001111110111111010101a111100011110111101110011101011101111011a10110212112011021022012110101211121010111100011111111110
1211101102011022212021122012201220111202b2111110111011111111101a111111100111110111011011111011111111111a11111202012221122112102001121011111100011111001111101111
1121222102022022202212222122222212010212b2101110111111001110111a110011111111011111111111101101011110111a01111110010020111212212000211222220111111011110111011111
2120210022102222122122122201201221202110b1111101111111110111011a111110011111111101011111110111101111111a10002121112212221210221121102202011110010111001111111111
1222022012122222212222212222222012202221a0111010111011101111111a101111110110111111111111110001111010111a11112202101112110221221112112200211101001110111111101111
0122212220220200222112022202222000221121a1111010111111111011001a110111110011001011101111111111001111111a01111001212112110221202121022121121111111110100111110111
1110021122112111121100102111222011101011a1001011011111110111001a111011111111111111111111101101011001101a11120122112101221121121111120221111011000011101011001111
1220212201221221121211111000002111100111a1111111111111101111011a111111111101011110101101111111111111111a10121221011120101000020021101221210111110101111111011011
0022221210022122122001222111110111111111a1111101122110221121111a222022210200122111111010111110111111111a11122110220122101102021220112122211100111101111110001111
1222102111010212220102020001100111011011a1001110100222221121011b020221121220112211111110111111111111011a11121101111000100221211211122011221101100111111111001111
0110020111002221112011122010112010101111a1111110122102121221022a102002020222122211001111110011010011111a11122111211110122222221022002221211111110111111111111111
2102202122022120212111222111221111011111a1101101121210211201211a010222021222000201110111111111101110010a11122210112222212222222222121120211111111110111111111111
2111212110021111210202020022221011111010a1110111121212112110110b221122221020221110111100001110011111111a11121011211120010111022122102111121111011111111111111111
2111222211020101221212112101120110111101a1001000122211222111210a220121012101200011110111011101111101111a11122202102210221112212021121102211111111011111001110111
1111022221222202120211222122211111111111a1011111121221100001020a212212121112020011100111111111001111111a11022211022112212000211220212221221110111111110110010011
0110111101111111011111111111111111111111a1111111122002101000121a211212221121221010111011011101111101111aaaaaaaaaabbbaaabaabaabbbbaabbaabbaaaaaaaaaaaaaaaaaaaaaaa
1100111111111111011111111101111101111111a1111111002211222221022a201110100102110011111011110111101111111111022012101210121110201102112122211011111011111111011101
1111110101110101111111001111011111111110a0011101110021100121221a011112011201010111110110101011111000110111021220102211112112012101211112121110110111011101111111
1111111111111111111111001011111101001111a1110111122020002211222a222121201012212211111011110111111111111111111010222121201212212101221011211111011111101111111111
0101101111111001111001110110110111111110a1111111111212222210210b112122121000121111111010111110011011111111120200122100021110020212221201221011111001111111110100
1111111111111110110101011111101111001111a1101111121011211020012a110122112211120211111111011111111111110111121221021210222212021202112021220110111111101101111011
1111001101110111111101101111111111011010a1111111102222021022102a022120220201111210011011110101011111011111001111110111011111101111011111111111110110111111111011
1111111111111111110110111111111011011111a1011111111212111110120a120212222012221111111111111110111111111111101111101111111011111101111011111011111011111010111001
1111011110111010111111011111111111011111a1111110122220111012112b020222121012121211110101011011111101101111111111100011111011111111111101111110111111101111111111
1111111100111011111111111111101110110111a1111101121102111220110b121212211021121111011110011111111011111111011111011111101111110111111011111110110111011111111111
1011111111111011101110111011101111111111a1101101120011221110010a221212122202222201111110110111001111111111111111111111111010101111101010111111111111110111011111
0110111010101011110101110011111111101111a1111110120120110211212a112122121011221211111111110110110111111111111111011111111110101101011101101111100101111111110111
0111111101111111111111110111011110111111a1101101110212211121211b212201001121211211101011111011011111011101111101111101111100111111111101101111111100011110110111
1011011111111111001010111001101101111111a0111111110221222100201a122121222122111211101111110111111110111111111011111111111111111111111111111101111111111101011111
1101111011011111011111010111111101011111a1111110102102211111011b012211121212021111100111111111111101100011011111101111011111111110011111110100011011111111111111
1111101111110011111111111111101111111111a1011111102222112012012a100211210102212111111111111111111111111010111011110101111010111111111111111111111110111100111111
1111111011101011111111110111111111110011a1111111112220201212122b112222102221112111011111111111111111111111111101101111100111111111011111011111101011111011111111
1110111111111011011111011111111100101011a1011000101212212211111b210211212121212100101011111101111101101111111111111111111111111111111111101111001101111111111101
1111111010101111111111111100111111011101a1011111121222112121111b101212202001220101101100011111111111111010011111110111111111111111111111111111110111001111111011
aaaaaaaaaaaaaaaaaaaaaaaaaaaaaaaaaaaaaaaaa1100101002202211211121a010222021102021111110111111110101000111111101000001011010111111111111110110111001100011111111001
111001001101011110111111111011111101001110111100021022200010202b121022201101212aaaaaaaaaaaaaaaaaaaaaaaaaaaaaaaaaaaaaaaaaaaaaaaaaaaaaaaaaaaaaaaaaaaaaaaaaaaaaaaaa
110111011010111010110111011111001101111110101011121222221122222a022222122002220a10011011111111001101111111101111101111111111111110111110101010010111100111101111
111111111110101110011011101111111011011001101111112121101221222a122122121012221b10111101111101100101111101011111111110111111110111011111110011101111110001111111
110110011111001111100111111111111111111010101111100020211122220b102022101121200a10111111111111111011101011111111011111111101110111111111010111011111110111101011
011101111011111101111110111011111001111111110011111111111001110a111111111111110a01110110111010111100111011111101111111111001011101111111101011111000111111111010
111010111111111101110111111111011111111111101011011101111110110a101100111101011a11111111101111111111111011111111110110111111011110111111111111111011111111101111
111111111111111111100111111101111011111011111110111111111111101a101100111001111a11111011011111111011001101010111011111111100111101011111101111111011110111011111
011111100110111111111011110100000011110111111111111111111111111a111111111011111a11111111111111101111110111100002221011212200211222201022202220111111011111101111
111110101010110111110110100101000111111110111111111111101111111a111111111001101a11110101111111111000111111101111122010222200111220001111221111011011111011101111
101111001111111111111011110110111111111111011111111010111010110a111011011111101a11111111101001010111111110110111021112122011211100001202112222011111011101110110
111111111111111100110111011110111111111111111011111111110110110a111011111111111a11111111111111111002201101222122122002222202212221101001220100001111111110011111
101111111111111011101110011111010111110101112021102002211121121b211110021111111a11101100111111101021101221111112012220222122211012122201121212011110111101100001
111011111111100111111101111111111111111112010111100102211100210a122212021110110a11111101111101011121002111110120221102221211221111122211101112111100011111011111
111111111011111011110111011111111111111112110021121121012222212a120012011101111a01110111111100111112112000122202002220202022202210120120012222111111111101110111
110110111110010111111011110111111111111101121111222111012221102a111221121111111a11111111011101111200022222110022202220210202221221101221110120011111111101111111
111111011110111111111110111110011111111112110022110121202112122a011211121111110a11101111111111112202221122222022102221221220121102112122222211111110110011101011
111111110110110011111111101110111101101112212102100220121212011b120212211111011a11011011101110111121221221112122222122202102210121111201111021111100101011111011
100111101111110011111111111110111011011111102222121022201022210a121111021011111a11110111011101111201210012122122222120222222212102211020210022110111110111011111
111111111011111111111111110110010101111111110110202211111121022a220212100111001a11111111110111111110022112022212002212122200221212100112110121111110111101111111
110011011001111101010111111111111111111111112111201120212102111b102212121111111a11111101101111112001120222100122012112022210112102002122120222101110010111101011
111110011111101101101111011101111111101111221001201221110121212a112101200111111a11111111110110112110111122222111222222210122221211120001211222100111111111101100
111111011111111111111111111011111111010012002101212221012112222a121121210000000a11111111101111112012222102111102202222222221212022112221111222111110111111110111
001101101011110111010111010111110111111112101121001212211222021a121222201111011a11011100111111102201211011012102012002002221122222102110212102110111100111101111
111111100111111111111111100011111010111102220012120212210201121b010111210111111a01111111111011111210202011100121220222222200202102112110222102111111011110110111
111111100111110111111001110111011111011111122212002020121202202a112211000111101a11111111111111110212111002111210200221202222122221020222021110011111111111111110
111101011011111011101101101101101111111112222221212111120212201b101222101011111a01111111111111112102122201212212200022112022222122001002112121111011111111110111
011001011101111111111111111001101111101112220020010211211120200a002211220111111a01101001011111111222121011211211112222112202222001111112112111111111111011111111
010111111010111111111111010110110111111012112110112012002222021a111221021111111a11110111100111110002110122101012222222222112222122012211101112111111111111011011
111111001101111111111111110011011110001101121111221022101221220a122100121111011a11101110111101112111211022111110020101221101222221211022012121111011101111111111
111111111110101011111101111111110110111101111210111212222120120a022122110011101a11001110001111010212201121020120012122020220221220122222020211101110111001111011
011111111111110110111111001110011101101111022121121202102110212a222120120111000a11000111110011110222112222111222021020222221220022001111201112111101111110111111
011111010111111011111110111011111101110101022101010112112021110a211021221111111a01111011111011101012212121220022221220221020102022122222210001111111100011011111
111111111111111011110110101110111111111111001221111112001221202b211112011110111a11001111111011112002111111220112222212000022222002211222112020111101111011111111
101111111111101101111111101011011111111102210212212111200012110b012222101111111a01111111101110111202112010102212210011212022202222022222212120001111111101111011
011111111101111111011110111100101111111110101111212022022222221b220212121011101a11111110011111111112112202221211122122112020200202210101122121111011101111111011
110111110111110101111010110111111111101111010111211110122211221b120121101001111a11011011111111112102122212121111022220120022122110112022202122110110111110110011
101101011001111101111111111011110111111111011212212120221121202b212211211101110a11100010101111110221121221000121122122220211110210220022212021111111011110111111
111111111011111101011111111111111000111111011121022120011100222b221111220111110a11011111111111111112021220101222201122221220222221221011021111111011111101111101
100101111111101110111111111101111111010102110102122121100011021a201212121111001a01111111111100112020211121022012022120021211122111101111111011111111111111011111
111010111101110111111111111011111111001111211210201201011001122a212022001101111a11111111111111112212101121121222110112102122112101111101110100111101101111111010
111111111111111011001111101111101100101110110021010220201211201a222120221111111a01110011110111111112211010222210211221121122111001111011110101110011111101101011
