101 110
139 3
122 49
126 101
64 67
119 18
56 105
111 104
8 43
26 34

11011101111001111111111111111011111110111100111111111101111111011a11111111111111a1110111111110110110101111110111110110111011101010111110011111111011110010101010
11101111101011101100011111111111110110011111101111111111111111101a11111001010011a1011111111111110010110111111011111110111111111111011111011111111111111111111111
00100111111011111111110111111011010111101111111111101111111111111a11011001111011a1110011111011111111011011001111101101111111111111111111110111111101111011111011
11011011011111111111111101111111111111101111111110111111100101111a11110111111111a1011011011101010111101112222122202012202212222221111221111P11011011100011011101
11011000111111111111011111101101011110101101111110011111110001111a11110111111110a1111111111011101011110011212011011010012212102100221111010P10111111111110101111
01111110101101101111111111111111110111111111111111110101101111111a11011111011111a1111101101011110111111002012002202022110111120111001211101P11111110111111111111
11111110111011111111111011111001111010100111111111011111111111111a11011110111111a0110111111001111101110111221211200100010001102012122201100P11111101111110111111
11101011101110111010111100111110010111101111101001110001011111111a11011111111101a0101010011011111100101121120211000202221202122121210121111P00111001001101111011
aaaaaaaaaaaaaaaaaaaaaaaaaaaaaaaaaaaaaaaaa011001111001011111111111a11111111101110a0100111111101110001110120012201112201200112112202102211110P11111101110110111111
0111111101111111011111110111111111111111a111111110000111011011011a11110101011111a11100111101101110011011111110211211012aPPPPPPPPPPPPPPPPPPPaaaaaaaaaaaaaaaaaaaaa
1111111110111111111100011011011111111010a111110011111110010111111a11011101111111a11110101111011011111111021221112121011P1110212121020111000100110110101011111111
1101111110111100110011111111111100111111a111011111011111011111110a11110111111111a01111101111111111110010012021022021212P1020212112222211111111101111111111111111
1111110101111101101111111111111111011111a111111111001111111111101a11110011110111a11111111111011111110101221121222121211P2120201102121011010111111011011110011111
1111110111101011011111100111101111001011a110111010100010110111111a11111111111101a11111101111011001010011221222222022002P1222112222210201100111011011111011110111
0011111011111010011101010100101011111110a001011111111111111111111a01011111011101a11111100111111110111101221211222212121P1111020020010221111011101111111110100111
1111011111101110101111111110111101111011a101110101111111111111011a11011110110111a01111100111111110111111201112010121121P2111120110212011111111111111111111111011
0111111110110111011111111111100111111101a111111011011100110111101a11010011101110a11111011101111110111111221122011021202P2112102121112221101101011110111101011110
0111101111111111101101001011101111111111a101110100100111111011111a11001011111110a11110011100110111011011210212020122200P0122202121020110100101111111101111111011
1111111111111111011110111100111111111111a100111111111111110011101a11101011110111a11111101100101111110111102021221122121P1121110122221110001110111111101011111111
1111111111020110111121222221212111201202a001111100111011101111011a11111111111001a11111101011111111100111211111101120202P2122100102121010101111011111111111111110
0111111111102220111021212121120122212111b111111011011101111111110a11110011111111a11111010101111111111111222102111222222P1001222122112121111100110111111110011110
1010111011121100210101101102111222222021b211111111001111111111111a11111111111101a01101111101011011011101120211100220112P2112202212121011111111111111101111111101
1111111111122122111201101200101120121221a111011111011111010111111a01011111111011a01010111110111110111001110122222120111P0111212121112111110111110110110111111111
1111110111121020111220020211222122222101a210111101111111011101011a10011111111111a01110110011111111111011101220211212222P1121001120202210111001111110110110011110
1111111010102100001011212201001121211211b201111011111110110111111a00111011011111a11010100111111111111110120110202221221P2220220012111221010100111011111110111111
1110111011121121011120111102121222012122a111101111011111011111011a11111011110111a10110011010111111011111012221122112211P2111221212202221111011111111111111111110
1111111101122222012210222221221022112220b111111101111110111111111a11111111111111a11110011101111111111101112022201112122P2212220202202010111111111111111101001100
1111110000111010012112211112120012202211b011101001011110111111111a11100011111111a11111111111111110111111122222012111210P2212021111212211111111111011110111111110
1122122100120221211202122202112212111211a010101111111111111111010a11111111101111a11111111110111101111011012021222121210P2120021122202121111110111101111110111011
2111021201111212112221002022220202022120a111100110111110111101110a11011111001110a10011101100011010111011011102111002001aPPPPPPPPPPPPPPPPPPPa10011111111111101110
0112121121022012222122122222122101111012a211011111110011110110101a11001100110111a1110111111111111111111111001002011122121012002022112110111P01111111111111100011
0102022212212200022221001012222112212201b100111001110111010000111a11111101110111a1111111111111001011111110212102022112122122111121222111111P11101111111111111111
1212211111122121220112020211022120220222b110111111111010011101111a11011111111111a1101111011101111111011121021112100022012212020212122211110P10011111111110111111
0220000202202022102222220210220101101110b210111111110111111011101a11110010111101a1110111111111111111111120211221120101021220212222221011011P01110111111011101111
0210022111211020002002210200220121021022b111111110111110110110111a11111101110111a1101111101111111111110111111210212122102202001110001221110P00101111010111111011
0221001122120220022210210212201221211112a111101011111111011111111a00101101111101a1111111111111011111111001012112222212101010222022111112211P01111110111111011111
2122121211122021202222212021202222211222a011111111111111101100111a11111111111111a1111101111111100101101111110102222110112112110110112211111P11001110101011111110
1021111120202222122202001002221212221221b110100111111111111011111a11111101111111a1111011111111111101111100122210101121122221112211110212211P01111111111100101111
1111120221122221222112120222222222201222a111110111111111111110001a11101111110111a1011110111111100111111111110102100102021111111021012212210P11111111111111010111
2211022210112210010122221202211212102102a111111110111111111111011a11111111111110a0110111111011101110000110111100110122210011122012211212120P11111111111111000110
1110011222112022222221221220200022222200b111011111110111001111111a01111111111011a0101111111111011111011111002011022211120122022220102111021P11101111111011110111
1101022101212121222012211220220121212211a211110111110111101111011a01010110101111a1111110111110100111111111111121211121120222222010221211111P11100110101111011110
0120222022012220122201222120201202110110a111111101011111001011101a10111011111101a1111110111111111101111111020201202221111202120122121121121P11111111111101110111
2110201220221222122222121012221201211121a210110111111101111111110a00011111111111a1111110110111111011111110112221221212211112222222120202111P11111111011111011111
1221110111011200021212222222222201221210b211110111101110111011101a01111101111111a0111111111111111011111111101111221222112212121012012022121P11111010101111111111
2101102020122122112220222212202222012012b001111111001011001011101a11111111111111a1111011010111011111110111102120210221211022011010212120221P11011111111010111111
2112222202102220221012220022110001201110b211111111111001111011111a11110111100111a1111111111111011111111111110021120112122111101211121101121P10111111111111110110
1011222221220222212101022102222120210111b111111111100011111111111a11101111111111a1101100111111111111111111021021222121210002112120202000211P01011011111111111100
aabbaaabababbbababbbbbbabababbbbbbbaaaaab200111111101111101111100a11111111011011a1111111110110011011101011012011102211211221222122212212111P01001111011110111111
11012002022222212212222222222222002221222111110110111111111101111a11111111011110a1111111110111111111111111011112210211112202010221211211011Paaaaaaaaaaaaaaaaaaaa
00102210202110012212202221120001111111111111110110111111111111011a11111101011101a0111111011011111111111111122112102120122022101112210202110P01111111011011111110
20121122121012121110002111121111111011111001101101111110111111111a11000111111111a110000111110111111111111112122120112110212122122111111211P000101101111110111111
01222110121121212111222211212100111111111111101010111022121010122a10122111202111a101001111011011001111010111210221000122211211222020222011P111111111001011111111
02111220111011222222112101112111111111111111101111002120212122212b12201122211212a101111111111011101111101010121221121101121002220112011102P011101111110111110101
20112111102122121222101212221211101111110111111112122111110110122a22102220021111a111011101111110110100010011102011121220211222100121111110P011101101111110011011
21021211201011222102200012211121111111111111111111122020112211001a21211211222102a1111111110011111111111110121101221022102110211222211210221P11011111111111011111
10122212012122012210111022110121011111011101111112222222000111022a10112200001112a1011011111111011111110010112121022202212201011222212202010P11111111111110110111
20120121020111121122020212112201110110111101011112020122021021002a12122221212221a111111101001011111111111101220111101212211011221112211102P111010110111111111101
12112212122210201011222210011221111111111111111111112212212121111b11111100202222a011111110111111110111111100201021212110122202111021202212P111110111110111011111
11111011110111101110111110011101001111101111101111221221221120221a11210122120222a110111101111111011111011111221220211102112111122111101212P110011110111111010111
11101101111111101101111110010011111101111111011112112221112112212a21222220012000a110011111110111100011110111210100011121211021011100122111P111101011111111111100
01110111111111111111111111111111111111111101010001201001021111012b12222121102111a111011100111111010011111011210111121010222002211221121011P111111110101101101111
00101100011111001111111011111111111101110101111111012020021121212b20212212221122a111011111111111011111010011110211122122210212201221011221P111101101101111110111
11111111101101111111100111011111010110111111111112022012112112222a12221212220022a011111101111011110110111110122011212220222121122222120101P101111111111101111111
01111110100110100110111111111110111111101111111110222212221121121a01201110221212a110101101111111111111111111012202022210222201101011121011P101101111111010111100
10100101111101001111101011111101111100001111101110211201210222211a22112201111002a111011111111100111111111001010111111111101110111111111110P111111111101111111111
10111111111010111110111110111011111101111111101111121211011221111b22212021121021a110111111111111101111111011111111101111110111011101111111P111110111010111111111
10111111111101111111010100110111111111111110110111100121221202211a21112222020222a111010111111111110111001111111110111111011111110101011111P111101101111111111011
11111001111111111101110111111110011111111111111101111211022110202a21211012212121a111111110111101001111101101000111111111111010010011101111P110110011111111000110
10111101111101111010111111011111111101111110111110212022221212221a10022111221122a111011111111000111100111111011011111001011111111101111111P110111110011011111111
10111110101101011011111011101100110111011111110110120022022101020a02121221112121a110111111011111101100111001011101111111101111111011111001P110111100110011100111
11101011001111111101111101111111111010111111111002210222222011222b22202112111012a011110111111011011101101011111111011100011111111101001111P111101111111011111111
01111111101101011011111111111111110110110111111011021112112111122a12202011101211a111010101110110111011111111111111111110111001110101111100P010110111110111111111
11111010011111111110101111001111111111011111111110121110202111001b21222122112222a11111111101111011011111101111111110111111100101101101011P0111111011011011111011
10111111000111111100111101111111101111110110110101102112121120111a12221210222221a1110110111101111100011001111111111111111011111011101110P11111111111111011011111
11111111111110111011011111111111111111111111110102111110102021111a22121111222222a1101111101110111111111111111111001111001111111101011111P11111111111111111110110
01111110111111010110111011111111111111101111101002022202111111011b22211111022202a0111101011100111011111101111101110101110111111111111010P11111111011101111111111
11110111111111111111111111101111101111111111111111221220101010201b21122210202121a0111111111111111011101101111111111110111111111101111111P11110011111111111111100
11011101101010111100111110101111111011110101111112011202220100221b20122220100122a1111101100111111100011111001111111111011110101111111111P01100011111111111111111
11111111101111011001111110110011111011111111111100121211121221012a12112111122211a1111111110110111011111111011011010110111111011110111111P11101111110111111110111
11111110001100111111101011011111110101111111010112121120100220111b22001111112121aaaaaaaaaaaaaaaaaaaaaaaaaaaaPPPPPPPPPPPPPPPPPPPPPPPPPPPPaaaaaaaaaaaaaaaaaaaaaaaa
11011111110110101111011110110111011111110111111112011121101220011a02122122202202111111101110111110111101111P1111111110111100111111111111111000101100100111111011
11011111110110011010101111111111111111101111101111012111210121101a02021111021201100111111001111111111110111P0111111111111111111101111101111101111111111111111111
10111111111101111101111111110111111111111110011111111111111101011a11101011110111111011100101111011111110100P1111110011011111110111011111111100111110111111111111
11111101111011110101010111100111111111111111110110001111101111111a1110101100111101111111111111111111101110P10111111111011111110101111111011111011011100101111011
11000111111111101111010111111111111111111111111111111111101001111a1110011101110001111111111111000111011111P11101111111010101001111101111111010110111010011111110
11110111001111110110101111111111110111111010010111100110111101110a1111110101111111111111111010111110100110P11112021202102211102212110221101220111111011111011101
11001101101111111111111011111111111111101010111111111111111111111a1111111110111111011110110011111110011111P11110221011111121111220222120202102111010001110011011
11011111101111110100111101110101111110110011111001101111011110111a1101111110011110101111111011111111111111P11111121222121221012112221120022112111111111111111111
10111111111111111111111111110111111111011111111111111111101111111a1101101001101101111101111111111022111202P00212022222212212222120121122221211101111111111111100
11111111111111111101111101111111110110010220200201111221112221121a012022101101101101111111111111210112112P122202221222202220222122011111112120101011101101110111
11111111101111111111101111011111111111111211101221021012122121120a010202101111111010111101101111112202112P221222120212222202212002222120221200101111011111111000
11111111011111111111111101010111101111111111222212122112222121211b211011101001111000111111111111120101122P011211121221202012022112220120112102010111110101111111
10011011111101111110111101111111111110111210120102210111200222211a1201101111011111101111101111102121002122P22121221121002022112121121120210222111111111111111111
11110111111101000111111111111111110111011111211110210212112211002b1211110111111111111110110111110222222122P12210211222212222202222211212022112111111111111111110
10111111111111110111111101111111110101111022122220120211111112212a1112111111111111111011111011111021202122P21122012220222220211022102212211222111101011111011101
11111100111111110110001101111111111110111211122221120111220102111a112022001111110101001011111010101210122P202212202022221212222221021021212122111111011110101111
11110110111111011111111011111101110111110212212010222110210111222b111101111111101111111111011111001220210P122201221212222222102120112011102201100110111110111111
11111001111111111111111111101111111110111200111101122212101211001a200111111111111111111100111010202002222P021222211212222221220122120112202021110110111111111011
11110101111101111111110100111101011010111112111021210111122112011a21102111011101111111110010111011101102P2202212122220212201122211211212120001100111111111111110
11001101111011111110111111111111111111111221220102122211001022111a2212201111110111111111111111100202011P12011122222221110222222022220121122012101111111101011011
01011111111111111001111111110111011111111010222211211111212202021b2010121100111111111111011110111010202P00210212120020202120102010122010012110001111111111111101
01010011101110110011111111111111101111111212112012211012022010121b000201010111001111001011011101122200P220220121211222202122020222121202221021111011111111110101
10111111110110111111111010011111101010111202121212112212201021210a220220111111111111111111111100101202P201200122121022121202102021221222122111111011110001011011
11111111111011110111110110111111111110110222112111202102111121201a201111111101010011111101111111212101P221211121202012220222212122111002211000111110101001111110
10111111111110001011100111111111011100101101021121102111212221111a2021121011110010111101011110110121122P10202110220011222210221002211221010111111111111010101000
11111111111111111011111010101101101111101001102210121021001011111a10111211011011101111010111111002010222P2011102221222012222121202222112122100010011111111110111
11111011111111111111011111101111010111111212112112222021102121101a21212211111010111000111110110101102122P1212222201120210022221202011221222010111111001111111111
11101101101111111111010011111011111111011122022112121011020011220b1211111111111111111111101011110120111P20200121210221120211001210001221002022011101111111111111
01111111111000111111100111111111111101101101112022222220122110111b021212011111111111100111111111222100P101211221110002122112122210111000212210111110101111011110
11101111101111111101111111111110110111111221001121112111120111121b11222110110001111011100111111002110P1201001022212202002110012111212021111020110111111111101101
11101111011011110111111011111111010101111222222211220120112110101a1201221010111111111011111111102110211011202210112222210222122222111121202022110111111111110111
11110011111011111111111110111110011110111021102122011002011121200b1112221100111111111001110011111220212221122202222022212121012111211211221211111111110111110111
11111011111111101111111110111110110111111012111021102222111120210a2122211101011111011111011111111120011111201121212220221222112201212101202220111111111011111100
11001111101111111111101100101111011111110012100112211212211010121a1011111110011011101111111101112112201220011202222112201222202212111212202212101101111111111110
10111111111101111011011111111101011101111121120111212220001021121b1121211111001101111111000101112121111111012201201221211201212220210101212221011110011111101110
11101110110101111111101111011111111101111010200011222122221200222b1011021111111101111111101111110211111012221222201022121222022202010102221102100110011111110110
11011111111111110011111111101111110110011210211211022101110022102b0222021011111111011111111011111121022021010022111221212222220101111100111111111101111111111011
01010111111011110111110111010011101011110011202212102211122120000a1121110111111111011110101111012020221021112110102210221110211111111111111111111110101010101000
11111111110110110111111111111111111101101010222021101221200001211a1022201110110110111111110111111222211122201211111222012200121111011111101111111111011111111111
