3 89
143 112
122 49
126 101
64 67
119 18
56 105
111 104
8 43
26 34

111111011111111101111101111111111101111111110111111001011111111011101111111110a011110111011111111111101011111100010111100111011111111101111011111011101011111111
010011111111111111111011111110111110111111111111111111111111101111110110011111a111000111111111111111111111101011101011111111111111111101111111111110111111111111
111110111101111111001111111111111111101111110011011111111111111111011111111111a101111110110111011111111111101111111011111111111011101111111111111101101101001101
110111110111101011111111111111111101111101111100011111110100110111111111111110a111101101111111000111111010011110222111120211211101221011110111101110110111101100
011111101101101111111011111111101011111110111111110111111111010111111111111001a111110000111111111111101110110222111112201011122221022221101110011111111111010111
111010111011011101111101111101111001111111111110111111010011111111110111110101a101100110011111111011111121111001022111110022111222111110111111111100111111111101
110010111111110110011111100110111111101011011100111010101111111011001011111111a011111101111111101110111111122222112212220012121002222111110111101111110111110100
111100000111111011111101000111110101111111111101111110111100011111111111111111a101111111101001111101011121122221100212211110220010110201110101011111011111111101
100111110111111100111111111001010011101110111100111111111011110111111111100111a111111111111111111001110112221211222112021212101212012111111011001110110101111111
101111001111001111011101111110101001011111111111011111110111011111111111010010a101110111110111101111110121011211122112212112211212111211111111111111111101111110
111011111010110111110111101101011110010011110111001111011111111111101110101111a111001110111111011011111100222111101102220201202221201111000110101110111111111110
111111111111100111110111111111111111110100111111111111111111111110111101111111a101111111111111111111111112211022210212222102220212021011111111111101111111111111
111101010110111111110111111011111010111111101111111111111110111011011101011111a001111110110111110111101122211102110021202112110021110121010111100111110111010011
111010111110111111111111101111111011001111100111110010110111101101011111111111a110011111111111101101101002111120112212110120212112102221011110111101001011101111
101111111111011101111111111101111111111111111111111101111111111111100111111101a011100011111111111111110122111111111111211212012111201221101111111111111101111011
101111101111111111111011100111110111011111110101101111111100110011111101110111a110010110110011110111011122111122020022121122211010001221111111011111110111011011
111111100111001111111011011010101101101111111011111101111111111111011111111111a111111101111110110111111110211112111121011211012220201201111011110111111101111100
101111101111111111111111110111111111101111111111111011110111111101111110101111a010101111111001111110111110201020002022102222121201220021111111111110111111011111
111111101101111111111000101110011010011011111011110111111101111111111011110110a111110110111110011101110120102011201120121100222212021021001111111011100101110101
111011111112121212212221200111210102202022111111111111111101010011111101111110a101111111111110110011100101211121001111200110201120112120111101111111110101111111
111011111111212112211211110202210011211211111110111111111111111111101111111101a011101111111111111101111112100002111001101202020121121201111111100111111011101011
111110110011101111201222121212121122112201101111001110111010111111110110111111a010111101101111111101111100212112222222022201120012211221111111110111111111111111
111011000112222212202111210001022022120212110011111101011100110110101111111111a101011101110111111111110111112020121021121122212221112221111111111111111111111110
011000111010212121220210212021210221110112101111100011010101111111111101111111a111101110101101111011110121122021021210112111112112202001110111011111101101111111
111110111112212121211202222102211220222222111111110101011110011111111101110111a111001001111101111111110111112212011200112221112201122021111110101011011011101111
111111111112212102210222122111212112111121101011111111110111111111111111001111a111111111110111001101111121122121112012112011222211220101010011111011111111111101
110110101011111121212022101211121101121122100011101111111101100111101000100001a111111011101111111101011110012210211002101011111222011021111110101111010110101111
111111100012201012211111221211212110212102111011011001111101111111111111010010a111111111111111111111111111012211002221211121122222111121110011111111100101001010
002122020111011022212212000222112122011222101111111111101111011101111101111110a111010001011110111111111112221221011001212122212022121121111011111111111011111101
211212001212221222220101022200212122102121111111111111111111011001101111110111a101101001001011011111111002012112021202101212211102111011110010111111101111111110
221111122222222212202202222102221222201110000101111101101111101111101101111111a111111111111111111010111012122100101202100212122222222211111111111111101111000011
002100222102222212222202221222220110200221110110111110010111110011101110111101a111110111111111111111110102201021112220112100012220112101011111111011101110001110
220111212222022122212012212020212121102202111111111111101111111111011101001111a110111010011111111011111112222011012022110122122121111121011111111111111101101011
120112122100202212201220222122222120121111111111111111101110110110111110101011a011111011111111111101101111112220122222012000122121010201011110111111000111110110
210211222112201222012220022212212012122101100111100110111111011111001101111111a111101111011111011111101110122211212111002121222222111122201111111111111101011010
211222120120222222212012202222121221112221011111101101001110111111110011111011a110110111100111111111111111011001022110002122121111111021221111101111111111011110
010202110112022002221221111102202121212020011111111110011001111111111111110011a111111111111111011111101111022121202102122101222022222120121011011110011110100111
011121211012202222111221221222120211201222100001110101111110110111111111111111a110111111110111111101111111121222212221120220210112221121221111110111011111111111
212222112121001222220212222222100000001211111110011111011101111011111111101111a111111011101111101010111111111021211122222222221111020022121111101111111100001110
211101121220202212001200222221222202222212111111111011101111111101111111101111a101111111011111101111111101022011220211222122111022121212110101111111001101110111
202102212220202122120212022222210121102122111111101001101111111001110011111011aaaaaaaaaaaaaaaaaaaaaaaaaaaaaabbbbbabaaaa120021001020022202211101111111101111111aa
2212012100222112001210122120221222101010121111111110111111101111110101111110101011111101110111110101111111011111210222b122121201211122212211111110111111011010a1
1210221112222002202122022212122102001211221110111101101111111111110111111010111111101111011011110111100110121221111102b021112021222111111010011111111111011111a0
2121222021121220200122220122020112122121111111000101111110111111101111110111111010011101111111110111100111110102111121a210222221101110210211011111110111111011a1
1211101002122202202221221222222020011222121110111111011110101101111111111101111111011111010111111111110111100222011111b211010221221001112210111011011011110111a1
2211121111021222110222222221021112020221200101111111101111111111111111111011111111111111111111111111111111100021210211b112220222212121210200111011111110111101a1
1111121021000202020202222112020221202101101111111111111010111111110110101111101111100011111111111111011011121220111122b210021101010012102111011011011111110111a1
1100221210222212221220222212221201212221111111111101111111010111111101110010111111111111111101011101111111020212022221a101221120010110110011111111011111101110a0
2222021122122222222222212000000211021221011001111111011111011111101111111011111011010011110110111111011110122121211212b021110120222200120201010111111111111111a1
1201211201210220122222120121120121200011201111111010111101011111111111110110111101111111010111111111101111101212120222a010122211122220221211111101001011011111a1
1022222021120101211011212002111111111111111111111111100111111101001111111111111110111111001111111011011111122202122120b211212011221222211011111101111111110110a1
2110121222001122212211011111101111111011110111110111111001111101111011101111101111110111111001111111110100121021100120b022121111022221012211111111111111010111a1
2200222122222121222221021012221111011111110101110110200221222012011211101102222011001110101111101101111011110110002120b112122221101111121211101101011110111111a1
1221212212121121221212111212222011110011111111111212202122110021012222121222202111111111101101110101000111102120111111b121002111122111221111111111010111111111a1
0121121112202012102021212120210011111111011111001112222122112210200022112210110011111111111011011110001001002121022220b210110112222122211111111110111111111111a1
1121101020011122112121111001211111111111011111100011021120201221222011220122121211011101100011111111111111112012011111a122022220222101210211110001101101101111a1
aabaabbabbaabbaaaabaaabbaaaaaabaaaaaaaaaaaaaaaaaabbababbabbaaaabababababbbbbaaabaaaaaaaaaaaaaaaaaaaaa11011110022202222b021212122221201101111111110101111111111a1
1222121002011021111111102112202110110111111111111011110210011122222211121210011111110011111110100011a11111112022101121a110011101101011021111111001111111111111a1
0011121102111022202021102022112011101101111111111002122221121012021211112210011211101111111101111011a11111111102001111a211100000102122022111101111110110111111a0
1111001010111101111110011010110011111111100101111122102222022112122112212110122011011111111001101111a10111120012010200b120221100211121020111111101111111111111a1
1011111011110111111111011111111111111111111110101011121212012112202011220102111110111111111111001110a11011120222222212aaabbaabbbbaabaabaaaaaaaaaaaaaaaaaaaaaaaa1
1111001110011111111111011101111111011011101110011112111121210200210110211121122111011100001111111111a11101120020011122122120112001012011111111111111111101111010
1111110111111111011110111111111110111001111001111102101221110112021101212012222111101111010101100111a01110111121212220110221202211210212221111111111110111111101
1000111111111111100110101100101100111111101011111222221020122110111101201120222111111111111110111101a11111101111011212220112210212020110211011111110111111110111
1111111111010111111101110111111110111010010011011211122212021122021002011212111211111011111101100111a11011120111212210201020222001200212100111011110111111001111
1101111111110111011111111011111000100011101011111210112011120222102021211021221211110111111111111101a11111101111110111110111110101111111110111100100111111111111
1111101111111111111101111111111111110011111100011212101211011222212121112212211211101110111100111101a11011111111111111110101101111011011111111111111110111111111
0111111111111101011001111011101111111011111001101022012122211111022222211110201211110011111111111111a111011111110001110aaaaaaaaaaaaaaaaaaaaaaaaaaaaaaaaaaaaaaaaa
1111110001011111111011111011111101111111110101111221121210221111101202212022221111111111110111011111a110001100111111111a1100101111101001111111111111111101111111
1111111111111111100111111110110111111111101101111020220112122222222111211202121111111111111111110011a011111111110111111a1101111110111111011011110111010111111101
0110101111110001111111111111111111100101011110110012011212111211110222110111021110111101111011110101a111110111011111111a1111111101111111110111011010110101111111
aaaaaaaaaPPPPPPPPPPPPPPPPPPPPPPPPPPPPPPPPPPPPPPPPPPPPPPPPPPPb212121210222222211211111111111111110011a111011011111110111a1111011011111101111011111011010111011000
11111111P111111010000101110111101111111111101011122210112120P112101212212101202211011110111111111110a111110110111100101a1111110111111101110010011111111111111111
11101110P111011111111111111011110100110110111011111222221211P121112221011122122111001101011111110110a110110110111010110a1111111111001111101101111111111111111111
11001110P111111111111111111011111110110011111111012001222011P220201211100211221111111111111111111111a111111111111100011a1110111101101111111111011111111111101101
1101011P0110111111010111111111001110111111111010112110120212P210000200021211022111110111111101111111a001011011110111111a1111100111111111101111111011001111101101
1111011P1111101101101111111110111111111111111111121121221012P111012111212222112101110101011111101110a111010011111111110a0111110011111111111111110111111111111111
1111101P0111111111111101111101110111111111111011101121201111P120121112111221020110001101011101111111a011110001110100011a1111111111111101000111011111111110101111
1100111P1111010111111111111111000100101111101111021110021012P101210111111121122111101111101111111101a111011011111111111a0110010111111110110110111111110111111110
1110001P0111111111011011111111111111001111111101122211222121P020122222112011101111111111111111011111a110111111011111111a1011111111101111011111011010111011011111
1010110P1101111101110111111111111111111101011111120121200120P012221222222110111111011110111110111111a011110111111111111a0111011011110111111100101011111101111111
101111P11111111111111111111011111110111111111111102212121012P021010221121000221111111111111101111111a111111110111111111a1111111111111111111101100011101110111111
111111P11111111110110011111110111101001011010011112212121102P101112220122121001111111111110111111111a111111111111111101a1111100111111110110111111111011111111111
110111P11011110111111010011111010111010011111111110101111011P111111111111010111000111111101110111111a101101111111101111a1111101111111101111111001101011111110011
110110P11111111110011111011111111011101111110110110010011100P111110111111110011001111011110111111111a111111110111111111a0011111111011110100001001101111111001101
11101P111111111111111011111111111111011111111111100111111111P101101111111111111100011111110111010010a111111101101010111a1110101111011011011111111101111101101111
01100P011111001100111111010111111111111111111111101111111111P011001111111111011110111101110011111111a111111101120121011a2102010110201211211111011111111111011111
1110P1111110010111101111111011111111011111111011111011111110P111111111111111111111001110111111110111a011111111121111221b1122112212111202202121101111111011000111
110P11111111111111111111010111111111111111010111111011111101P111101110111111100111110101011101011110a111111011121221212a1111221112210111122112110101110011111011
111P10110011011010111111011111111111110101011111111111101001P101101001111101100111110101111010111222b120111111112012122b2200211111020121112202110111011011011111
111001101111111111101111010101111111010010211101212221021111P221211012011110111111111111111101110112b221021011210222222b2222111022212211221110011110111111011111
011001111111101110101111000110101111101112222101021111111002bPPPPPPPPPPPPPPPPPPPPP101110101111110222a001022220120012220b1212222012211010112210111001111110101011
11110011111111111110111111011100110111100110220222121111211220112212112211001111a0P01111111110111102a021121122022220222b2222200112100102112022011111110111111111
11100011111110001111110111111111111111111222002202120101110021101212122210111101a10PPPPPPPPPPPPPP120b022112211210012202a2122212210201210110012101000111111010111
00111111111110111101111011111111111111111211012202020110121201212120000201101111a1111101111111010P12a111021202122112112b0022022211102222202220110111110111011111
11111001111111101011101101110111111111111102011221202200212121012021012101110111a11111101111111101P1b211110122220212211b0012122111120212100220110111011101110111
11111111111011100100111011100010111111011220102212112101121220002020122110110111a110101111011010212Pb122022211222220122b2222202102111021120101101111111111011111
10111111111111111111111111111111111011111111111212121212111121202111202110111110a1111111110111111112P212011222002221212b2022122112211122112211111110011111011101
11101101110111111011110110111100111111111202212200220012201210010122122211111110a1111110110011002022P100122210222020121b1012222012120110201112010111111011111110
11100111110101011111110110111111111111101222122101220110121211011021121011111110a0110111111111111121P101012012220022202b1220211102011111212112101110101101111111
11111111101111111011111111110111111100110010100112210102002102211211012001101111a1111101111111112121P201012121222220120b2112202112221101201122101111111111111111
11010101111111101111111111111111111111011012222201222220212102221122122010111111a1111101111011102210bPPP221201121222012b0122222111221022111122111101000111101011
11111011111111111011110011011100011110111111010021212122111122010211220211110110a0111111111100110112a200PP0121201202202b1212222112022121122001111110111111100111
00101110111100101111101011110111101111111121222210012220011222120112221010101110a1111011111011102112b21121P21202PPPPPP2b2221222012202210202210011101111001111101
11111111111111110101110111011101001111111002111112212220212012102100021210111101a1100111111101110221a211011PPPPP210221Pb1221022212201112111101011111011111110111
10111100111111101011111111111111111101111111011122222121120011101212222011111101a1111011101111010121b202211002212222222P2020022112212021111211011010101100110101
11111111110110111111110011110111111110111110211112202222210211012111220011111111a1111110101111110100b111122021022212222bP212222201211011221202111110011111011011
11111101111110101110111111101111000111011210210211020012222122100202022210010111a0111111111111111210b211221020012021202bbPPPPPPPPPPPPPPPPPPPPPPaaaaaaaaaaaaaaaaa
11111111110111101111101011111101010101111112221212020222111110112200111111111111a0111111010111010221a20100122222022122112222022212222211220222P11101010110110111
11111111111111111011111111111111011000100222011120120112111111221210121210011111a1101111001111111222b22012202122220222222022202211220110102112P01011111111110011
11111001110011111111011101111011111111001221101121221210210201211221022011011110a1011011101111112111a121002110221221200022101221212022202021220P0011111111001111
11111111111011111011011101100010011111010021210112100221112112121121222211111111a1010101011011112221a211112111212220202221212222112022212212221P1010111001111101
01110101111011011110111101111011100011111222201210221200222211021112111210111111a1111111101111111210b211210121202222012101221221021201011110010P1111101110111110
10111011011001111111111111111111110111111212111112122222010011201011110111001110a0111101111111011201a12002221012002202012202221100212211121202100111111111000111
11111111111001111011111100111011111110111211101211112010200100010210221110101111a0110011000101011111a01221120112222222122220122122202200102112111111111011111110
11011111011011110111101111111111111111111112222012102200221201111221111110010111a1011100111111112122b21111111201002202202222220121012221211112111111111111111111
01111111100111111100110111101110111111111220201222212212011222212111211211111111a0111111111111012120b21122212122222202212222202201202220012121111111101111111001
10111111111111111010111011111011011101011121221122212021202202122102122101011111a1110001110110111022b12121211102021110011102101111111101111111111111111111110110
11101111111111001011011101110010111111111120222012221122222012111112102111011111a1111101110111011011b20021212211121202112122010111111110110101111111011111110110
11111110111011110101011110001100011111101221111002102222211221212102102011111011a1011101011011100211a20111121212221012121022212101011011101001111111111101111011
