101 110
139 3
122 49
126 101
64 67
119 18
56 105
111 104
8 43
26 34

1111110111101011111011011111110110111111111111111111101111101111111111111110110110110111111110111110a11111111111111111111111111110111001011101111111101111110001
1111101111111111110111111001011111110011111111100111101011110111110101111111111111111111111111101010a11111101111111111111111110110110111101010011101101111111000
0101111111110101111110111111111111111101111101111110101011111111111111111011111011001011111111111011a11111011110111110111101111101111101111111111111111111111111
aaaaaaaaaaaaaaaaaaaaaaaaaaaaaaaaaaaaaaaaaaaaaaaaaaaaaaaaaaaaaaaaaaaaaaaaaaaaaaaaaaaaaaaaaaaaaaaaaaaaa11010221221122002220212102212202120011P11110111111111111111
110100110001111111101011111111010111111111111111111111011111100111011111101101111111111111101111110011112200001111102122220221022122121111P011111011111111110011
11111111111111111111111110111111110111101100111111111111111111111111101111101111101011111110011100101110110222012120021011122222201212211P1111100111011011111111
10011011011111111111111101111001111110111111111001111111100111110110111111001111111111111111111111101011010201111101222222101110100120211P1111111111110101111011
11101010111111101111111111111111111101111011111110010110111100110111110111111110111111110111001111111111111102101201111220121120212021110P0011111110111011111111
1101101110011110111101111101111111011111011111000110011111111011110111101111011110101110111100101011111111021121202222111220011211112200P11111111111101110110001
1001110110110111011111110011111111111111111111110111011101111110111111111111110111110111111100101001010002101111221011012210022211002201P01101110111111111111111
0100111100111111110111111101110110111111111101111111110111101111111111011011011111111111111101101110111122211211212110000111202101222020P11101111011111111111110
111011111111110110010111101111000111110110111111111110111111111111011110110011010111101111101111110111111200211222222221222201221012111P011110111101111110111110
011011111110110111111111001011111101111101101110011111111110111111101001111111111110011111010111001111112121011112221011112111000222022P111101111101011111111101
010111111111100111110111111111111101111110111111111110011110111111100110111111011110110111111011111111011221022121211201122222121221211P111111111111111111111111
111100011111111110101111110001111111010111101101111111101101111011111111110111101011111011111111110111111212211111120212122112211110222P110111111111011101111111
110011111111111111111010111110011111011111111011111101111111010111011110111110111111101101111011111110112110212011222222222221201201001P111111101111101011111111
111111111101111110010001111111011101111011101011111111011111111111100111111100101110000111011111111111111101110001202001102221102111112P111111011011111010110101
010111110111111111100110110111001111011101101111011111111111111110111111001111110111011111111111111010111221121112222201202202220220222P111111111111111111101110
011111000110111101111111111010111110111111110111110111111011111101111111111111011110011111101111111010112210111211022121222221211212222P111111111111111111011101
111011101111111000112122112120122222212111101011011101111101101111111011111111110101010111111111101111110121210011101212211112202212100P111111101111111111111111
111111010011021120000222211201202201211001110111100011111110111111011111111111111111101001011111101011101202212222101101101201121111211P111011101011111110111101
101101011111012110010112112221222012121202110111111111111111110111111111010111100011111111111111111111112122112100111121121100022010121P101011111110111101110111
111111111110100020102120201211022101122112101011111100111111111111111110111001111111111111111111111110110111212112101011222220011120121P010111111111111011111110
1111101111110002121122211121001011220012221001111011111101101001111111110111111111111111110111111111111120212122121011012121121121112121P11110111111010101111111
1010011101102021202112011021101212022111221111111111111011110010111111101111011011101101011101001011110121211022120021101210221222201220P11111011010011100111111
0111110100020112222212122202221211100121201111111111111011111111111111111111111111111011011111111110111101211221102111102021110101121221P11111111010101111111010
1101011100110100010010212111011202222012011111011011111111111111110111001111111110111111010011101111001112012200011111110211101222222111P01100110111100111011111
1111111100000002011102222112112100222122201111111011111001011110111111111111011111101110111101110110110012110221122200211211221122002120P11011111111110010111111
abababaaaabbbabbbbbbb02112220011002011212111111111011111111111101111010011111111aPPPPPPPPPPPPPPPPPPPPPPPPPPPPPPPPPPPPPPPPPPPPPPPPPPPPPPPaaaaaaaaaaaaaaaaaaaaaaaa
22202120211022112112b21022212221000022202111111011110111110100110101011110111111P1111111101011111111101101002121120021102221012211212121111111111111011100101101
11002210212102221212a22222222201010220121111001100110000110111111110110111111111P1111011111011111101111122121212100211121002120222212101111100111111010101101111
00121010202001222001a20200202001121122212111011110111111111111111111011111111101P1111110111111111111001112122111122122001002221221221121011111101111101111110010
21111011001201221122b22000222202112011001211111111010010100110111101111111111111P1111111111010111101100110001121000102222221001011122211111011111101111111111110
01110221112221022000b02201012221212121102011001111111100110111111111111111111111P1110111011111110111101101221022111020222122122111210121011111001111111111111110
22001112202122012222b20120221002111211112211111111001111111101111101001100111111P1111111111111110011110011011102110022122220121222022122011111111110011111001111
12020222022121110212b22212222221101020112101110101011110111011110111110111011111P1001101111111110111111100021220202022011101122111201200001110111111111111111111
10011120212211221221b20212222211111102101211111111101011111011011111011011111011P0111111110111111011111001120221012221011200201122102122121101101111111111111111
21122020120110222002b02202220022112102112110111110111110001011101101110111111111P1111111111111101111111111120202212212110121211221211010221111111111010111011111
11002111222212210222b22220202121222111221001011111111101101110111111011111111110P1110111011101110011101111121202121021222221200020121102211010111011111011101101
12111112221122022222b02121110021211210211211110111111010011111111111110011111111P1101111100110011111111111101112120022221121122011002121011111110111111011111111
11012221012212222221b22102202212222112121111111011111111111111111011011011111111P1001011011011011001111111110112111201202111010221221120121111101101111110110111
12222102102022202212b22212120210201121202211001110111111111111111011111101111101P1011111111011111111111110012021221020210021121112222020111111111110110110000101
20122022221022221200b22202122020220111211110011111011011111110110111110111111101P1110110111111111011010101111012212202110010110222220120201110111110110111110110
11022121111222222220b02222221222222112222211111110110011111111011111111111011111P1111111111111111111101111011121201200111220120021222122221110111110111111111010
22122120100022212211b22212200122102210212111111111101011111011011111111101111110P1010101111111111110111111111022221222210212120202122221111110011111111111111111
22020121022212212222b20222222212200120222110100111111111111001111110101111011110P1010111111110011111111011112120121210211220012211221200220011011101111111111111
20222111011212002221b11222012211101001222111010110011011111111110111111101001111P1111111100110111111111011122222222101110121201112222202120111101100011111111111
12222021012021022222b12221221111202212010010110110111101011111111111101111111100P1011101110010001101111111121211102122110211020102120221110001111011001010111011
21110211111212020022abbbbbaaababbabbaaabbbaaaaaaaaaaaaaaaaaaaaaaaaaaaaaaaaaaaaaaP1111111111001111111111101120211221112111112121222011022121001011011101110111111
12010110222002022212012211222222011121220101110011101011110011111111111110011101P1111111001010101011111111112020112121211101212111211012111011111111110101111101
02211101101111110020221212212220111111111111111111101011111111110001011111111111P0011111111111011110111011112212010021220021122112221110101111101110110111111011
12021210121102212210011020111111111111111111101110111111111101011110010110111111P1111101101100111111111111111211121112101102221200212100211110110111111101111111
21020110001121112212201211112121111111100111111011122221022211022120121201121011P1011111001111111111111001121102112112100111122121122222111110111101110011011111
21111102002011112201211210202120110111111011111110121121102212221020112201122012P0111101101111111111111111122222220001210212021022222120011111101111011110111111
22010221122220112210112111210021110111111111111102221002222222122022102012000211P0101110111111111111100011120220222122022020202112021202221111111111111110111111
10221121222021001121101020110111111111001011101111200201002211210202221212110021P0011101111111101111111111111112202211012211120212021111221101111001011011101111
11011022011222212012122020011221111011111001111111111122121221101121112120212122P1111111111110111001101111100111121011021212222122121212201111100111010111101110
21122101021000022221122112212010110111011110011112002201111211210022211012020220P1111110001011101011111011112222212222211121121111221211121111111111011111100111
02002201201121221211202121210221111111010011100102211121120211101222121120212122P1111111110111111111110111021211111211210101211012010022121111101011010011100101
11101111111111110111111001111011111101111111110011212111202220111020212121221112P1111111111100101011001111111122202211111222102212112122010111111100110111111111
11111110110111001011111001101111111101111101101110221100021122121120211211122012P0111010111111111111011111122120112220221212111200201120121011111010110111111111
111101101011111001010111111101111111111101111111110210221110102201122112001222111P101011111111111111110100112222110021112001200012222111121100110011011111111111
111111111111001110111110110110110111111011010111112211112111220221112121212121201P111000101111111101110111102112102212122200022110221121001111111011011110011010
010111111000111110111110111111111101111111111111022220121200121100221021202112201P110111110001111101111101110122212122111220212022011012221111111001101110111001
110111111111111110111111111101111111111111111111121111222122221122022221211122110P111011111111101110101111120111111101021221121111120012121101011100111111110101
110110101111111011011110001011111101111111111111021102112120212200121221201022100P111011111111111011111101101111111101101011101110110111111111111110111111101110
111101111111111111101111011111111011111111111101112122122022021122202012222112021P110111111110001111011111111111011111110111011111111101000011111111101111011111
110111011101011011010011111111111111110011101111111111111011022222211121211211211P111111111110111101111111111111100111100001001011111101100110011111111100010111
001110111110111111111111111111111111111111101111121012000002121212002102121021020P111110101011011111111101111101011111011011111111011111111110111111110111111100
111110000011111111110111100111011011011111111111120112211021111222120211221122021P111111111110111011111110101011110111011011101110000111100011111100111011001111
011110000100111101111111111111111011111111111010121220010022122212110212220100201P110111111111110101111011111101101111010111101111111111100001111111111111001111
110011110011111111101111111111111111111111100111122020112220121212002202120212011P011111101111011111111101111101011001011111111111101111111101111111111110111101
1111111011111111101100110110101101111111111111101222110022122212210022121222101010P11101111010111111110011101111111011111111011111110001111101011000101111111001
aaaaaaaaaaaaaaaaaaaaaaaaaaaaaaaaaaaaaaaaaaaaaaaaababbbbababbb120221222212112111010P11111110111111111101111111001111111111101011111001010110101111111111111101111
011111111111111111111111110110111111111110111111011202122201b220001021222112001201P11111111111110111111111111111101110111111111111111111110101111101111110111111
101010111111111111011110111111111000111111111010002022102021a201011222121211002201P11111110111101101101111001111110110101111111001011111111111111111111101011111
111110101000111101111111101111100110101110011101121211212210a122022220122022202210P11101111111011110111111011011110111001111111111111101111111111111111111011111
101111111111111111111111101111110100111111101111022021002101b12211122121211121011P111011011011111111111111111111011111110111111111111110011001111111101011011101
010011111111111111110110110101011011111111110111121101021221a12112002211221112121P011111111011000111111111111111111111111100110111111011111111011111011010110111
111110010101111011110110111011111011111111111111111112212211a11122011002201110110Paaaaaaaaaaaaaaaaaaaaaaaaaaaaaaaaaaaaaaaa11110111111111111111110100110111111111
111110001100111100110111111111111110111011111111112021222221b12220101122112111121P010001111111111101110111111111001111001a11011111110110101111111111111011111011
111111111111111101111011111111111110001101111111122120210221b22212220211121202101P111111111111100011011111111111110100011a11101101111011111111111101111111111101
011111001111111111111011111111011101110100101101021110120201b02122111222200211221P011111011111111010111101111111001101111a11111101001110011110111111111011101111
111101111110111101111110111111011011011011110101111111111111a11111111111011111111P011011011010111111101111011111111111101a10111110111111111010101111101101101011
111111111101010110111111111110111011110101101111110111111111a11111110111101011111P111101101111100011101011110111111111111a01111111011111111111110111111111110101
110111110110010111101101111111111111111111111111111110111011a11110010111110110111P110111111111101111111101011101111111011a11111101111111111111111111010011100101
011011111111110011011111111100011111011100101111111011111101a10111101111111011111P011111110101111111111101111110111210021a20110212210021012112011110110111111111
011011011111110011011111001111101111111111110111110111111111a11101011101011110101P101101101101111111001011111100202222211b10221112120201221100111101011111110100
001101111011111111100111111111111111111111111001111100110111a11111101111111001001P011110100110100111010111101111212100112b22010102221121212222111110100011011101
011111111111101111111111111111111011010110111011110111111111a11111111101111111101P111100111111101222112121121122201020021b11122202002212021100111111111111101111
111111111101011111011110001101011111111111101221212212112121a11221202211111101110P011111011101100111201122121212112022022b21122011111101121011001111111111111000
100011111111101111111111011110111110100002111122221111201212b22012221012111111111P111111111111112111202002120102121222121a22022122221121212121011101111110111101
111111111101101111111111110111111110101102221021111111112021b10001100011011111111P001111011011111220222212221222220102201b22212120221201112222011101111111111011
aaaaaaaaaaaaaaaaaaaaaaaaaaaaaaaaaaaaaaaaaabbaaaaababbbbbaaaaa22221201221110111111P111111111101111221021100212111221021211b10222120022101121212110111111111110101
001111011111111111111111101111111111111110121221012201121002211121122112111101111P111111111111011112201210102022101120222b22201222121202020221110011111111111010
111011111111111111110101110111100101111102002122101221221220122101202111111111001P110101111110002222022000122012202222222b22102211211211122211101111111111111101
111100111001111111101111101111111011010010112122221101212200211112122000111011100P001101111110012220122102001122221122122b22112111111101122210111111111111111111
011011101100111111110110111111101111111112012212212022021010221212110212011111111P100111111101111111211022111110222222222b11202212122212101212111111110011111110
111110011011111111110111111011011101100012221012001020222111020101111222111110111P010110111111112212222022112112021220210b11022221111122122201111111111011111110
111111111111001111110110111011111111111110112221120210212211111101221021011111011P111110011111112211211022121022120122011b12201120101122011212110111101111111111
111101111111111111111111011011100111111112212201121002102122202222011211111111110P011011111111111111111111222112220102221b22000012211111211121001111111100011011
111011011111101111110101100101111111111110211110102201102021221112222100111111011P101101011110101222101212201212222122001b12222021112120200112101111101111111101
111111011111111011101100111111101110111111012222012110020222212222110111100010111P101111111111111201021212222210221222220b21222201121222212220111101001101111101
010111111111011001111111101101111011101110221121220220121222121121122112110111111P111110110111111201122202012102121212222b22222022122102221221101111011111111111
011100001011011100111111101111111111101112102210222102210001120120022202111011111P111011011111111122122211121210222202221b22021022110221212212111111111111111110
111010101111111110110111101110111011111111220021201110201121012122201221011111110P111101111010112020220001211222222122200b12202112120220112211111111101011111111
111111111011011111001101111101110111111112121012112021112220222202102112110111111aPPPPPPPP1011010211010011021011222210222b22022011110210212102111101101111111111
111101011111111111101010011101111110111112110221112221001022211201012010111111111a11111110PPPPPPPP20022110020110000022020b10001201201220202221110011111110111101
111101011111110100111011101111111001100111221100112112121212110100111222111111111a1101111101111022P0221211111011021202221a12222221112002121021101101111110111111
111111111111111110111111111001111111101112221112211101121121110021220111110011111a11011111111100122P212220010221022222120b22222021120120011221111101111111110101
111100111111111111111011111110111110111102210221202220111011102101112111110111001a111111011110112112PP0122222210222022112a20222210212110111222011101111111001111
100111111111111011111111111101101111111112112112211110200021021012222020111110111a111111110111112220111100211112221012212b20220211111111212220111111111101110011
011111011111011111110111011001111101111102122021022112201112211220111221110110111a010010111111111212120000122221121020102a22101121000122011120110110111111111111
111111111011111001111111001111011111111101211122122001111102211011121210111111111a100111111011111101221212120012012212222b20221211022111212222101011111111111111
010111110111111110111111111101111100110112012200222222100201021211110110111101111a101111011110112012111111222210002112222b01021122122202101011111010110101111110
011000101011111111111111011110111111101011101111022110101010202212221111011111101a110111011111102221120111101220202220212b22122212002022022022011101101111111111
110101011111111111110011011111111011011110222002220211012212112222100022110111100a111001101111112222111211111102222121222b12212121221202111221111101111111101000
100100011111011110011111111111100110111102122121110221110111121100022211111111101a111111011110110121220021112022022001012a21210011101101100011011111101111110111
111101101111111111111111110111111111011112112101112121222211122212222201111111111a111111111011110112221010002011210011121a21022110011111110011111101111111111110
111111110111100110111111100111111111111112110201221221220221111021110120111111111a111110111001011122112122110121110221212b12020111111010111111111111010100111011
