4 11
31 110
122 49
126 101
64 67
119 18
56 105
111 104
8 43
26 34

11110111111111110111110111111111a11111101111111001101011111111a0111111101111001100111110111111111101111111111111111110111101111111011111111111011110110011111111
11011111111111110100100111011110a10111111011101011101110111110a1111101111011111111111111111111111111111111101101011111110111101110011111101110111001111111000100
11110111101110111111011101111111a01101111111110111111111110111a1111010111100110010111110011011011111110100111111111101111111111101111101101111110110111111110111
10110001110111001111110111111111a11110111011101111110111111111a1111111111011111111011111111111011111111020020122022110211101101110010121111110100101111101111110
11010111111111010110110101010101a11111101110101011001111111111a1011111111111101111110111111111111001001121111111202211122201022020112011101101111101110111111111
10111111011110011111111011111011a11011111111111111111111111111a1111101100010011101111111111000101110111110120220100222112112222211202011010111101011110101111011
11111111011101011111101011111101a11110011101110111111110111111a0111111101011011111011111111111111111001120200211212121021012221110022021111111111111011011101111
00101110100111101011111111110001a11111010110111111100111011110a1101111111011111110011111110000101101111112221212222121121101110212120221111011101001011110111100
11101111111100111100111111101111a11111101111011011111111000111a1111110111111011110111001111111111111110111011002211221211120120010212001111101111111101110111111
11111010111011011111100101111111a10111111111001111111011011110a1111111111111101011111111010111011010101112122222221111022122020101211111111111111001110101111110
01111111111111111011111111011011a11111101111111111111111111001a1101111101111111100111111011111011011111110222121221111001002001211011021111110111111111011110111
11110011100111111111111101111101a01111101010011111100101010111a1111111111111101110111111111111110111111121212101102221110102111221112211110100110111111111111110
11111110111100010111111111111111a11011011101001111111011111111a1110101111111111110101111110111111111111101220212112210010222122011201121111101111111111101111111
11110111111101111011111111011111a11111101100111111111110011100a1111111101111110111110111111111111111111122221201111002202120212222221021011111111111110111011100
11101111011011100000111101000001a11111111101011111111111111011a1111111111011111110111011100011100110101102012001212022212122010111120101011011111111111001101111
11111001101011111111111010101111a01110011111111101111100111111a1100111000111111100111111110111111001111022211101112112011211111101111021101101110111111100111011
11110111011111111111101111111001a11101111111110111111111111011a1111011010111110110111100010011111011111110121210221222101101120020122011101111111111110101110111
01111111110111101011011011111011a01101111111011111110101011111a1111111111011111111111110101100001100111122122101120122111111111122201100110011101111111101111101
11110101111111111111111100101111a11101111101011000111101111011a1111111010111110111111011011010111011101112212202221101120122122212021021111111011110111111011111
10111001011101211110100222022112b02010212201011111110111011011a0110111011011101111010101110111111111110101011110222101122120211220222021001101111111101111111101
01111111011212221221100011221202a00112020211110111011111111011aaaaaaaaaaaaaaaaaaaaaaaaaaaaaaaaaaaaaaaaaabaabaaaaaababababababbabbabaaaaaaaaaaaaaaaaaaaaaaaaaaaaa
10000111110111222122112211021112b2210211101111111110111011110111111001111101111111010111111110111110111111112122111001212122022212101221111111111011111011111111
11111111101112221122022211002211a2200221021111111110011011111110111111111111111111111111000111111110111100211122211211220201102010112111110111110111111111011111
11101101001220212122122222122121b1222121210111101111101011011111111011111111111011100111011111001111111011101122122121120211120211200221101111111111111101110001
11011111111122000221122122212101a0002110211111101111110001111111111111011101111111111111011111111111011122212102112202112122011011122111100110111111101011111111
11111111111122222121210221022012b1201121121101110110011111011111110111111110101111111101100100111111111122112122121010201201210021112011101110111001011110100111
01101101101212011211202101110022b1021020221111111101111111111111111111011110111111101010111011111111101001221102112110121220202221122021011011111111110101111111
11111111111022121112112102122221a1011002120110110111111111111110011101101110111111111011111011110111111002102101222111122210222120012220010111110111101111010111
20022201112022202212122212211021a2011201120011111111101101111111101111011011111010111111101000111111011112211111211120202210220112220011101110011011110101001111
10011212202102200022221221222112b1122002221111111011111111001101110111101111100011111111111110111111101110120122000222012121102022002121111100111111011110001111
21201210212001212122012012222221a0110201221111111111111011110111111111111111011111010110011111000111001011122001212121112220211122021221110111111010111111111111
22101221211222212021222202022222a1122222010111111111110001111111101111111100011101100011101111101110111102122112110122011122112122020221111101101111110111111110
11121102020221220100112222012222b1211201220101100111111111100011111111111110110111110111111011111101101011011221012012122010210110101021111111101111111011111101
22221022222112210121222202222122a2212121111011101011011111100111101111111111111110011101101111101100011122121121101112202202112010221221111110111011111111010001
21012212101200222022022212211022a2120120111110101111111110111101111111111111011111111111011110110110110111021221012000222111121212011211210111101011101111111011
22120211201100200200112221211122b2212122011110101111110111111011111110010111111111011011011010101100111111112212101211211121110222211212001111101101111011111111
22212110210201221222221202221221a0211120121111111011111111111101110111111111110111100101101111011111111111011211220111101220112220011122111101011010011111111011
21122220010220122222100222110201a2010211001111111111110011010111001111111111111111101111100101111110111110020002202112001102110222111210101101010111110111101101
22121212011222222222012122220222b2212221021111101110111000111101011100101111111111101111111010111110111111002211102112112212202201021221121110111111111111101111
20222201022122211121222001202121a0021112121111110111111101111111111111111111111111110011111111110110111110120222022101122122011111201222010111111101111111111111
02121111012221122022220222221012abaaaaabbbaaaaaaaaaaa11110111101111111011111111011111111001111011111111111111112110111101110112122011200121110011110111111111111
2100222010111222222222222211022121222212211111111010a10111101111111111101011111110110111010110111111111111100022222110212222222121212222201110111010111101011011
2221201222120201222222122022201111112111121101111101a11011011111001011111011101111010111111010111111111111121211221012111222012121012102121111111011011111110110
1122121210000212021222221101011211021122210111111111a11111011111111111111111011100111111111111111111111101111011021210112212212221022000220111110110111010011111
1122212120112212120222020222222200021111201100110111a11010111111111101111011000011111011111110111011110101112110212210021112101022210101200111111111011111111111
1221021220222020022100222012020100211102120110111110a11011111110111111111111111011111111011011111111011011022101022012111121110112221122011110111110111011101110
1211122010222222022222022212012222022202221111111111a11111111111111101011111111111101111110111111111110111121112201222112021221112120212121111111100010100000011
1211200202112022122021220221222222122111110011111111a11011111111010111111100101111111111111111101101111111120010121122200102122212111221221111111111110110111111
1222021221021220001010120222112211121121021111011011a10111111111111111111110111110111110111110111111011110121222201121221022112210011221021111101111011110111100
2020200122222122122112120222022212222112211111111111a11111111101111110011101111111111111111111101111111101122002220002021120012222101222211110011110111111011111
2121111112022221021110101120221010111011101011111111a11011011110111110111111011111111011111111011101100101112221202022022221022021112121011001111111111111101111
2112122202210222011102101210100100111101100111111111a10111111111110011011111111011111111111110111111100101122212011211101111222222101100011011111111111111101110
1002021011112221022221121111201010101111001110011111b11101211220101101221012220aaaaaaaaaaaaaaaaaaaaaaaaaaaaabaaaababbbbbbaaaaaaababbababaaaaaaaaaaaaaaaaaaaaaaaa
1111020221222122110120120212201111110110101100001221a12220102202012112121220212b11101111111101111001111111122220221101002121101212122021100011111111010010001111
1222102121202212222122211200111111111111110101011221b22111111021110112022001221a1111111111110011111aaaaaaaaabaaaabaaaabbabbbbaaaabbababaaaaaaaaaaaaaaaaaaaaaaaaa
2102110012122201222121111112110101111110100111111222a21121212202102222102111121a1110111110101101111a111101111222122021210220221122121021211111001111110011111011
1122112212212210212020121102220100101111111011111120b01222101022212022111110121b1100111110110110111a011011011222012110122122221221222120201100111101111111111111
1002221220110210210222122210201111010111111101111221a21020111201221102010212112b1111011001111111110a100111101121012112222222101212011220221111111011111111110111
2121112110021101212212202112112101111111111010100112a21122111221011022220101020b1111111100011111111a111111102101222211120101221122122211211111111111110110110001
0111111011011001111101101111111101111111001111110100a12101221201210221122102021a0101111111011111101a010011122211112221211022101221022202211101111111101111110111
1010111111101111111011111101110111110011111000101122a12221002221210110220110202a1100111001001111111a011111111221010201211112102201021110211110101111111111111100
1110101111111111101010001111011011011111111011101222b11010221021121211202201022a1001110111111111111a100011101210202112211221010122110212021111111110101110011111
1111111011111111111111011010011101111111111111111110a12100222211112000122121201b1111011111010111010a111111122201121222121110212111112221101101111111111010110110
1100101111101110111111100110111111011101111110111111a21221222021101220122211121b1111110110111011101a111011101121121222220020122222210211211111011111111111111011
1111011101001101111101100111111111101110001111111212a21211111212011122221212022b1111110110111111111a011110112210111121220202220222100201101111011111111011111011
1111101110111100110111011111111111111110101111111221a20221102020220002112112012b1101111010110111111a111101111011011111101110111111011011110101110111111111101010
1111111110111011011111001101111001111011111111101121b20122101222220101212021122b1101001011111111111a111101111110101111111111110101110110011101111111110111101101
1111101101101111111110111111111101100111111111101222a10201121122221222120222212a0010110111111111111a111111111101101111011101001110111111111011111111111111110111
1001110111110110111111111110010111111110111111101221a11200012010112022201201112a1100111111011111111a111101111101111110011111110111010101111111111101110111111011
1111111011111110010111011100111010110110011111101101a22121111112121022111122111a1111111111010111110a011111101111111111111111111111111111111010111011011101100010
1111111111011111011101111010111111100111101111100011a22111211111102121112002011b1110111110111111111a111111111110101110010111111101101111111111111110111111100111
1111001111011101111111001111101111111111111110001122a20221211212111211111211111a1101111111110111101a111111011111111110011110111111111111111111101110111110110110
1111111111111100011101111101111011011111111111010111b22121012200020112022221210b1111111001111111110a001111111111110111111110101111111011101101111111111111111111
1111111111111111111111100101110111011111111110111110b10201210122212200111022022b1111001111111111011a010111111001111111010111011110111110101111101111111111011101
1111111111101011101101111111110110110111101111111002a22212202222112102112122020b0010111110100111111a111111111111111111111111010111010111101111111111011111111110
1111111011111010111111111011111111001101111101111212a01121212110102102222212221b0001111111011111011a111111110110111101111110111111101111111111111111111111010101
1111001111111111111110010111110011110101111111101222a02010101221012121022122221b1111011111100101111a111110101111111111101101111101111111101011011111111111111010
1111110101111111111110101111011011111111110111110212a01112112211121120202222202a1111111111101111111a111110111111111111110111011010111111111110100110111101111111
1111111101111111110110111011111011111101111111111221a21210221221101011220021111b1111111111110101001a111101110100111101011110011111111101111011110010111100111011
1111111111111111111010011110110111011111001011101102a10111201222112012222110001a0111111101111101111a111101110111011111111111110111111111111111011010110111111111
1101111111101101111110111111000111101111101011111211b22212122112120211111220101a1111101111111110111a111111111111111011111101001110100101111101111111110110010111
1110101111111111101110111111111010111111111111110220b00222012010201210001100122b1110111111111011111a111111011111011111101001011011111111011101111001111101010111
1111110101111111101111110111111111111001110111010210a12222020222121222022112112a0110110011101111011a111101111111011011100111111111111011110111111101100111111111
1111011111110111011111111111111001011111111111110011a11111011111101111001101111a1111011111110111010a111111011111101010101001101010001011001111111111111011110001
1010111111101110111111011110011111111111111111111111a11111011001111110011111111a0111110001111111111a111111111100110111111101101111101010110101110100110101101110
1101111111111011011110011111101110111111111111101111a11111111011111001111111111a0100111111110011001a111101101110110111111111101101111111111111111111101111111101
1111111111101111111111111111101110111111111011111011a11111111111110110010101111a1111111111111111111a110101011001011121212102101201120122002112111110111111111111
1111111011111011111111101111111111111111111111001110a11101111111111111111100111a1111110101111110101a111111111011121102221122101211022121222122110111111111011111
1001011111111111111111111101111110111111011111111101a11111101101111111011111011a0111111111110111110a111110101111212022111211122111022211101011111111011111111111
1111110111101110011111110111111010010111111101111110a11011111110101011011111110a1000111111110011221a111122122202222210022212221021122221022120111011011110001111
1011111110111111111011111111111111111001122210211211b12212121212212121110111010a1111011111111011211b212221011222212002222122221212210201022111111011111011101101
1110000111111111111011011011111111110111121212121111b12221212102021202121111011a0101111000110110212b020221011122020021222221202212202122222210101110011110101111
0101110111111101111111111111011110011111022111110121a21212201210021100011110011a1011111111101111111a012222210110220222222222020010101121100212111111101111011011
1111111101111110101001111111101111101011110220121200a20011112021012021111111111a1011111111111011121b001022112220020012002022022211222201011222111111111111111100
1110111101011111111111100100111111011101121110211122b22110210221100222110111111a1101101111001111022b020220211222222221101122122101112102212211110111111110111011
1110011010111111110010110111111011010011111121121011b12221000101021021001111111a1011111111111011220b112212022022022222101222202000011221012121110011101111111111
1111111111111111110111011111101111111111020122212222a12001021202111112211111111a1111001111111001122b012221001221022222211012220222101101101222101101111110111111
1111110110111001110111111011110011011111110211102222a12202112112122021111111101a1111111111010110102b122121221022012121012220221201122122222112101111100111110111
1111101101111011111111111111111101111111112220101202b00022022201122102210111111a0111110111011111021b112222021110222221201110222110212102122201111111111111111111
1111111011111011101111111110111110100111122022021222b12212122201121112201111111a1110111111011111121b121102220022112221222220222211222210122010101111110001110010
1111011111101111101111111111001110011111110202122011b10022112121111222101111110a1111101111110101020b221111221122122221222212212221212120212100111101111110001111
1111011110011100111111111110110111111110121221201011b01221102210201122221110101a1111111010111111022a102012212111222222222201221212201011121222111111011011111111
1110111011111110101111111111101111111010010022012212b22111211010122201211111111a1111011111011011201a220112111210221122222222222222211111212102011001111111111111
0111111011111111011111011111111111111111111002020122b12222020021111101021100111a0111011111111110122a201112220000022210212212111022121112111111111111111111111111
1111111011101111111111111111010111110101120202001211a11112111222120211111011111a1101111111111111222a012111222112222021220221201221022011211221111111111010110111
1111011101100111111100101111111110111111102020012211b21112111022222122211111111a1011100001101111110a100110220020022220222021012122220112121220111110111111111011
0011111011111111111111111111011111111111021222111201a01112100101220201120101111a1011010110111111222b111221222222112010122222022211010210121011111111101111111100
1111110111111111101010110111100111101011112101221220b02120111121101212100111011a1011111111001110212b112001102222222122011122201200122222101121011101111101111111
1101011111011011100001111101010011111111120122122120a11212102210021111211101110a1111110110001111012b110112111111102222210220102210211112112110101011111111111111
1111101110110111111111110111111111111111110202112110b01221111011020211111111111a1111111101101111010a021112112100212211202010222111122111111012110111110111111111
1111111011011111111101110101111011111111120101220122a11111200110102201111011111a1111111111111111121b221211101011221100222222212011122221120122011101111110111111
1001110111011111111111111111111011111111112110202102b11210122221111112010111111a1111111111111111211a011111010000222222222122221101021002221012011011010111011111
1011111101111111111111001111111111011111111101120012b11222221200211112211011111a1111111111111111212b020222221202001122222022221201011211121021111111011010010101
0111111111111111011101111111111111001111110222111022b22110102112002201211111010a1111111111111101111a211220212212212211222121222121112210122202111011111111111111
1111111010111011101111110111111111111111110211110121a22220100111121222021111101a1111101101100011012baaabbababbabbbabbbbb2222201010221221212111111110011111011011
1111011111111111111111111111001111110011011100210200a12211122111122211120111111a111111111011111022022212111122022122122a2222011202220120021102100111011111101111
0111111111111010111010111001011011111111112112011222b02122201121111112220111111a011111111110111101122212112112111112212b2222200220212112111101101101011111111111
1011111111101011010111110111101110010110012211212021b11211221201212200021101111a111111111111011122110212100112210120001a1122200011101111111101111111110110101111
1010110011010111111100110111111111111011011021101210b12102021202210110011111011a110010101111110110002122211112211111222b1111122011111111111111111110111111111111
1110110011111011111111111110100111111111111102211221a00001221222120101221111011a110111111111001122112212201000111220212a2212111111110111101111110011111101111111
