20 111
34 14
122 49
126 101
64 67
119 18
56 105
111 104
8 43
26 34

1111011111101100111011011101111111111011010101100111000101111111111111111111110111110011101010111111011110101011111111111111111111011111111111101111111011111011
0010011011110110111011111111111111101111111111010100011111101110001111111100011110111001111110111111111011110111111110111111101111101111111111111011111111111111
1111111111110111101111101110111101110111011010111011111111101011111111111111001110111111101111011001111110111011111111111110111100111111011111111110110111111111
1111011111111111101110111111111010001111011110111110111110110110111111000111111111111000111101011011011100212102201120201122212212202121111111111101101111111101
1111111111101000101011111011001100110111111110111111110111110110111111110111111aaaaaaaaaaaaaaaaaaaaaaaaabbbbabaaaaaabbaaabbbababaabababaaaaaaaaaaaaaaaaaaaaaaaaa
1111110110111111111111110111111011011111101111111001110111110111111111110110111a11111110111100111111100121100122201122201020220001212101101111111111111101101111
1100111111011111101111011111100110100101101111111111111101111101001011111111011a11101110111111111111111011222210122121120111211110112211111111110000111111111111
1011011011111101111111101111111111111101111111111111111010100111111111111111111a01101110111111111111111112201102112221212211212221120101111111101111101111111111
1000111111111010111101111110111111111110110011111111110111111100111111101110100a11111111011111100011101010220200112212222222101122220221111111001011111110101111
1111110111110001011111010011110111111111111100001110111001111111110111111110111a10111101101111111111111101120212211121120221122022111220000011111110111110111100
1111101111101011111111111101101111111111111110001111011001110100100001110111111a11001011111111111011111120022211211022022202201220122211101111111010111011110111
0111111111111111011100101000010111111110110111111111111110110111001111110111111a01111111111111101110111022010011022222112121012121112211001111111110100011110111
1001111111101000001111011111110101111111111111010100101111111111110101101011111a11111011001110111110111122201012222200211222212011112111101010111100111101111101
1111111010111111111111011111111101111111110111101111111111111111001011111101101a11001111111011101111101101022111121220222121111021112201100110111111101111111111
1001111110110111110110010111001011P11110010111111100111101101110111111111111111a11101111011111010101111122011022220100122001200212011111110011111100100110111111
01111111111011111010111101111110101P1111111110111111110000111111010111110110101a11100010111001111110111111100121111100122011221221111021111111101110010111111000
111111111101111111010010101111011011P101111001111011001111111111100111111100101a11111111110111111110111112221021112212112221122021220210111110111111111111101110
110011111111111101111111011111110111P111111101111111111111111111111110111101111a11011011111111011111011122111202222021121122210201201121101111111111101111010111
111111011101101101101111011110111111P111111111110110111101111101111111110111011a01100001111101110101111122121210111112101112211122211001111111011111011111110011
111111110112121201012222102202211220P101221111110110111011011111111101110110101a01111011111111111111111111111111112202012221121122110221011001111110111110101111
111111110112111001101210122222121221P010020111111111111101101111111111111111111a11000111111111101011111111211111121212112110121011021111111111011110011111011111
1011111001012120222222101222221102221P21021111111111111010011111111111111111111a10110110111110111111111121122011210212200212221012120011111111100010011111110111
11101110111211221120101121021211021112P1210111101111111111101111111011111110110a11111110111111111111001122001211221100022211110221101221010100111010111111101110
11111111011221101201020201210120121021P2200000101101011011111010110111101111110a11101111100110011111111122022211202112121201020100201221101000111111110111011100
11111111111112012012022011100122122122P0201101111101111111111111111111111111111aaaaaaaaaaaaaaaaaaaaaaaaabbbbbbbbbbbabaababbaaaaabbbabbbaaaaaaaaaaaaaaaaaaaaaaaaa
111111111110112022221111221122210101210P221111111111110111001110110111100111110001101101111111111110110022210222120011112001120111111000011001101111110110111101
111110111111200220222011212200002022222P201011000011111010011011110111111011111111011111101111011111111021112121200122212112112012222201111110011111100111111100
111111111101012201202011212122221121201P121010110011001100111111110111111111111111001110111110110110110120211120221110101022222200100201101111101111011101111111
0212101221222222220120022022202112122222P21111110111110111111011111111011111110101111111111111111010111122112120111112122210222022110220110011111111111111111110
22121222201221222122222220122220122111202P1111111101110011111111011111111111111111111111101111111111110102111011100222200012202112212101111011100111111010111011
121212202211221212020120122122021111202201P111101011100111111111111111011010000111111111111011110101110122012112100212222002210211001221111010111111001011111111
2211212222211121122001122010222222220111021P01111111111111111100111111111111101101101101011110101111001111021012021221211211202111022211111101111011111111110011
2002112102211220221111222201112212211122111P11010101011110111111010110111111101001011111111101011110111112121110121210201200211201110201111111111111101010101110
0211011102121222112020021201222221211110201P10011111110100101111111101111111010011111111111111011111111110220021001112122211110202002121111111011111011111110101
2222020211222202202222122012222020220211110P11111111111010011110111111110111011111111011111111111111001111121110222211122211220102221122221111111111110011111011
1101121112022221021220202122102011122122121P11101111111111111111111111111111001010111011111011100011101100110001111022120211212121120201120111001101011111011111
1111212201112122012022020220201222102122100P11111111111111111110111111111111100110111111111111110111101011111200221201202110101112121111021111011111101111111011
102121102222222221222101002012021022221212P111111110111111100111011111010111011111111111111001011011111111120022210111111120212012212220011010011110110111011111
202222201221202222021222221112222011101221P011111111111110110111110111101111111001010011111111101111111111120112111110022221221211211120121111111111111111111111
122221210201212122222212200122021111102212P101111111111101111111111101001101110011111111110111110011011000022121221111102210210122110221101101111111111111111101
211202120022020222001202122222222220222122P111111111111111111110111111111110111111101111111011010110111011111012212022122010110022020212001111111111101111110111
201110120012222022210222222212022221102112P110111001111011111111111011110111110111011111111110111011111110122010020212112202222120212110201101011011110111111101
baaabaaaababbbbabaaababbbbabbbbabbabaaaPPPaaaaaaaaaaaaaaaaaaaaaaaaaaaaaaaaaaaaaaaaaaaaaaaaaaaaaaaaaaaaaaaaaababbaabaababb112021222122002111110111101101011111011
00102111202000110222120212210022012212P111101010101110011011111111101011111011111111111111111011101111111111122120120111a212121120222110111111100011011111111111
1020022112022220220022212011101211112P2201011111111011111110111101101110111110001111011111111111010110010111020011221122a222222212211221201101111111110101101111
1222210220212220022120212202212211201P2211111101111110111111101111111000011111111011111111111011111111111102211111202220a222022111122002211101111110011000011110
2011000212212212212222210222222110112P1210101111111100111111111111101101110000111101111110011111111110110112121101201111a020201212120222101111111010011111111111
aaaababbaaaabbabababbbabbbbbbaaaabbaPaabbbaaaaaaaaaaaaaaaaaaaaaaaaaaaaaaaaaaaaaaa011111111111111100111101111011212022212a220212112121111211111111110101101101011
202122002101021222120221022122221102P1211211010111011111111111111110111111111001a111011000111111110101111111220001101221a222221112112111021111111110111111011111
21100121001122220212020221222221220P00112211110111010111101111111110111100111111a101011101111100111111011110101120221201a111012221101121121110011111110110111011
2202122001122212121210220212210101P111001111111101011111110111101111111111101111a101111110110011111011111111100212012122a111022111111112021011111110001011111011
122222112210221211211220222011111P1111111110111101001010111010111111111111111111a011111110011101111101111011102122222111b212012211211202121111011111101111110111
11221000220010101210022022222121P11111111011110011002220121122221122212101102202a101111110110101011111110102110112212221b111010222120101021111110011111001111111
12002022111100220102012112021110P11011011111111111201221002121101012120112211101a111111111111111101111110011111122201121b201121211200222021111001111111111100111
02221221012212101112221022222121P11111110001111111212212202111101112122000022222a101111111011011111101111110011022221112a100110222200221211110111011111101111111
02121222221122202222100112211111P10110111111111112012120121111222112101112112210a111111111111101111111100011111122121112a101202221122122120110111111110110101111
12021120101111010101101010112111P11111111111111011120012200210121112202221200111a001111101110111011111111110222102102112a011110121210222021111111111111110111110
00120022022122121211002111210211P11101111110110111211210211111111022112221221221a111111111111111111110111110111111212112b111202012120221121011111011111110111111
22121100112111100012121112202010P01111111011011111111122221110020221011111122200a111101111111011111011110111221121211222b212112210121112121111110010011111111111
1111111111111110111110111101111P111011111011111101202222111110121102112102201012a111111011001111011111111111201222211220b222122212201002011001001111111111110111
1111111111110011111111111000011P110111100010111110211022122210112010121122111101a111110001110110111101011111201111121110b221012101111220221111111110111111111111
1000101101100011010111111111111P111111111101111111122011011121022011020022112221a111111111111111111111100112221201212012b110221111212212221111101111011110111111
1101111111111111111111111001111P111111010101011112102201222222122122100200011100a110111111111111111111111112100111220102a211110111122102111101111111111110111111
1111101111011011111111110110111P110101111111111010110010112100121121200112111110a111110011111111111110110112102021211222a222022112202112221111111111110111110101
1001111110111111111101110111111P001110001010111102112101102201121121202222012112a010101111100111011101110010121122211021b221110012212122221101111011111011111001
1111101111011110111111101110111P111010110111111112012111101202111110112211202111a111111101111110101111111111010001011000a111011101011011111011110111111111111011
1101111111011111111101111111100P101111111011110111112211010121220102011121012220a111111011111110111110111111011101111101a111111111111110110111111111100111000011
11111010111101011111aPPPPPPPPPPaaaaaaaaaaaaaaaaaaabbabaaaabaaabbbbbbabaababaabbaa110111010111011011011111111001111111111a111101011110111011111111111111011101111
01111111101111110011P111101100110111011111110111121020221022222011112110111211020110111111101111110111110111111011011101a111110111111101110110011100001111111111
11111110101111101111P111111101111011111111111111122212212102111110102022211211101111111111111101111110111011111011101110a111111101011111111001111111111011111111
11111111110101111011P010011111111110111010001011112122202211220011221102221101211111101111111010100010111110111111101111a111111111110101011111111111111101111111
11111111111111111100P101001001111111111111111111121212221101122221011120012121211101111111111101110011110111111010111111a101111111110111111110011101110111101111
01011101111111010111P111111111111011110101111111021221002101212112101222112010221011111110111010111011101111111111101111a111101111011111110101111110011001011111
11111010111111101100P011111110111111010111111111101011001121122112120200012111111111111111111011000111110111111111111101a110111101101111111111111111010111011101
01111111101111101001P111110111111100111111010111022120112221001111022210110001111110111111111101111111011101111111010001a101110111111111011011110011111111111111
10011111101111011111P110110101111111111100111111010112121212202012212221110111101110111100111011111111111001101110111111a001111111111111111111111101111111010111
01101011110111111111P100111111111111001111001001011210122222222211010022201220221111111011111001111111011111110100111101a001111011101111111101111101111111111111
11011111111001010101P111110110100001111011111110022120100212212121102221211112121111011111111111101010111111101110111111a101111101111111111011110111110110111110
11101011111101111111P011111111111101111101101111101211222021212002222021111012010111110111011111111101011111101110111111a111111111111111101111010011110011110111
01001111111111111111P110110010011111101110111100102222221112111002002002110221021111111111111111011101101111110111111101a011110111111111011000111100011011111111
01011011111001110110P110011101111110011001110001112001112110111211100211211122001111111111000111110111101111111111110111a110101101111111111111111111010111011111
11111011011111111111P111111111111110100111111111011022121221211201010111121121001111101111110111111111001110011111111010a001110011110111011011111111111111001111
11010110111111010111P111011101111111101110111111121222212221110210120211222121120111111110101110111111110101101111100111a0111111111011111111aaaaaaaaaaaaaaaaaaaa
11111100111111011111P111010111111001111111111111110110111111111010111111111111110111101011111111111111111110111110011111a1111000011111111111a1111111001110110111
01111111110111111111P111101101111011111111100101111101111110111000111110111011111111111111100110111111111101111110111111a1111111111101011111a1010111111011110101
10101111011001011110P110001111111110001111101111111001111111101001011101111111111111111111110111001111110110001111111111a1111111011110111110a1111111111101111011
11111011111110110110P110111101111111111111111101111111011110111011101111111011011001110111110111100011111111111212112010a2111111111222221112a2011110101111111001
aaaaaaaaaaaaaaaaaaaPa111111011111111111010111101111111011111111111100101111011111111101101111111110011111111110102120010b2201222122112111121b1110110111111111101
1111111111101110101P1110011011011110111111111101111101111111111111111111111111101011111111110111011111001111111220122101a1121122020200121211a1110101101111110011
1101111100111101001P0111111011111111111011111011011111111111011011111111111111111100111111111111122001110012001201222202b2221112111121022202b2110010111111111111
1111111011111011100P1100101101011101101111122121201121122112122122222211111111111101111011101111121211021211222202210122a1222121210111022000a1110101101111011011
1111111111111111111P0001010111111111101012122122212012021220111001201121111110111010101111111110222221222122212210222220b0120101012222011110a2111001110111011111
1110111111111111111P1111101111010111110111111122112112202202122020220121010111110111011110111101000112022211102210212121a1012222211202112211a1110111010101011111
1111011111111111010P1111111010011001010010221211112212221101201012220211111011111100111111000111112221101212111122222222b1221101201121011101a2101111111011111111
1111011001011111111P1111111111111111111110111112211212020021212012222121111111111110101010101111021222212121022122122202b2222221021112111011a1111111111111111110
1111101111111111011P1101101111101111111011202121202021101220121221121112111111111010101011111000111122222220111111210222b0022211022220121010b0110011111111111111
1110111111111111111P0111111110111010010112100212011202120002201001201111011110111000111110110111211102221200201000222121b2010222202012121112a2111111111110110001
1011101111110111111P0111101111011110111112102011101101021022222112101211111111111100101111111101221211201212200210021222b2120102201200011122a1010001111010011000
1101000110011111110P1111111111011101111112102112211111111222222121121112111011110110111110111100001122001112212211220210a0122112121010220121b1111111111111110111
1111011111111011011P0111111111111011001112212021110102212122021012222212111101111111110011111110100201121211121222222221b0112222211201222021b2100110111001110111
1001001010110001111P0011001111111111101110020122112111222221111220222011111100111111001111111111122112201100110210122222b2002211110121120221b2111111111111101011
0111110111111110111P1011111111111101111001111221212202220102222111202202111111001011011011111111221211021112122222002220b1022201111211122021a2011111011111101111
1011111111111110011P1110110010111111111111122110212211120121222122212221001111111110111111011111210000211211010122222222bbbbbbbaaabbabbababbb0111011110110111101
1110111111111110011P01111010111111111111122121120111122221212111120120121111110111111111111111012211221002120122202122222022012121021112012222110101111110111110
10111101011111111111P1011111110101111110120200110201220010121211111011121111100011101001111111111121220222212121012021221222122122211121112102111010001111101010
11111111111111111111P0111111111111011011002211111121210111200221221112210111111111011111101011112001122122022012122110212022221112200212211111101010011010111111
11011111101111111111P1101111001111111001112202202221112122121222122121201111110111111011101011010112101011210102102222020022222011121121111020111101111110011010
11011111111101111111P1011110110101110111121111222202002200122102122211211011101111111101111011112121122111220211101202222210022112101122222211000011110110111101
11111111101111111100P1111111100110111010110111210221220100100111122121121001111110111111111111100110122101122212222002212210202222112120111122011110111101011110
11100111101111111010P0101011111111011111001120100000120121212220201122220111110111001111111111111210121001021111022222212222122111201120122021111111110011111111
01101011101111001111P1111110110101111110001212211111222210121010011221021111110010111111011111111210211202112122221202221211022101122202222112101111100111110111
aaaaaaaaaaaaaaaaaaaaPaaaaaaaaaaaaaaaaaaaababbbbbaabbaabaaaabaababbaaabbbaaaaaaaaaaaaaaaaaaaaaaaababab01020121110222221002022222221212110221012010110111111110111
1011110111010110101111111111011110111111121222221222221212002201220012111111111111110111111111112102b21121112222212200120222221110112211120121101010111001010011
1010111111011100101101011111111111111011102112101012201111121122121121110110011111110111101011010221a12111122112100011210222202212110222221200111110101111111111
1101110110111110101100101111001111111111122221221111021122210011102221111111111101011110110111112101b11120212221201202222122222001100201101212011011010011111111
1111111111111111011111110111111001011111120121210210202220110011210121221111100111111111111100011202b21121221002022201212212220111021202122211110100111010101111
1111000101111111111111111011101111111111001111222110102002121122002011221111111101111011111111112220a22112212111122122122222022201222111212222110011111111111111
1011011111111011111110111111110111111111110121121022212110121111021022111111111110111111100111111200b20211111221212121022212101111100011111011111011100001111111
1111010111111111111110111111111111011110121120200011211120021121211121111111011010101110111111111102b12100111111202202122120021011111111111111101011011010111011
1011101111001011011110110111101101101110122111221111110012010012221111021101111100110011101111111221b21121220111202120201211022101111111101101111101101000011111
