80 119
104 11
122 49
126 101
64 67
119 18
56 105
111 104
8 43
26 34

11111011110101111101011111111111101110111111111101101111001111010100011a1110111011000a11011111110111110010111110110011110011110111101010111a11111111111111101101
11011111111110011011111110111111111111110011001010111111111111111111111a1111111111111a10111111010111111011010111111100001111111111110111111a10110111111011110101
11111111111111111001111111111101011111111111111110111110110111011110101a1001111111001a11111111111111111111101111011111011110101111111111111a11111101111110011111
11111011111111110001111000011110100111111111111111110111011011011111011a1111100101111a01111111111111011121201112212201021210000000122200101a10111110111111111111
11111111011011111111111001100011111010101101111010101111011111111111101a1111101110111a01011111110110111002221111211110020122222112121111111a10111101111111101100
11010011111111110111101110111101111111111110101111110111111110111100101a1011110111101a10111111111011110102122011112122220120110121222221111a11111111111101011111
10111110110011110011111101111111101110101111011101101101110110110110101a1001101111011a11111111001111111122211122202220212111111012111211111a11001111111111011111
11110111111011111111011111111110100111110011111111101111011011111111111a1011110111110a0111101110110aaaaabbbbbabbbabbaabbbbababbbaaabbbaaaaaa11111110101110111011
11011011111011101011111111111110100111111110011111111111110100011111111a0111111101111a1111001111011a101012121122111201212211202011120121110110010110111111011111
11010100101011111110011111001110011111111111111111111101111111101111110a0111111111101a1110111110111a111112110122111222120120012220121201001111111111111011001111
11111110111111000100011011111110111001111111010111111011110111111101011a1111111010000a1011111101011a111000210022011101122211110220122121110101111101111101101111
11111111101111111110111011111011111111111111111001111100110111011111111a1111111111111a1111111011111a011111202221112122212112211002201211111111011110111010111111
11110111001111111111111111111111111101110101111101001111111101111111111a1011111111101a1101101111111a111021122022120211012211022100221101111001110111011101011100
11110010111111110011111111111101111111001110111111101110101101111111111a1111101011010a1111101101100a111111221201122011011021222121122220010111011101111011110011
10111110110111111001101110111111111111111010110111111110111101111101111a1011111111101a0111111011011a101021121101121021022112011201221221011101111011111110101101
10111111100111110111111101111111011111111111110101111110111100111100111a1011011111101a1111111101110a111122221122101222221100121101211111111111111110111111011101
11111110101101011110111110110110101101110111111111011111110011010111011a1011111011111a1111111011011a111121110121210121111022111211111220111110111111111101110111
10101111111010110111110111011111111111111011101011111111011111111011101a1111111111111a1111011111110a110012021110101002112122120112200210111111111111101011101001
11010110110101111111110111111011110100111101110111111111101111111111111a1111101111111a1111011111111a111102112111212111201211122212111211111110001111110111110011
11111111110112202111201212221111211102222011111111101001101010011111111a1100111011110a1111111010101a111101221002212121112101122112022221111101111111111010111111
11111111110102221122211110221211112212012211110011111111011110111111101a1111111001110a1110111111111a110121122102210122000022222221202101000011111010001111111111
00011111111221011111010212210121122120201111101011110101011101110111111a1101110111111a1111000111111a011122201021221221112011121121122010111001101111111011101111
10111110111210022112220121100000211111122210111101111111001111111111111a1010101011111a1110111111111a111122200201120212121102222121221011101110111111111110111111
11111011111110101222121112002211121120102200101010111011111111110111111a1011110111111a0111111111111a100111122111210212202111201221122111111111111101111111111011
10111111011120101021101122110022102111211101111011111111111101101111111a1111011011011a1111101111111a111012111221201100022212121112122011101111101101111111111101
11111111111221111111111121212111112202021111011111011011100001110111111a0101111110111a1111011110111a001110010011201101020202121220002221110111111111111110110111
11111111110112121122122120122120021211212001111111111111111110111111110a1111111011111a0011011001111a101110122011121222210211221201000211101101001110111111111111
11111011011121122011210121211101212001012011111101011111101111111011101a0111111011011a1011001111110a110110201200122200111221122101122001010011111110101111111101
01112211020122212210220022222221202222121110111110011111101111011111111a1111101110111a1111001111001a111121122212102122112122112112121011100111110110111111111111
22200111212102002221220202222202212112212111111010011011111111101110110a1111011101111a1111011011010a110102210201221221120011200212222021111010111111011111111111
12111011111210221222022212220221011220221001101110101110111101011101111a1111110110111a1011111101111a011112211020122101121212012002202221110111111111011111111110
20121022011222102222001222220021102011020110111111011111111111111010101a1111101111111a1111111001111a111111222111122121121022102222222111111111111111111111111111
11212112121121221222122221222221002222121201111010100111111110111111100a0111010011111a1011111111111a111012102022110121211021101121110201011101111100111111111011
11112222111210122212222222021201222102121211111011111111011111111011111a0101011111011a1111111011111a111011201112101101102122201112201111111110011110110110110011
21121021211022212222222222222020101111100211011111011011101111111111111a1111111111110a1111111111011a101111121220000110222220122222110100111111100111101111111011
20111211112221122221121022211210221122212111011111111101111011111111111a1101111111011a1111110111111a011110101111111212112211010001212220121011010111111011111111
10121202020012210011212202222222100202000111111100101111101111101111101a1101011111111a1111101111111a111110101111210011112022201221211222111111111111110111111111
02111101101220212022222022222210101221101211011100111011011101110111101a1101111111111a1110111010111a011111121111201120101110121111221120001101010110110110111101
11210001110200202202202202120221222022112011011111100011011111111111111a1111111110101a0100111111011a111110012011100112212220120121222220111110110111111100111111
011221111121211222212022220212211012211121111111111aaaaaaaaaaaaaaaaaaaaa1110011111111a1111100011111a110111122000112022121112221022221121221011110111111101111011
021111122111222120220220222222222112121221111111111a110111010111011011101111101111110a1110111011111a101111122220120111110122000210120212111111111111111011001111
022221101020201221200122222222210222222201111111111a110101101111111100010010111111110a1111110111111a011110111212222221122110121010121111211101111011111101110111
222022122111122101122202202212112222010012011111100a111110111101011101111110011110101a1011111111001a111100121212212111220220201222200211121111111010111111111111
201122222012222221112120122101221010220111111111101a111111101111010111110111011011100a1111110101111a111111111202122211212021210022122012201111001111111111110011
022010210211002021212020202122121211122201011111111a101100101111111111110111101111011a1111111111111a111101012202220220001110202222200221211110111111111110101111
021220200120200210212222222020122112121012111001110a110111001111111111111111111111010a1111011011110a110111022212222200210211211121202101211111110101111111110101
112221121102021222022122122220212101222221111111110a111110111101111110111111111111011a1111011101011a111011102202112001111112220121111112211101110111110111111011
201221111110221212012000202222122121102020000101111a101111111111111111111110100100111a1111110101100a111111112020012112121212212111221221021101111111111111111111
112111210121211002210211201222222121120111111111111a111111111111111111101111111011111a0110110111111a011011111211120212111121211222212012101111111100111011011011
022002212121222202212202220220212121202102011011111a011011111111111101110111010111111a1011111111101a111111112120220102120212111120201122221101001101110011111110
212211122202121122220202112212011111111111111111010a111111111010111110101101101111111a1111111111111a110101120201211022102111002120121222021111111111011011111110
100122102011211021222122120112211111111111111101010a111110111011010101110011011110111a1000111111101a101111002222112221102111101110102000111111110111111111101111
011012212012211111111102222220010111111111111011112b110122111012211210201011222211111a1110110010110a111110112210201122010022220212112200121111111101110111111110
111112222220222122222112121012100110101011110011101b201122121010211212112111112001111a1001111111111a101111102012122111201100121102121212220110111011101111011101
022212210112000222202012212122111111111001111111112b011122121201200211222220001110111a1100111111111a110110121220111222011212121210111211201110111100110111110111
111002201212111121021112211222211110111011010110022a012212221010201221101212210211111a0101111110110a111111121201201122021221112110210211211111010110011111111110
202221212201112111222220221100111111111111110101112a102122112112011222212022202011101a0011110111100a111111021111121102211101002111202020211110100110111011111011
020022212102201121111222021211211100101111111111112b122122211222122021222212220111111a1111011101111a011000121122212221120112022221121122121101111101111111111111
011200122021002112112122102110011101001010111111112a210112002122211211110221110110111a1011001010101a101111112122112221202201222021122221111011111110111001110110
110100100111001110110111111110111111111111101111120baaabaabbbababbabbaba1112122211101a0111110010111a110110122210202210122221012211202122221111011001111111111101
11111111111111111011011110111100011111111111111012002212201011001111101b2220011111110a1111111001111a111111111111122220102212202011110211211100001111111011111011
11000111111011111100001110111111111111111111111102011222112212120220110b2122121011101a1111111111011a011111101211212121212222022101022211221011111111111111011111
01111111110101111111111111101111010101110111101112002221220220001112121a2012210111111a1110101110111a110111112121111001221011121002220201221111100111111111101111
00101101111111101111110110111101011111011101101102121100212202111110120a0222022211100a1111111111111a001111021012211020210221200121211201120111110101111111101111
11111110011110111110111100011111100011001111111112022122112110211211211a2122112210001a1101111111011a101110012012102202221211010211120210001111111111111011111111
01111111011111011111111111101111111111110111110111200012120120111112221b0222221211110a1011111111111a110101011111011111100100001111111101110111110101111011110111
01111111111111001111011111111111110111011010111112121220101112011210121a2111011210110a0111101010011a111111101011111110110111011111011111110111111111101111001111
11101111011111010110101111111110111101111111011011110021112201021200022b2111010111111a1111001111011a011111111111111001111111111101111111110111110101100111111111
01110101011111111001111111101111011111111011111010220222122110221220200b2112122211110a1111011111111a111011011111011101110111111101111110110011111111000111110101
11100010101111101111111101101110110111100101011111111112122112211202102a0201221210111a1101111101011a111101111111111111101111111111111001111111111110111111111101
01111011111111101110101111101101111111111011111112012112211121110220000a2212221211101a1111111111111a111111101011111101111101111111101000100110111110011011110111
11110111110010010110111001001101010101111111100110222200112021111212122b2212212111111a1111111110111a110101111111011001111011000111011111001110111111111110111111
11111111110010111001111111111101111001111111111102200111222111201122122a0222201111111a0110011111101a111111111101011111111111011110111111110101111100111111111111
10001101111110101001111110111111111111111111101111122101020111012121220b2222022111111a1111100111100a111110101111111101111111101111101110111111011111111111110111
10010111110101111111111010111111011111110101110110122202221220011101201b1202101001100a1111110010100a110111101011011101101111111111101111011101101111000111111011
01111110111011111111110111011011011101111101111101221121222211122121112a0211212201111a1011111011111a111111111111101110111111101101111101111100111011111111111111
11111111010011101011110110101111101010111101011110121010100211111121001a2222122011111a0101101111101a110111111100111110111101011101111100110110111111110111111101
11101111101011111111111111110111111011111111111011110012021010221222121b1122112201111a0110111101111a111101011011110111101101111011111111101101111110011111101111
11010111110111101110111111111111111101010111101012121122110211121012112b1122112111011a1011111111110a011111101111001111111101111011111111111100111001101111111110
001111110101110111110101111aaaaaaaaaaaaaaaaaaaaaaaabaabaaaabbbbabaab022a1012002210111a0101101111110a111111111111111011111010111111101110011111111111111111011110
011111111111110111100110101a101011111011101111111222212021122101101b011b2222202211111a1111101011011a011111101101011111111111100111111101111111111111111011111111
110111011111101101100111111a111101111111100110011022122212221201222a111a1120010211111a1111101101110a111100111111111110111111110010111111110011111110101111011111
111111011110111001111111111a111111111111011110111201021022211120121b112a2012221111011a1101110001110a011110111111111111111011110110111111101111111111111110101111
111101001101111111110111111a111111111110011111001111100111111111111a000a1110111111111a1111011111101a111100111101111111111111111111110110110111101110011111101101
011001111111110111111111110a101111101111101001111111011001111011111a111a1111111111111a1111111110111a111101111111101111111111001111111111110111111101011111111111
111000111110111011111111101a111110100111111101111101111111011111101a111a1111111110110a1111101110101a110011011111111111011011110110111101011111111111111110111101
110111111111111111010101111a111111011011100111111111010111111011111a111a1111111111011a1111111110001a111110111110122211011011120012222011200111001110011111101111
111111111110111011111111111a111110111101111111111111001111111111111a111a1111111111011a1111111111111a110111101102102212100101121222212000212121111111111111010111
011111111011010111111111111a101110111111111110111111111111110101111a110a1111110011111a0010111111101a111111110010212220222222012212111001211201101111111101111101
111101001111111111111011001a111101101111110011111111110111110101111a111a0011111111111a1101111110201b122111001202222222011102202010020202222222110111111101000100
111111111111111111101011111a111110010101011200120011011022010202100b212b1111010111111a1101111101122a222122122112222222202222222122212121201022011111101101101011
110111111011111101111111011a111110100101111012111112021222102111012a021b1100111111101a1011111100221a011210200222122022122022222221112121102220000111111111101111
111011111111011111111011110a111111011101110111000102110212111211221b112b0110011110110a1101111011102a211222111210220110021222212221211212222220011011011011111111
011101110111111111111111111a011110101110121221121212211011221110110a111a1101101111111a0111111111220b110210020120222222122000220221221022120111101111110111011111
111001001111111111111111011a110111111111111111121222122222001212220a212b1111101011111a0111111001221b021200012122220220220212120002220220122211001111011010101110
110101100001010011111110111a111111111111122122020110111212122211221b212a1111111110111a1101110110012b011222222110221022022201000112112112211012101111101111111011
110011110101111111010111111a011011110011112121022221211121122011112a220a1001111111111a1101110011121b112120112212220221021222002122101212012222110111110111010101
011111011011011001111111111a111110111011110122111221211111210011222b011b1011111111111a0110110101202a111120122012221221222022221111202200022111111111110110101101
110111111111101111111011111a001101011111021012002000221000121001102a021b1011111111111a0001111111211b121121022022122220022122222012202212221201100101111111101110
111111101011101110111111010a001101101001020101212120020112222102022b221a1111011111011a1111111111102a111221122122121122222220220121002110102221111111111111111101
011101111111101001111111111a111111110111122222100122120121210112221a011b1110111111010a1110111100121a111212112022121021221021200222221122220122110101110111100111
111101101011111011111111001a011011111111010121122111111212222010102a111b1111111101011a1011111111220a022212202222221201212202111211210021212221110101011101111111
111111111100111111111111111a011111010111012121102112121221212010102a020b1111111111011a0011111111121a122022122122111220221022120021022022221112111111111111011111
010010111111011111111111011a111110110001101012210121220220002211211b202a1011111101001a1011111011221b221011112221120221221202111011110101222122111011111100011111
111101011010111100011111101a110110111010112122221222012111100122011b022a1111011011111a1111101001022b102220212201111220022202022212221222112212111101011111111101
110011110111101111111111011a110111011110111201102022111221120102120a120b1101111111100a1101111100021a102202001210120121222022220101022212120112110111111111101110
111111111101001111111111111a111011111110111010211121000101012012101b200b0111111111011a1011111111112a222001112010221220122212011212212211111212110110111111101101
001011111111111111011110110a010111001011121111122020202212201212221a211b1111110111110a1111110101112aaabbbbabbaaabbabbababbbaabbbbbabbbaaaaaaabaaaaaaaaaaaaaaaaaa
111111101111111110011111111a111011111111102112201121211010111121122a212a1111110111101a01111011101111212111211022001222222002101000222112020012011101111111111011
110101110111111111111111111a111101110111020211212211110222021021202b121b1111111010111a11111111111011011122202101022220222222121211112110120102111111111111111101
111101111011101111111111010a101100101011120012201202201222112112121a122a1111110011110a11101111011212012112020212211021212222222021211121211122111011011001111111
011111111111111110111011001a111111111111111212211202101121212112101a101a1110101111011a11010111110022012210212012010222220121122121020210102211111111011101111111
111011011111101111011101011a110110011101122221112222112202102121122b221b0111111110111a11111011110122121021002010220222001221222022101010212120101111110111111001
011111101101111101111111111a110111111111022121110202212012021121112b001b1111111111011a11111111110201121122121122120220221112200021221111211111110111111011111111
111101110111011010111111101a011111111100110122112110211021212220100a102b1111110011110a11110111112211122121222222122220001222121211110122220221111110011111111110
111110100111111101011110110a111111111111020102212212202012212012222a121a1111111010101a00111011012221012002210111112212222112222221111020022212111111111111110111
111111111101111111111101111a101110111011120202222120121121022102022b222a1011011011111a11110111111111012222121212020222212200112021002120121102111011111110111011
110101110101111111111111101a110111111111112211120222100122121120200b110a0111111011101a11111111100102111122210221211210102111112111010111111111101101111111111111
011111100111111100111111011a111001010111112021121022120122211112120a221b0110111111111a11111111110202211212011221122212220220111111110011111111011101111111111010
111011101111111111111101111a111111110011112101200011201101201121102b212b0011111111111a01111011112220221121201122211120112012021011111111111011111111111110111101
