20 111
34 14
122 49
126 101
64 67
119 18
56 105
111 104
8 43
26 34

1111110111111111101111101110111001101111a111010111101011010111110011111a111110101111101111101111a011101111011111001101010111011110111101110a01011111111111111111
0101110110101111001111101111111111110111a011111101011011111111101111111a111111111111011111111101a110111111111101111111111101010111001111111a11111111111101111111
1011001011111111110111111111111111101111a110011111111110011111010011111a011111111011011011111101a111111101111111101111011111111101110111110a11110110001011101111
1111110111111001111111111111111101111110a100111101101111011111010101110a111111111101111111010101a010110101111121220121111011121222222211101a10111111111101111111
0111011111101110111111011111011101111101a111110110111101101111111011111a111010111111111111100011a110101020220210201212101212012012220211110a01110110111100111111
1111111001011011111111100011111111111111a111111011111111111111110110011a110111111100111100110111a101011111222022101012211201012111211111111a11111101111111010110
1111111000010001101101111011011011011101a111111111110010111111111110111a011111101110111110111011a111111012111111020012110222110120201211111a10111100111111110111
1011100111110101110111111011111111111001a111111101001110101111011111111a111111110111001111111111a111101111101012220212000121111211101221011a11111101001111011101
1011111111111111001111011101110111101101a111100111111111101101111111111a111111101111001111110111a101101002121121210100211222211122120121111a11111111111011111111
1011101100111111111110111101111111000111a110111110011110111111101111101a111111011110111111011111a111111111110220112121211222102211012111111a11111111101101111111
0100111101111111011111111011111111111111a101110101111101101111111111111a111110111111101111110111a111011122212012120001220201222012112200111a10111111101101001111
1111111001011110110111111110111111001001a011111111111011011110111111111a110111111011001001111111a111111112121211101212111121222220221220111a00011111111110111011
1111111111111101111010110110111011111101a111110011110011111111001111111a111111111011111111110101a101011022212111110201222121111121221210111a11111111001111111111
1111111001111111111111111111111111101011a101011111110001111111001111111a110111111110111101111111a111110111221221212201222011221212122220011a11011111111111101111
0101111111111111110101110111101011111110a110110110111111111011101111111a111111111111011110111111a111111122112201221102112022011020120021111a10011110101001001111
0110110111001111101000111010011011110111a110111111111111111111111110110a111111101111111111111111a101111012202210211121121220122020200221111a11111011111011111011
1101111101111111011101111100011111110111a111010100111111111101111111111a101011111111111111001111a111110121121102212102201112121120001020001a11111101110101100101
0101111111101111110110111011011111110100a111111111111111111110111111111a100111111011111111111101a111101111121021100221112110121220012011010a11011111111101011111
1110111011111111101010111111111111110111a111110111110111111111011111111a111001001010101111100101a111111110212220201102122122121101120110111a10011111011101111100
1111010111101211121211220111220122212211a111111101111011111011111011011a101111111111111100101111a101110112212212102110012021101111022101111a11111111001111111100
1011111011122210210121122120112111112220a211111111111010111111111111100a110110011111111111111101a111111122200221211210202222120000112111110a11111101101110101111
1111111111121110011122122121202212102012a211110111111111001110101111111a110111101101101001111110a110111121221021221011111112122121110120110a11111011111111001110
1111111101021112101102220121220121022122a111111111110111111111111011110a110111101001111100111111a111010112011111210021222111221211112110001a11111011110111111111
1011101111021222102022111121220121221112a011101101111111110111111111110a101110111001110111101111a110111022222012221210112111021111212020111a10111010011111111111
1111111101121202211212122001221112012220a101111101111001111101111111011a011111111111111111101110a110001120220202210112111202012111120121000a01110101110111011111
0011111011111122212221112100201011221222b211110111111101111111111111111a111110111111111110011111a001010012101212121012221201101012110211101a11111101111011111101
1111010111120120021222222221120110020102a211111111111101111111111101111a111010111111111101111011a111101121112112112121121102221221111220101a11111111011110111110
1011101111122202012201211112122102222121a001110100110011011111110111100a111111111000111111111111a011111111112212012211211120011120212200111a11101111111111111111
1210122111220221110220022110220212221122b111111111111111110110011111101a100111110111111111101111a101111121201201111120102221221102122001101a01111101111111101111
1112202220112101222111222212220202111110b110111111101101111101111010111a111101110110111111101110a111111111120110221121122120121201212211111a01111010110001111111
2121221220122212202222222022220222211212a111011111111111111100111011111a111101111011011111111110a111101020011122121211201211112012101001111a01011111110111111111
1212201122220222222100221012100121001111b111111001111111111111110110111a111111111111111111111101a001111112111222202112112120212110122001111a10011111101011111111
0221212221012222122210102222022012210110b211011111011010111001101001011a111011101100111101111101a111111122122010021021010121122120122021111a11111011111101111011
2121112211221220220202222220212221201022a111111101001011101111111111110a111101011011111110111111a001111010212101121122022122111221002201111a11011011111111101111
1021110210122202221122120021222111222011b211111001011110001101111101111a010101111111101101110100a101111011122120120120102222121111211211111a11111111111111111101
1010110102211222222210220202022111211111a110101111111011111111011111111a111111111111011111111110a111101111101010002022110221122122101211221a11011111101111110111
0112021112222020222122220202022011211012b011011111110110111111110110111a011111011111010111111111a011011101120202101010220100021212220212211a10001011111111011111
2122221221120200222122222120222212121202b111101111101011111110111110111a111111110111111111110110a111110010122111221210111122102221121200121a11111101101001011111
2212120021121020022021212021020221101112a110001110111011111010111001111a101111010010111011110100a111111011111202221110112111221000120001121a11111111011111111100
2112212122222200000222210022200022110222b111001111110111100111111111011a111111111101111001000010a101111110111111221022222111112212222220221a11111110111110110010
0211011111222020122202222112002211001112a211111111011110111111001101111a111011110110101111110111a111111111122102211200222021222220111001111a01111111111100101101
2022220200212222022022220022122221201122b211111101111011111111011110110a111111111111011111111111a111111100122112212011110112211222210111211a01111111111111111111
2122112100122221222202222210120011021122a111111111101011010111101111100a111111111001111111111111a111111110121220122211222212001121220211011a11111101110101111111
0111110221222022101212200220222111122222a201111100111111010110101111111a111101111111111111111101a011010111100121121101111120012222001102011a11011111111111111111
1122012122122200201100222222022210110202a111110110011011111111011111101a010000101111111101111010a010111111121120222021111001212122020212121a01111011110101011110
2211112120222222110202122022012222222011b011101111110101111111110101111a111011110110101111111101a110011011112111211210111221220120101121001a10111111111111111111
2021020220122220221112111122002101121222a201111111111111111111110111110a111110110111011011010010a111111111122222202102222111021222122111121a11111111110101110111
2122102002121220121222201120220111110212b211111111111111111111110011110a101110111101111101101010a111111100102210121222122201211211001222211a00101110001111101110
2201121221020210021212220222102110120200b211001111111101111111111111111a111111111011111101111111a110110101111212210212102012222212212211201a11110111110101111111
1222022221211222221111222210222102122120b111101111111111111111111011111a101011111011011111011111a111000101111122211121212112201110212212111a01110111101111111110
0101112120112121012110220222010101111101a111101111011111111111111111011a101111111111110101111111a111001111121101101122210222122122012110101a11111111101101111111
1121201211222212222021002112112111111101a011111111101110011110111111101a111111101111111110011010a111111010000211121111212111221212001001121a10011111111110111101
1102121110012022100020120011022111111111a111000110202011121221212201200b211022121101110111111110a111110011112222200012000122201212001211201a11111111100101100110
0211020121022211201210021201011111101111a111111111212122201201121121212a100111220101111011111111a111110011112120122122122212020121220002221a11101101111101101101
2210222020111120122212011202122111011110a110011111022002121210222012121b021112111111101111111111a111111010112210220222121122221011112211221a11100111111111010110
2221011121212221101112202102211111111111a110010111112201212121122111111b122110211110110111111111a011111111021121220001221101102111121121201a11011100000111011110
2012010221122112220112000012212111111101a111101110121102112011012110212b122220210111001111011111a101011111102021212212111111011211212022101a11011110111110111101
2022012112122122221022120222121111111111a111111110121112212221121012121a222111111001101111011110a111111111122221112121012020111102010111221a01001111111101111011
1012121211202021211121111122022011111101a111111111022110221110222222011b211222011011111011110111a111011111102210120211111211102022112002221a11111010111111111111
1110111011111101110111100101111110111111a010101111202221121202102212220b122212221110111111101110a101111111121110121102021112122122221211221a11110111111110100011
1011111110111111111110111101100101111111a101111100122111101020211112212a111100211111111011111110a100101101102212100101110222102211122122011a11010110111110111111
1111111111111111111111111100111011111111a111101100012220100211220100122b221110221110111111101001a110011101122221020102010212222222110221021a11111111111111110000
1111111111110101111111111111111111101110a011111112201122221121221220212a221122101101110110110011a111101100122201012120111220102112110022011a11111111111101110111
1001111001110100111111111100101000111011a110101011212120211020122002221a220201211111101111111010a111011011122021102101112222020120221022021a11111110101111111001
1111111101111111111011100101111111101111a110111110211021221222222211021a110221111111111011001101a111101100121221022221002120221221110111001a11111100111111111111
1111111101010100101010111111100111101101a111111112211101001221211000211a010122221111110111111110a111110001111111111101111111111110101111111a10101111111011110111
1011011011110010110110110101111101111111a111100111120221022202122222121b121121211110101110111011a111011111000101111111111111111111111111111a11000111111111111111
0101001111111111101101001111011111110111a011111112111220212011202222012a210211221011111100111010a111100110101111111111110111111111111111110a00111111111111111111
1101111110110111111111101110110110011111a111111111011212111111122220002a122120221111011100111111a101111111101111111011011011101011011111111a11111100000101111111
1001111101101111011011110111111111111111a111111112111012000102210122200b121020221110111011111111a111001101011011000111111101001111111111100a11011011111110111011
1111101010111111111111111111011111011111a111110112121212112222221202120b211210011111111110111111a110111110011101110011111110101111111111101a11111111011101111110
aaaaaaaaaaaaaaaaaaaaaaaaaaaaaaaaaaaaaaaaa111111102010100000110111022220a111211211111111111111111a111101111100111011111111000111111101101011a10111110011110101111
11111111100111111111111101111111111111101110111112012221212102220112110b221111021101111111101111a110111101111111011111101101111011111111100a10111010111111101111
11111111101111101111111111110111101111000001110012212122022210200122202b222002211011011011111111a101111111101111111011111111111101101111111a11111010011111101101
00111111111110111111111111111101111100001111111110220111221220121202201b110202210100110111100010a111111110110111111110011111111111111011110a11111111111001111011
10011111110110111110111111111001101111101110111112212000012222121210101b221112211111111111111111a101001011110111001011111110111110111111110a10111110111111101111
11101111111111111010010111110011011111111110111110102201121222011111122a110211101101111100111111a101111111101111111101101011111110001101011a01011011110111001111
11111111101101101011111111101001110001111111111111122121222110212011221b101220111101011111111011a111101111111111011101111110111111101111111a11111101101111110110
11111010111001111100111001111011011001101111111102201011220022210121211b212211221011101101101111a111110011010111111111011111101110111111101a11011100111101111011
11110011111110111011110111000111111110111111101112222122112011010012102a121111111111101110111111a011111111110110111111111111011111111011111a01111100100111011100
00011111110111011111101010101111100111111111111111011202111222010220201a202101021111111011101101a110011111011110111111111111111111001011101a11101111110111111111
11011111100110111101111100110111111111011111111110202100001012111011220b012221211110011111000011a110101111100110111001111111111111101111110a11111100111010111111
11111111011011101111111011011111110010101111100110121121002011201220011b110222111111101111011111a011111111111111101011111111001100111110011a01111111111011111111
01111101111111111111111011011111101111111111111110111111111111110111001a111101111011010011111111a111011011101111101111011111011011111111110a10111111111111111111
11010011111101111101111111111111111111110111111111111101111111111111010a111111111110111111111110a101101110111011101111111111111111110111111a11011011111111101111
11111101111111111111000101111001111111101111001111110111111101001111111a110001111011111101110110a111111011101011111111111110111111101111111a11111101110011111111
11111111101110101111111110111111111111110111111111111111011010100111111a111111011111111111101010a111111110111111121002010211211200111101220a11011111101111111111
11111101110110011111100011111111111101011111111111111010110111111101110a100011111111111111011111a111101100101112211022021122211101221221002a21001011101001010101
11111111101011111111101111111111111101111111111011111001011111110101011a111101111101111011101101a110110011111112212111112011222221111010112a21010111111110111100
00111111110111010111111111110111011111110111111111110111110111001111001a111111111111111011011110a111111222012221122221212210022210210012110a02101111101111011011
11111111110111101101110111111001111101100211222102212112210122212110111a111111111111111111111101b000121021222020120120122222222122022111212a01110110110111111111
11111101110011111101101111111001011110111202002111111011212120112112112b111110110111111111101101b120121212111011222022222012221221202002012a11111001111111110111
01111111011101101111011111111111101011111121110121112210120222201010221b111111011011111111101111b111111201121000021002221221222222211021122b22111111110101100111
11111111111011111111111101011010011110101122022212122000222202210211110b111111101111111111111010a212110012201212222211111102210120201121212a02101111111111001111
01101111011101011011101111110101011011111121210220100122001111100000022a111111011111011101110101a121122110212212220222220021022111022020200a12111111111111111101
10111011110111110111110110110101111111001212101211210121101120112102121b111111111111011011111111b020101000002212222111202210222121221111010a20111011111111011111
01101111101001101111111011111001111111111101110211221211222202121112211a111101111111111111111111a122022202221122010202022102211222211200120b21111101111111011110
11011110100000011111111111011111111011100102112110112221111112200221220a101111101101111011111011a012122212022022212110112221212202222001121a22001101110100111110
01011110110110101110111110111011111010111120211120101222211010212011122b111111111111110100111111b122112011210022112122212102221221120011112b12111101101111111011
01010111111111110110111111101011110111111201202121122010101122112121212a110101111111011111111111b111021212220211220201021212222222211012221b12010111111111111111
111110111101111110101011011111111111101111212222011babababaababaaaaaaaba011100111111111110110111a121112121201021002222211222202110221222220bbbaaaaaaaaaaaaaaaaaa
111111111100011010101111111000111101111100110110222b02101002121111211212111111111111101011111111b122012202010120202101122200001221101222121111111111001111110011
111111011001001011110011111011111111111012102102112b10002112122212022111111111110111111111111111a012211111221111200010222200222012221110110012101111101100111100
101111110111111111111111111111111101111111210211212a11220211122112112201111101111111111011110111a221221212012112010222221222121000220211221202010111111111011101
100011111010101111111111111011111010101100221001120b12211012111122110201011011111111111111110001a120021121002112100002212122212101110021211011111111111011111111
011011111111111111111110110111111011111110211212011b20220101122221211111110011111111111100101111b110221222122222120021221222220202021101202011101110011101000011
110111111101110111111111111111111110111101221202012a11222111122010022220011111011111011111110001b112112021120222022222010221212020221221120112111110111110111010
111111011111111110111100101101111100111111211212112b02101112110210222120111101111001111101010111a121222112002222212212100202201111102012021010101111111101111110
111111111111111000111111110111101111101112112221011b02111220121212221021111011100110111011111111b021221122110222222202220100022120121212102021010101001101110110
110111111111111110111111111111111111101111122100102a20200221021102101120011101101111110111101011b112012102022110212212212222010212101111121022111110111110101100
111111101111111011001111111111100110110111201210122b12112201211022111212111101111111111111111010a121211121012122102121220022220212101222222110111111011111111011
001101110010111110111111111011110111011111210022220b21100222100122210211101101111101111111110111b211122222112222021211012122112100022101112121111011111101010111
001011111111011111111011111111111011111111102210221b11112121012122210112111101011010111010111111b112222221221210202121022111202122001120001221001101011111111111
011101111001111111110111101011111111110011210222202a22120222210221222012111111011111001011011010b222211211222212220222222220122111201102211212111101111101111111
111011101011111111111011110111111110001111121121210a20112011211212200111111110011110011011110111b002111111222121012222022201022221211001112122101110111111111101
001001111111111111110011011110111011101111212120121b20122222211202122111110111111111101101111111a212202211001200111022222211220202211221222211011011111111111011
011101111101111111110111111111111110010111201201112a11121202211111211121111111111111111111111011a122122210101112222112122212122202222121211022111111111111110111
100110110111011111110111101011110100111012120020010b20022201002100212222111111111111111111111110a122202221222202212012210220212111101101111111111111111101111111
010111110110001111111011011101011110111111212112102a21122222111210212112111101101111111011001010b220101212211221211111112220110110111111100110101111011111011111
111111100111101101111101111010111111001111110100102b11102101020221220222111100111011111011111111a200211121121112100201102121222111110011101101111111111011111110
