108 109
58 17
122 49
126 101
64 67
119 18
56 105
111 104
8 43
26 34

101110111010011110011111111011111101010110000111011110111111111111101101111111111011100111110111111a111101111101111101111001110111110110101111101111111101111011
111111111100101111011110110111010100010111011111101110011111111001110110111111110111011111110111111a111011101111111001111111101111111011101111101111111111101111
101001011110110111110111011010001111111101111111111010111110111111010101110011111111011111111101111a111011101111111110111100011111111111111101011101111011011011
111111001111111011011101110111111111011011111111111011111100111011111111011110111011111011011101111a111112121112122212010121200222012121101101101111110111110111
011110111111101111111010111110101011111111101111111110111110000011110111111101101010111111110101001a111012121221021002220220012122111111001111111111101010111011
011111111111111110111111101111111111100101111101111111111101011111111101111111110111111011111111101a111122112210102220222221112211212221111111101111111000111111
111011101101100011100111111111010101100011111111111110111001101111010110111100111111101111111111101a101111210210221022221201212212110221001001111001111011111111
101111101011111111101111101101111110011101011111111111101011111111011110111101111111111111111111111a110121211202022101112201221222101121111111111011111111111111
111101011111111111111111110011011111111011111111101001111101111111111101111111010010111111111111110a101121120021210220001210021120101221111111110111011111011011
111011101111111111111101101111101111011111111111111110111111101111101101111111010101110111011111111a111112112101112010201011012211100221111110111111111001011111
011110001111011111111111010101111110101101111101101010011101010011111101111110111101111110001101011a111112112110001212110012111022211101111110110111001111100101
001111111111111100111011011111111100110111101111011111010111110111111111011011111111110011111011111a111110112212010222012022122001222111111101111111111011111111
110101010001101101011111111101111111111110111111011111111110101101111011101111011101101111111111111a100111210200211222211221022221022011110111100111111111101100
111111111111110110100111110110111101110111111110111001111110111011111111101111111111101111111110011a111012021211122112212222112022111111111111101000101101111111
011111111100110111110111111111111111101111111011011110111111111111111111111111111111111111011110111a101121211021122012212221002110210011011111111010111110110111
011111111001111111111101111111111010111111111111101111101111111110101101111111101111011001111101011a111111202221122201010221222112112220110111100111111010111101
011111011010111110110111111111001111111101101101111111111111100111101111001010111111101111100111111a011012111221111212011111111221011111110111101111111111111011
1100011001111111111111111111011010111011011010111111111111P1111101111110010111101111111000011011111a111112222111012122121022220121112001100101010101110100111111
01111101001111111110111110111111110111111110111110111111011P110101110110111111111101110111101111111a111102120220212121222222100120211121110011111111011111110001
111111111112121122100211211111022221022110011111011011011010P11101101111111100111111111111101011101a111122212221222112111221121212201021110111111101101111011111
1111111101112201112122022221121111100020211111111011010111110P1111001101101111011111011010111111111a111101021222222201121002112102121220110111101111111011111011
01111101011011121102121001012122221211122111011111110111111011P110101111110111111010111111111011101a111122022202110010012212222202100021001011111111011110111011
101011100112122222000120111111121012010212011111111101111111111P11111011101101111001111011111111111a101002212211111002222221112202211221111111101110010111111110
1111111111022002022210221112112221120211001110101101101110111001P0111110111110011111110111101011000a111110110220201110222122121112212211110111110111111011111111
11011111010211211022201110102111021111222011101101111101011111101P111011111111010011101111001110111a001012111200212212222202122222001111101001111110111100110110
110101101011221120212222211122112100222121101111001110111110111111PPPPPPP11111101101110111111110010a111122210102021001022022200211111121111110101110011001111111
1111111110112022022211222112221011212122001011011111111111111111101111010PPP01111001111101111111111a010021121122122212221122121111112201111111101011001111011011
1011101110121212222122110112020110212110111111111111111111110111111110111100P0111111011111101111110a111112111201111012011122011002021120100110011111111111110111
02112121112222222112210102121221110012012211111100011111111111101111101111011P101111111111111111110a011111211112222222202111211222211110110110010110111011011111
011012121101122222102210120201221202222010011010111111111010111101111111111101PPPPPPPPPPPPPPPPPPPPPa101111012220110122210021001111212201101111111011011111111111
122120212122212202220120222120122112022011101011111111001111111111111111111111111011111011111011111P111122122222112200002112211211202221111100111111101001111111
100212120202101022202210202112121112202212111111111101111111100101011111111111111111110111101011101P011120212122201120101121221112211210111111011101110111110111
201111212102222222022210220022212212121112111111111100111111011110111111111111110111010101111111101P110102000112121120221021012122221101111111111110011111101110
112121210121022222202222012221222201122111011111111110111111101101111111111110111111111111101010101P111112220221221200021222220222202011111111101111111011111111
211202111222222222222200022022020112112100111111110111110110111100111100001100010111011111111001110P111111022112211112112021121220022021001111111111110101111111
112101022010102002022202121222110221111022111101111110111111111111111111101111111111111111111011111P111111111211112211112212011112122111121101111111011100100111
102112101202122122111201022102222021101110101110010110011111010110011110111111110111111111110110101P101101120220212102222101201212210021111101111110001001111110
221012220102122122220221120122111121102222111110110111111111111111111111111011011110101011111010110P110101110112221210122220212210220222101110101111011111111011
122102011222221220121100021210222201121112011101111110111111111101100000111001001110001111111111111P111011122212111101121121111222121102221111110110111111111111
ababbabbabaabbabbbbbabaabbbab2112110120022111111111010111001101111111111111111111011110111111011111P101111121212212121210222110021022120010111111111111111111101
1021221120112222220222120221b0212211211221111111111111111111111111011101111111101111100011111110111P111111101112210022110001101121221211211111011111100111111111
2112220011212202102122022222b2111112202002011110101111011111111111111111101111111011101110111111111P111111122212112201122200021112110200110111110110100111111111
2211200010021122222220202221b2220121221121101101111111111101111011111011111101101101110111111011110P100111010021212022222012010211112022111110110111111111111011
1210121111122022212221220201a1112100202110110111111101101101011111111111100111111011111011011101111P000110010121101101112211222212222112121011111011010111111101
1212011022112020201222122212a1122202221121111111111111101010111111111110111111110111111111101011111P110111111121120012122121212111101010100101111111101110111011
1001122020122202112212222210a2211111102021111101110101111111111011111101111101100110111111111110110P101101122212110222111102212121221201211111111111011111111101
1020112112220220221220221222b2010122112111111111100101111110111111111111111110011111110111101101011P111101122021022222201122101222120111021111110010110101011111
1112111211222022212202222022a2111221210112110111111111111111101010111011101111110111111110010110111P110101101100212120110112201112121222021011101111111011110101
0201212101121122101112222212b0002122222111111011111111110111111110111111101111111101101111010001101P101011111111000120210211221221121200211011100111111111110101
1222101011220212202202221110b0100222212102111110111011110111111011101101110101111111111111111111101P110011101120112122122221221222212121020110111111111101111010
2111201101022212221202220102a2011111100111111101111011110110111111011010111111111111101110011110111P101001021210222101202112202202121212121111111111011110111111
2111202222201211222112211112b1211100111000111101000110101101101111011011111110111110111110111111101P001110111100022120022011022212120211111111111111111101111110
1212211112101112112212121221b2211011101011110111012111111000222220022122102011221111111111010111110P111111110011211222122112201220120011021111110111111111111111
1220221212111101111111100112a2211011111010111111122222021021220122221210122112021100111111111100111P101010122212121122210111122222210120121100111111100111001011
2212110121111122111112122102a2101110111111111011012201211121011110122011122120121111111101111111111P101111122110212211121212121211211021221011111101101101101001
2201112112221101111121221200a2101001100111111111120222222112112122012022220111211011011101100101101P110010112021001222111222221111122110211101101101111111001111
2220102122221111212221011122b2111101111010110111122120210121211221111001222221111011111111011111111P101111111221102021101122110221112120120111111111001111111110
2111121220221221120121200200a1211100001111110011011210111112110122121022101100021101111110110101111P111111110010112211122121112120212121221111101000111111111101
0222210012112122122212111112b1211111101011111101120122211221121202222122111121021110111111111101111P100011112121022102111222121112110111201111110110111111111101
0111101001011111111111111101a1111001101111001101121222120122112111012221001221211110111101111110111P111111010210212221202222212202220111211111111111111101111000
1111111101110111111111111111a1111111111111111101100211212022101010111202220002211110110111111100111P111111121101102211102220211222112221111111110111100111111111
1111101000111011111101110110a0101111111011101111122022212121101211122100222212210110110111101111111P111111102022121201021121111122101211211111101011111111111111
1110011011111111111111111101a0101110101110110111122122020121121221020220002220211110110111111111111P111111111101020211212110020220112102211010010111111101111111
1111110110111011101011111111a0011101111101111101101201121121211112012112210112201111101110111110100P111011112211120222221122012022201112221111011111010001111011
1011100101111110101111011111a0010111011100111111001102112222220212220221210212110111111111111101111P111110112200001111001101102111021121221111111010111110111110
1011111110111111111111111111a0011110101100111101111220212022110112221221111111011101110111110111101aPaaaaaaaaaaaaaaaaaaaaaaaaaaaaaaaaaaaaaaaaaaaaaaaaaaaaaaaaaaa
1111111111111001110001111011a01011011111111011011200112021022122212111220102222110001111111111111011P11111110111111110011111011111011111111111011111100111111111
1010011110111111110111111111a01111111110110101110212112211111210111110121101022110011110111101111111P11111111111011111101111111111111111001101111111111111110101
1111111110101110111111010111a11101111011001111111110222122222202100101212110222110011111101111101111P11111101111100011111101111011100101111111111111111111111111
1111111111110111111111111101a11011110111001111111210211122122122111222111112121111111111010111100111P11011111101111110111111111111111111111100011111011011110111
1011111111111011110110110110a01110101011110111110110201020221122222120211002110210110111111011010111P10101111110111111011101111001011111111110111111110111010111
0111111111111111111110111111a11111111110111011111222212121122120122012220021212101101101111100111101P11111110111111111111111101111111000111110111101010011111110
1001111111101111101111111011a11101111011110110010120201211102112211200222122122211100111111111111100P11111111110110011011111110011111011100111111000011110111001
1111101110111111111110010111a01111010110111111001021022002122110120221102121112110111111100101111110P11010011111100011011011111101010111011110111110111010110111
1011010100111101101111010111a11101101111111010111010021222210221222111002110111211111110111110110111P11110111111111101111111111111101101111111111111111111111111
1111101111110111111101101101a01111100011111101111110222211122110122222122210211111110011110111111010P11111101110111011111111000000111111011111100111011111111111
1111111010011010101111111110a1101111111011011111122112111121110211121222112110110111111111111100111P110111111111111011111101111111101111111111111111111111101100
1111111101111011101111010011a1100010111111111111120001221002122020111210122202121110101111111111011P111011111111101111101111111111111111101111001011111001011111
1001111111011011111111111111a1111111111110111111110021201210011112012122012211121111011101111010111P111011011110111111110111101111111111110111001111011111111011
1111011110111000111110111111a0101001101111111110121222102202101111221222212201211111111110101111111P111011110111111111011111010110111111111111111101111111111110
1010011111111101111111111111a1111111100011111111111022222201222212211111202110101011101100111111101P111111111000100111111011111001111010010011110111100110100010
1111011111111111111001101010a1111111011111111111110221212220221111221111121112201010111111010101111P110011001111111111100111111011111101111010110011111110111010
1011111111111111111111101111a0110011011111001110110210122120211211020121212112000101111111111111110P111110111111111111011101101111111111011111011111111010111010
1011111110101111101111110011a0111111101101111111111111111011111011111101111101111101111110111111111P111011000101110010111111111111111111110011011011110111111111
1011011011011101011110110111a1111101111111111111111110110011111110111111011011111111111111111101111P001011110101111111010111111111111101101100111111111111111111
0111111111111111111111101111a1111111011111101100100101111111101101110110111111111111111111110111110P111101011110111111111101111110001111111100101101111111011110
0010111011111011111110111111a10111110101111010001111011111111111101011011011110aaaaaaaaaaaaaaaaaaaaPaaaaaaaaaaababbaaabbbbabaaaababbbbbabaaaaaaaaaaaaaaaaaaaaaaa
1001001101011101111010111111a11011110010010111101111111110011101111011111111100a1100111111001111110P101110111112102111110001122112221002110201111111111001111111
1111101011110101110111010011a11110101111011111111111111111101111111110111101001a101111111110011111P1011111011112121221212121011112202120222211011110011101101111
1011010011001111111111111111a11111111101111111111101110011111011111111101111111a010110110111001122P0201111121220112120002202021021222112011111011111110111111100
1111111110011111011110101111a11011101111121221120211100212120011212221211111110a0110111111111111211Pbbaababaabbbaabbabbbaabbbbbaabaaaaaabbbabbaaaaaaaaaaaaaaaaaa
1110101111100111101010111111a11111010011120012111120111212122002210110210011111a1110111111111111102P112121022012122022121212211221021211121011111111111110111111
1111101111011101011111011111a11101111000110221111112111010012122122222201101011a1111001111111111221P112112222221221022022012222120220211112122111101110101011111
1101111111111111111011111111a11111111110111102002111002121101120212112121111111a1111101111111111120P211002222112222100202021212111202012001212111111101011011110
1110111111111101011111111101a11101111111120211121222210112200011211112200010011a1111010110111111202P211110202221212202220210122021102211202212111111101111001101
1111011011111111011111111101a11101101111111002011212220222121112222111111100101a1101111011111111222P112222022122121222121222222222122222221002111111111111101111
0101110001011011100111111011a11110111111122211222222112010212210121221121111001a1101100011111001102P221220102022012011202221112112221220122211110111111111111110
1011011111101111111111011011a11101111111111121011121212210222111010021201110111a1111110101111010120P121001222212222220222201222221212222201211111111111110100010
1110101010111110011010110101a10111110111110122221022001120202012211101211101111a0111110111100111220P222022201120212122200000222122221101202112111101111111111111
1011000111001101111011101111a11111111111121222222102210001012220020212021111101a1111011111111111112P210122111011222211211220220212112021021112111101111010111110
0110111111110001111101111011a01111111111022122221110011201222221200222121111111a1111111111101111011P110220122111222012122012110111222112011211000111011111111011
1111111111110101011010101101a10111111110101202112210112102011200110122111110111a1111111011110111112P222002021210010122112012122201112100210211111111111110111111
1110111011111111011111100010a11101111101121121121210122121121121222021011111111a1101111111011111111P110112202201002222012101120222021020120121011011111111100110
1111111110111110111111111101a11011011111112112221212112210210210212021211011010a1111111110011111221P112122120102212221222121122212112221222022111110101110111011
1111111110010100111111111111a00111111111122121022221211220112111110122221111111a1111101111111111001P001212111211102210202012222021002121210111101111111011100111
1001111111111011111010110010a00011111110022210121222211122112012022121011111110a1111111111111100110P001122222102202020121122202021012222112100111111101011110101
1111111111111111011011101111a00011101101110112211102122201111111122111211011111a0101111100100111212P011122120122012222122221202021120112011221111111110011111111
1111011100011010011111111111a11001111111120122210000011011121122121101021110111a1111111111101011121P100111121122022021210202222212201120011222011111111111110110
1110111111101111111111111111a10110111110011111210112210101212122222212100010111a0111111011111111221P220020010222122200222211200121212001102111111111101110111111
1111010111101011110110111111a11111111111111202211022222110221201002112121011111a0110100101011111012P21221101P102101212222121202102110212111220111111111111010101
1111111111111111111101011111a11111111111110221111120020011022220220210111110101a1111111111111111122aPPPPPPPPPabbaabbbbbb2221220212110101120002111111111111110111
1111110101111011101011101111a01111110111110012122202212220112121121221201011111a001111111111111112222222221121222220222b0222220121112022101122111111011111110011
1111010111110111111111110111a11111111111121002111101100112122021012100211110101a110111011111110111212200012220222202000b2102211222112212112201110111011111110111
0010111111001111111011111101a11101111111120121122122222210220022222220020111101a111110101110111101112221220010222222021b0022200001202020112221111011111110110011
1101001011101011011101111100a11111111111121221111211111220012100112212221111111a110110111111111011122201220220121201002b0122121221121122121000011111111111111111
1111111111111110010111111011a10111101011111102212221222122021121012202221111101a111111101111111121011202111212122010222b2221222222211212122110110111011111101111
0011010010011111101111110111a11111100111122212101112211212011212222211201111111a111111110101101111012200111022121222222a2222212121221011221121111110111111000111
1111111111110011111111011110a11011111100010101111021110220122122212112111111101a110111101111111012111221021220222002112a2212222101111111111111011110111011011101
1110111111110011111100011011a11110111101110220110012222111111221202011021111011a101101111011111102220221210112111200212b1111112111111101110111011100111111011000
1110111111111101110111111110a10111110111011210200121211002220111112121221111111a110111111111111022212212220121121212212b2121202111111111111011110100110111110111
