20 111
34 14
122 49
126 101
64 67
119 18
56 105
111 104
8 43
26 34

010011111111110101110111111101111110111111111111111100111111111111a1001111111111111110a001101111110111111111011111111a100101111111111110111011110111011111010011
011111101111101111010111111101011011110111101111111111111111111111a1110010111011101111a111100111000111101011111001111a111110011111111111110011111111111111000111
111111011100101111110111110011011110001111110110111111111100110101a1101001011111111110a001111011111010111111111111100a111111011111111101111111101111101111101111
111111111111111111111101101110111111111100111110011111011111101101a1111111111111111111a011111110111111111212222212122a100012021122022111111100101110111001111111
111111111111111111011001111101111111111111110011111111001111111101a1110111110111111000a111010111101101110021222112222b202021111101202111001111111010011101111110
aaaaaaaaaaaaaaaaaaaaaaaaaaaaaaaaaaaaaaaaa1111110111111010111111011a1001111101110101111a111111111011110111211102101101a100102012201222121111111110111110101111110
1111101111111111001111111111110111010111a1010110111111101110111111a0111111111111101111a111111010101111111122112011222b122022221011121121111011111001111011011111
0101111011101011101111101001111110110101a0101101011110111011110011a1111111111101111011a111011111111111110222112012101b122111201111211211101001111111100111111111
1011110101111111110111111110111000111100a1100011111000101111011111a0111111001111111111a101111111111110102121011002212a101112102112221110011111111111111010011111
1001101011100001101111111111011111111110a1110111111101111011111110a1001111011111111101a111111111110111001210112112210b221102011221222211111110101111111110001101
1101001101011111100011110111011011111111a0111101111111111101111111a1111111011111110111a001001111111100112122211222020a201122112221011020110111111011111111011101
1110111111111111111010111111101111110111a1111111111110110101111111a1011101111111111111a111111111101111101101221222122a112122202112211121111111011100101011101011
1110101111101111011111010111101111111110a0111101111100100111110111a1111111101110110111a100111111111111110120221202202a221010212221222120111011111111111101110111
0111111011110010111111001111010111111111a1111101111111110111111111a1011011011111111110a111111111011111112202120211012b222202112221122221111110101111110010111101
1110110110011111111100110101111011PPPP01a1100101011011111101111111a0111111111110111111a110011101111111112001111212222b211222101121021111011110111111111100111111
11110111111011111111001111111111110100P0a1111000111111101111111100a1111101111111111110a101011001111111112221001022201a112011102211102121111111110111110011101111
011111111111101111101011111101111110001Pa1011111011011010110011111a0111111111011111101a101111011011111111121222111201a222110221221210001111111111011110111110111
0101110111111111101111011011111110101110P1011110011111111011111111a1110011111111111010a111110111111111111212122220222a101211212202012101111010110111111111111111
1111101110011011110111111101010101111111P1110111100111111111110111a0111111100011100101a110111110110111102121012202212b122201221121202021111110111010101111110111
1011011011111002112211120111201112112022P0110111111011101111110111a1111111111111101111a111111100111111110012202211211b110020212211212211111111111111111101111111
0011111101112110121201012101120121212210P2111111110111110011111110a0110011011111110001a111011010111111111222012122112b121022112111100101011111111101110111110101
0111110110020011102012102212222122001121P1110101111011111011111111a1111110111111111110a111110111110001012212202121122a101112112120200210111111111011111110111110
1111110011110100121022111112122122222200P1101111111101111111111101a1111111000111010111a111111101110111111212121212021a201222110112212121111111111111111111111001
1111111111102222102121112212112211212102P0101111100111111101111111a1101111110111011111a110111111100111010211201201111a102121021121111221101011111101111111110111
1111010111112101012110122212201111112022P2111011011110111111100111a1111110111011101111a110111011111110102102101012210b021202212011000221111010111110110011110110
1110100011111211111110221212121111022201P1111110111101101110011111a1111111111111110111a101111000111001102220210110211b212122112101210220111100111111111111101111
1111111011022211101211221012011221111020P2111110010111101111111101a1111111101011010111a111111111010111112000122022021a102111122220000221101111111111111111111101
1101111110111122212022101222112110110212P1111111010110111111111111a1111100111110111101a110101111111110110001210112221a122110111212211111111111111111111110110111
1222112120012120212220220222222110210212P1101111111111000101010111a1111111001111101111a111111101111101110111101000211b001111211201122221111010101111111111111111
2212211201110212102202222212111221110210P0111111111111111110111101a1111100100111111101a101011000111011101111221022200b001222211111221121101101111110111111111101
2212220102222220210022022120221122212101P1111111110111001111110100a0011011111011111100a111111001110111010102020212101a222101010120110021111110111111111010101101
0121211122002022222222220201220210012110P1111111011111111111111101a1111111111101101001a111101100111011112212222022122b121011202000110021111111111111111111111100
0222212212122222211022222020110211112121P1111111011111111111110111a1111111111111111111a110010111111101111102221212201a202011200212202111111011101011111111101111
0001222222222220212222022222221102221101P1111111010101110011111111a0110111111110111011a111111101010010111112220012012a211102221112122111111011111011010111110110
0101211122012110222122012222221111101122P2110111111011111111111111a1111111101111111011a111111111010101111112221101222b021121200122201220111111111111111111111010
2202111211122221221212201211122201211211P1110101101111111110011010a1111111111101110111a110011111111011111011111001120a111122212111211221111111111001111101110111
1122221012122102120012012112222101021121P1111011111010011110111110a1111111111101110101a111101111111011111011002021022a200211222212112122001101111111011011101110
1022112102222212202112112201212111002202P2111011111111111101111110a1010111111011001101a011111110111110111110211211122b202011221121202221111111101111101011111111
1122121012220122002202202012021021102212P2101110111111111111101111a1011111101111101111a111111111111001101110011112200a110221120210110112211111111010110011111101
1121111210220212222022211220222110022102P1111011111011101111111110a0111010111101111010a111110111111111111011121121122a210021210211111010221101111100001011111010
2121012221111222102212212222212100121211P2111111011011001011101111a0110111111110101011a111111011111111111011011011120b210222122202011211211111111001110111110111
2021101201211122022222220221020112100222P1111111101111111101111000a1111011111001110111a111011010011101111011222020111b022221212111002201020110111111111101111111
2222221222102222202222220021222220021111P0111101001010111111111111a1111011111111011101a110100101111111011112101201201a002121222112102222110111111111111011111111
2220121022222022022122211022202221201012P2111111011011111111111111a1111011111111111110a101111111011111001112112222222b012202111112110012011110011011101101111111
2220210111100122222222222222212112122111P0111010001111001111111111a1100111100010111111a111111111111011101110120020102a221210221021221111111111111100011111111100
2021112202020201211201122222120010211211P0111111110111111111111111a1111101101111101011a011101111011111111011012111112a020220000221121212221110111111100111001111
2112212121210100222221022212120120022000P2111110101110111111111110a1101111111110100011a111111110011111111111002001212b001210221022121211121111111111111101111101
1222220220221221200111222220222001110111P0111111111011101111111011a1111001111011110110a111101110111111111112111120212b211211122212222221221111011011111110011111
0120112112101221202120212220221111210202P2111101111111110011111001a1010101111111111111a111111111101111011101011121211b121110021110111121011011111011111111111111
2112222022212122222221112121022011121011P0111011101011111111010111a1111111111111110011a111101111110111011111112210210a120112121122222222211011111111111111111111
2110212112021101122222122021210111111111P1111111111111010110110111a0111111111110111111a010110111111111111001221200011b122110210222122221210101111111101111111110
0102102222001210022221201201001011010010P1111101111011111001111011a1101111111111111011a111101111110111111101222110120a011120022120121212021111111111110110111011
1100120012122122112121022112202100111111P1111011111122221110222201a1221211222022011111a111101111010110111110202202100a221121210211112121221110111100110111001111
1111211122112221111112012111122111111111P1101111122211222220012101b1221210211102111111a110111111111111001112102112121b102122220122012222111111111111101000111101
1210120212121022001121122222220101101011P1111111002121210212222002a2211101122102111111a111010111111111101112012211211a002222121112001112110001110111101111111111
1211122110102221222211121021002111011011P1000111012111101122210120b1021101222212111111a101101111111111111010212211220b221001120021111222201111111111111110111111
0221121212020220221220012111121111110110P1111111112011210000102012b0111022122020111111a111111111111111111112112122112a121120121221111122221111111001110101010111
2222212210012002111221022112121001111111P1001111121221221112222111a2222101221122111111a111011111111110101111111122212a211111201222121212021010111101011011111001
2121122112102210122120122122021110101101P0001110101102002201110112a2221121020201111101a111111111010011011112110022222a121110012221122111011111110111001111111110
0011011100110111111110011111101101111111P1000111112112221211022111a2101212110001111101a111111011011111111012122121120a201211022101121222211111101111111111111101
0111111111101101111111101111000011011111P1101110122100220011112112bbaabaababbbabaaaaaaa011101111101001101012112222101b002120112212022221201011101111010110111011
1111111011101111111110101111111111101111P1010110120201221112112212012112110222121111111011111111011111101110111111211a202211002022111101221111011010111001011111
1101111101111110111011111111111111111111P0110111102122221012212211212112120112120111101110111111011111111112222221121b222202202112211020221101110111111110111110
1111110111111001101101111101011000010111P1100110001100011112221122201202211222221111111011111111111111111110012121211b222122221110021220121111101111111110111010
1110111010110101111111111111111011111111P1111111012200111221122110220221122222221111110101111111100101010111011201021a222112111001122021021111101010111010101111
1111101101111111101010111000101101111010P1000111102022121221221011202221201220221111111011100011101111111110111010111a111101110111011111010111111111111011111111
1111101011111111110111101011011111111111P1011111102211020120111111221122212212001111110101111011101100011111011111111a010110111110111111011011111111110110110111
1101111110001111110110111101011111100111P1111111112221010220120211111211002100121110011111111111110011111111001110111a111100111111110111111011110111111110101011
1111111110111111111110110101101101111111P0111111111022121121111100201222022011111111111111111010111111111111010100101a100111011111111111111111111111011111111111
0011111111001111011111111111011111011111P0011111110212211012111221222112212101111011101110111111101011001111001101111a111111111110111111011110100100111101111111
1110011101111000111111111110111101101111P1110111122110011121212011021210111222211100110111111110111001111101111111111a111111111011101110011101111111110101111100
0110111111101001111111011111011001101100P1011011121110220121112221220011010202021111111111011101101110010011111111111a111111001111110111001111111110111111110111
0110111110111111111011110111101110101100P0101111121211211121022122211211212121210011111111110111111011011011101101100a111011001100101011111111111101110111110111
0011101011100011111110110111101110111011P1110011121212122202220121221021121212220111111101010110111011111000111111111a011111101111101111101011111110111011111111
1111111111110111110111111101111111111010P0111111122221212210001110012110111112101111111111110000111011111111111111111a110000111011111110011111111111111110111111
1111011111111101111111110001111111001011P1111101021211020212212211021122112212110011011111111110111011011111100110101a101101001111111111111111001111111111111111
1111111110111011110001111111110111111111P0111101011122021211110210220212211021021111110110001110111011111111101110111a111111111111111111111101100110101111111111
1111111110011001101111111011111001111111P1111111102112222222222211102210100210121111111011101111101111010111010101110a011110011101111111111011111111111111101111
1111111111011110111111111101111111100111P1001111121000100120222201201000012022111111111110111111111111101110011111111a111111101111110111110101111100110101101111
1101111110111101110010111001111110111011P111111111111211201200aabbabaabbaababaaaaaaaaaaaaaaaaaaaaaaaaaa11111111111100a111111110100111110011011111111111111111111
1110111110111111011110111111011101111110P111111111021221002001a111120212220222211011011111011111101111a11101111110101a111110111101111001101111111110111110111110
1111111011111111111101101111011111001111P111110111222012002020a002012211212212001111011101111011111111a11101010110011a111110011101111111111111101111111111111011
1011101111111100111110010101110110111111P011111110101101121210b121120221010202211110110111011110001110a11011101111111a111110111011110111111111111111110110011111
1011111111111111111111000111011111111111P101110110110111011110a011101111110110111110001101011111011111a10111111111101a111111111101101011111111011111111010110011
1111111110111111101111111111111101111111P111011101111111111110a101111111111101111111111110110101011110a01111111111111a111011010001011110110110101110111111111001
aaaaaaaaaaaaaaaaaaaaaaaPPPPPPPPPPPPPPPPPa101101111011111111101a011101111111111101111111111101110111111a11101111011110a011111110011111101111111100111110110010111
0101011101111100101110P111111111111111111011111110111101111111a010111000111101111111111111111111111111a11010011111010b210220121101121222100211110111011111110111
011101101111110011100P0111011111111111111111101111010011111011a011111111111111111010111111110011110111a11011011211022a212221121211212211200112111101111111111111
010111110110010111101P1110100111111101101111111110011101110111a111110111110111111110110101111101101111a11111111120201a112122110021001212122002111111111110111111
100001011111111001101P1011100110111011101110111111111111111111a111111011001111111111111101111111222211a00222122220122b222212122112101210201021111110110110001101
111110110111010111111P1001110111111010111201121110110212222222b201222012101111111011111011111011120210b21222222220211b202102200102122012110110111101010101111111
111111111101111110111P1100111111110111111020010021210110021000a021202121111111111111111111011001021220a12011212221002b122022222210120002022001111111111110111111
111111110111100110111P1111110111111111110221111122012112211122a211101021110111111110011111110111222021a12221022112222b222222201221121212012200011101011111111111
011011110111101101111P1110111011111110111011112222211110022021a210212120111011001111111111111111211111b12121100000210a222201222021122221001101111111110101111011
001111111111111111111P0101011110111101111221112111021021011221b122021222111111111001101111110010121012a01212212222010b122221102121201012112210111011111111111111
101110111100111110110P1111111110110111111201211122211010100021a012021021101111111110111011110111211102a21222221221220a202222222210011222202210111101111110111111
101111011011110001110P0111110111111101111212211020222111110102b211010021110110111111111110101110101122b11212201102220b212022212121220112022110111110011011111111
111110011110111011110P1011111110111111111112210000121020222212b221102202101011110111111101011101010211b22222222212010a222220002112212022021222100111101110111110
101111001101111011111P0011110111011111011202122210011020222201b212201120101110110111110111111111222111b00012212212222b220200122001212112122111110111110110111010
110110110100101110111P1111111111011111111201212222212221102221a220112221110101111011111011111111101200b20122021222022b220222110202122012212012111101011110111110
110111111111100111111P0111111111010111110020101122010002202122b120010022111010111011111001110011220122a12112221211222baabbbbbabbabbbabababbabaaaaaaaaaaaaaaaaaaa
011111101111011111110P1111111101111111101021122122220020202112b201012111100101111111111111110111121202b212221021221212122122222212110220122222110101110111111110
11101111101110101111P11111111101111111101212102210111212211212a211120100110011111111111110011111100111a121210210222222212201220012120201121010001111100011110111
01001110111111011011P01011110010111110111200211022111012111121a102222112101011001111110111011111121200a111222102021122221122022201101221122120000111110011111011
10011111110101111111P11111111111110011111121020212222120210011a121112112111111111111111111010111120122b222112212221011222122221122222121102120010111011111100111
10111011111111101111P11111111101111111100122010212110210221211a221121112111110101111011111111100120210b022102022101122122202221020220201212222111111100110111111
10011101011111110110P11111111111111110101102001112022211200221b121121111111001110111111111111111121212b111212212012102012111122101211112211221111111010111010111
11111111110110101011P11111011011011101111101200122112121211201b221201200111111011111111111111111100211a120000020121011212211022021222221002222011110111100111011
11111110111101111010P01111010111011011111022120110220121122222a102122101111111011111110011011111200110b012122202222222221222202112121212020222111111111011111111
11111111111111101111P01100011111011111110220211220112111210102a010020201101111111001010111111111112112a121121112222222212000222121112221222221101111111111101111
11111111111110011111P11111100011110110001220121201121212111112a021210112111111111111111110111011111110b222121221222022221221200012222002110221111111110011111010
10111111111111011111P11011101110111111101020212202212222221221a001220202111111111111111101101101110212a012022122222220120222222220101100221021111111110101111110
11111111111111111111111110111010111110111212221212012122212112b122210021011111110101111011111111211202b211201122122202022222221111101220220121110111111011011111
00111110101111111111011001111111111111111112112222122220121001a111202111111101011011111011111101102201a121210122212222201221222221122101221122111100100111110111
11111111111010111111111111110011111111110012122001012121101221b200122111111111111110111001111101012211a120211120121221222202122222111201222101111111110111011111
01111011110001111111111100110111111111111021112011112202012102b111221012101111110011111111011010002121a212221012222222222221220222122112222011111011110011111111
11100111111111111000111111110111011101110121100212002202112102a112220122101111111111111111110110100112b222210102222221222212021122002211111210111110110101111101
11111111111110111111111111111101011101111222221012011121101220b201111212101101111111111111111111120222b212111111210002112200122100110111111111110110110111111111
11111101101011110111111111110110110110011212112211202102112122a211201112010110101101111111011111102121b210011221221111200111022111111110110110011111101111110110
11111110111101110101001111011011111011011221112111220210210001b122021121111111111101101111111001112202b122120110121100122221201100100111101011111111111101111110
