80 119
104 11
122 49
126 101
64 67
119 18
56 105
111 104
8 43
26 34

111111011111a1111011100111111111a11111111110101111110111101111111101111111011111111111111111111111111111111011111a11111111111010000111111011111111a1111111111111
110111111101a1101111000111111011a01111110001111110111111111111111111101101101111011011101101101111111111110111111a11111110111110111111001111111101a1110111111111
111100111011a1101111111110000111a11111101101111100111111101010111111111111111111111111101111111101111111111111110a11011100101111101111111011111001a0011111011111
101111111111a1010111111111110101a11110011110111110111111111111111111001101111110001111001101011001010111100212102a00112220112212212021211111110011a1111111100101
111011111101a0111111111101111111a11111110111111111111001101111111111111111110111111011111011110111011110101002202b22122200111221200122111111111111a1111111101111
011111111111a1111001111110101101a01111111111101110001111111110100111101110111011110111110111111111111111102120200b01211122222021021222101011001110a1111001111011
011111111011a1110111111111101111a11100111111111110110101111011110111111111111110101111110101111111011110211101221b11200122112112212012211111001111a1011011111011
111111101111a1101111111111001111a11111111111111111111111111011111011110101101110011111111110111011111111111022201a10222022121122110212211101111101a1101101110111
111111101111a0011111111111111001a11111111011101101111111111111111110111111001111100110101111111111111110212110001a12221101021210212000111111111111a1011111101110
100110010111a1101011111111111110a11111111111111101111111111101111111111010111100111111011011001010001111211220221a21211011211112022021101111111111a1111011111111
101111111111a1101111111111110101a11111111111111111101111111011111111011101111111001011101110111111011101021120210a10012102220021202101211110111111a1111111000111
111101111111a0111111111111111111a01111011111110111011111111111111011011111101111101111111110111111101111P02211212b21102201222221122210211101111010a1111111111011
101111111111a1111111111111101010a1111111111111011111100100111111011111101000110111100111010111111111011P210221122a21022222221020111222111010111111a1111111111011
110101110111a0011111111101111110a1110111101111111111011111101110111111100111111101111101111011111111111P221220002a12002102100011211211210111101110a1110111111111
110110110111a1010111111011111111a0111111111111101111101101101001111011111110111111101111011110110111110P120200022b21111122211110111221201101111111a1011011110110
110110011111a1111111101101011111a011111011111110011110101101111111111111011111100111101110111011111101P1111112122a10212120011202122211211111111111a1111111111100
100111011011a1111111001111011111a110011011101011010010111110111111111111110111111101101111011110100101P1212211101a22201120221111221122111010011011a1101011101101
111111111111a1111111111111111111a111011111011111111101110111111111111111101111010111111011011011110101P1212212112a01112122212121022212101111011110a1000111111111
101111111111a1111111101110110101a111111011111101111111111001111111011111111111110001011011111110111111P0212102112b12210122022121001120210111111001a1110111111111
001111111011a2111112221212211210babbbbabbaaaaaaaaaaaaaaaaaaaaaaaaaaaaaaaaaaaaaaaaPPPPPPPPPPPPPPPPPPPPPaaabaabbbaba01210100222210112010211111011111a1111101111001
111111111111b1120112222122222111bb0200110111100011111111101001111011111111111111P11101100011110100011011112121011112201122121111221221211111111011a1011011111111
101111111110b2222122002201021211aa1010110211111011111001111111111100101011111101P11111101111110111000111111122012122012111122221102122111111110111a1101111111010
111101110111a1120021021122111220aa1212011111011111111110010110111111111101111111P11010001111111111101001212221002002110101212211110122201111111111a1111111011111
011011101112a2211011012101110022bb1011011211101110110111111111101111101110111101P11101101101110111111011020120201211112122122021212212211111111111a1111010111111
111111000101a2011202001000211102aa2110111100111011101101111111111101111011110101P11111011111111101111110212101122001102011122122001111210111111001a1111101111111
111100111102b2221002222012210101aa2121122101111111111111111111100111111110110110P10111111111001110110110222210212100110111122012121221201111111011a1111111110110
010011111111b1020200110212111021bb1222102111111111111111111100111111111111011111P11111011111011111101111211202012110202012021012112012111111111110a1111111111111
011111110100a1012101220122001210aa1012211111111111101011101110111111111110111110P10111011110001011111111220211111021112121211122221210111111111111a1111111011111
101101111212b2212001202211011121ab1222102011101111010011111111111100111110101110P11111111111100111111111011212122210221122220122000102011111111111a1110111010011
110222121101b2222222222212222222aa101111120111100011111111111110111111111101110P111010011110111111011110222212201122120102011121000222011111111111a1111110111111
212022222120b2112022220202220202aa211221111111101101011111101111111011111110101P101101110011110111111110212221222122120112010112222111211100101101a1110010110111
121121202222b2221221222220222202bb122211121111111110111011110111111101101100111P111110101111110011111111220212012112111200122220211112001101111101a1011100011100
222221210220a0202212220001221221bb200112221100111011111011110111110111111011111P111011110110101111111110222020122112011221222110102011110010001111a1111110111111
200220120122b0102222222210122210bb012202221101110111011101111111110101011111111P101011111000111111101111102102221121211201221122222102101111111111a1101110111111
121021121222b0121222212222221221aa011222211111111111101011111111101101111111111P111111111111111111101111111111011011221122201201221212002211110111a1111011111101
211122211012b2002021222210101221ba112121110111111111111011111110111111111001010P111110011111111111111110101211121121102111111200001222112210001111a1111111011111
100110221020a2222220122021221201ba20122122111111111110011100011111011011101111P1111111111111111111001011111222111120212212111212111011021000101111a0100111111111
111120112112a2201122222122212020bb01111222110001111111101111110101111111101111P0110111111101111101100010111121211112112212211110222122202011111100a1110001111011
222212111122b2222222212110221220aa22212200111101111111111111011111011000111111P1010101011101101101110011111022122120221110012222110120110111011111a1101001111001
121111122022b2201212122022221222bb02222222111111011101011011111111111101111111P1111111111110100101111101111122111210110112222021020022202011011111a1010111111101
202012121022b1112212220222202221aa10021221001111110111111111101101111010111111P1101111111111100011010011111101222102110022001102221121121001111011a1111001111111
111212122112b2221222220222002221ba21220011111111111101110101101111111111101101P1011110111110100111111111101110211012121112000002021110221211111101a1111111100010
111122111222b2222002120020022221aa22121212111111110110011101111111101011011011P1111111111111101111111110101021201121201221101111202002122011111111a1110101101111
212221111112a1121222022202222210ab21220021111111111111101100111110111011111011P1111111111111111001111101111010121201111221021111220212122011011010a1101111011111
212210102112b1012222222220210222aa12222012111011110011101110011111110111111111P1101111011111111111111111111120210121111111212211001101012210111110a1011110001111
221221212012b2122102221022201020aa21211102111110110111111111110111111101101011P1011111111111110110111111111102212202020211011120212212001111111011a1111001101010
221222021101b0222222110202022202aa22221112111010101101111010100110111110110010P1111101111111011011111111111202122221012002210011110212110111111110a1101111111111
102022102112b2200122221222102002bb2221111111100101100101111110111111111011111P10111111011001010111111101101120121221211102222212112201102211111010a1101111111111
112111121210b2022121212212120222aa2121120111111111100111101110011101011111000P11111011111111111111111101111221222011120202111201222121102111101111a1111111111111
222022212122b1222221022211210011bb0210112110111011111111101111111101110111111P11010111111110111111111111011021122122221101220011212201202211111111a0110111111101
122222112101a1211222021012012221aa1010111111011111111111111101011000111111100P11011110100110111010111111011111022121210122211122110120100001111110a1111110011111
022222211121a2102221010022120201aa111011111110111110001111111111111101110110P111111011011101101101101101000210211102222001212220021221101100111111a1111101111111
111121101001b1211212122202122111aa111111111101011221101120111201201102222222P112001110111111111111101111111222011222211210100222112122011010111111a1100011111111
012122122222b1110121200101122101aa11111011111110102211111112110122222111221P2021101111111111100110110111111210101222112222220201122221201011111011a1110111010111
101211122121a2111022111122212221aa01001111111110002200210211110020102210112P1210001111111000111111111111111221121212220211121121201222112201111111a1111111111111
122211012210b2012221111122112211aa11111101011110012212021210222022022212000P2111101100011111011101111111111221021111022022112102122121012210101111a0111111111101
221222220211b0120111022112111200aa11111010111110121202002112011201012221022P2001111111111111111111110111101212012112110201221222020212211111011101a1111111111111
102220211121a2021000211221212221aa1111111111110110110100111012201211101111P01122101110111111100001111111011121012122202111111101222111112211111111a1111110111111
010221100211a2112012221112210121aa1111101001110011201212211211212200110011P12111011111111111110011111111011121020212112221112021101201022111001111a1111001111011
111110111011a1011111011111010110aa010101111011011212210122000aPPPPPPPPPPPPPaaaaaaaaaaaaaaaaaaaaaaaaaaaaaaaaabbabbbbbaababaaababababaababbaaaaa1111a1110111110110
110101111001aaaaaaaaaaaaaaaaaaaaaa111111011111111012202212102P2011222112211211011111111100111111010111110011212022212002212221111022111110101a1111a1011111110111
111111101111111111101111011110110a111111111111011021121120110P2210002120022022201111010111111110111111111011112111121120220121122122122212011a0111a0111111111111
110111101111011111111111011011010a101011111110111112202211101P1201200100121020111111111111111111111010111110120011122121112212122111010021111a1101a1111010111011
111110111110111111110011110111111a011111110111010111121122010P1222222100111222221101001111111101111011111112021222221211201122221221211101010a1011a0011111111111
111111011111111111011111111111110a111111011111111212121021211P1212011110122211021111111111111111010101111101210111002022202211000112201111110a0110a1111111111101
111011100100000110111111111100111a101111010111111212112100121P1210211011212021111111111101101101111111111111111111111110111111011111110111101a1110a1010111111110
111110111111111101111111111111111a111001011111111111121201011P2122000122121121210111100111111101111101110111101111010111111101101110101111110a0110a1111111011111
111110111111100111111111101111101a011110111110111202121222200P1222021200212102121111101111111111111111111111111010110111111111111111111111111a1100a1101011110111
001110111111111111011011111011011a111011010111110112102111011P1011222022021111211111111111111111011111110110101110100010111010110111111101111a1111a1111101110111
111111011111111111111111011011110a011111111101111102112102111P1121112212221221200111111111111011110110110111111001111011010011111110101011011a1111a1011111111111
001111100110111011011011101110111a011111011011011112202221222P2100202120212011211111011011101110111111111111111111101110111101111101011011111a1111a0111111111111
011111111111111111111111101011111a010001011111111011012112011P1202122221011121111111111111011011011111101111111011111110101001111011010010110a1111a1111110010111
111111110111111110111110111011111a111111111111110101111122012P0221202201122212011111011111110111101111011011100111110111111111111101101111111a0100a1111111111000
111111011111101111111111111111111a110111101111111110002011110P0210021222222202111110111111101101101111111101011101110111111101111111101111111a0111a1111111010111
111111111111100111111111111011110a111111001110111022121202220P1022121221022212211111110111111111111110111011111011101011101101111100111011110a0110a1111011111110
011100111111111110110111111111110a111010101111110202110212111P0122200012222122111110111111111111111101111110111011111110111011111111111111111a1110a1101101111101
111001001111111111111011101011110a111111110111111102221112121P0221111202220101201001011110000110110111110111111010101110110011101101111111101a0011a0011110111100
111110110100101111011011111111011a110111110111110220212210121P2222201021112110121100010111111111100111011111111110111110000001111111111101111a1111a1111111101001
111111111111111111111111111010111a111111111001011110012211212P2111111222212210120111111111010111111111001101110111111111011111111111011111110a1110a1100001110111
0011110101100aaaaaaaaaaaaaaaaaaaaa101101110011111022021022002P1122111220212022021111111111011111110110111111111100111111011111011011111111111a1001a1010111111110
1110110011111a01101111101011110111111110111111111101112112010P2221112212211100201111011101101010011111111001011111010111111100101110001111011a1101a1110111111111
1111011111011a11110100111111111111111010011100110100102002201P2210110221120112111111010101110110111111111111111111111110111001110111000101101a0111a0101100111111
1111111001011a11111011111001010111101111111110111222000120202P1120222110120112210111101111010101111111101110111111111110111011101111111111101a1111a0111111100011
1101011011111a10111011011111111101111111011110110011110111111P1111111111110011011111111101101001010111111000111111111111101111111111111111101a1111a1111101101011
1111111101111a11111101111111111111111011011101101111100101111P1101110111101111110111100111101101010111111110101111111111111111011111111111111a1110a1001110110101
0011110010111a11111111111111010111111111111111110111101111110P1111111111111111111110111011111111100111011110111101111101111111111110011111011a0011a1111111111100
1011110111011a10101111111110011111111101110011110111111111011P1111111111111111111111111011101101011101111100111021211102201102221010212122200b1111a1110010111110
1111111101111a11101111011111111101011111111010111101110100111P1010111011110100001110111111111101111011111111101022122121112111022222110220102a1011a1111101111111
1110101111101a11110000111111011111111111111011011110000111101P1011111111110011011000101111111111110011101111011212212210221212010101222112222b1111a1111111011011
1111111111101a01001011110111111110111111110111111110111111011P1011111111110111110111110101011111120201222111222201222222001222110212221100122b1101a1011111111111
1111110111100a01101101110011111100111110111121212021212120102P1110220210101101101110111111101111021210122020201202211202122222221121221112221a1111a1101111001101
1111111010101a11111111111011110101011111122211110000022121011P1201011210111111010111101111110111122211202220110210222022222222202121222212221a1111a1111011011111
0111111011011a11101111111011111111111111122201102111211102121P1122222102111011011010111111111111100021211010122212002020222222112201121122012b1111a1011110111111
0111111100111a10101101111010011111001111001202212210222011201P2222221220011111011111111111101101200100221020222210200210222222010202102110011a1111a1111111111010
1111111011101a10111110010111111111101111121011222212211102112P0121002121111000111111101001111111222122200200021222002211012200012112211002002b1111a1111111011110
0101101101110a00111111111111110111101110112112110222201221120P1102101121011011111011011110111111211221212222000120022111122011222221120221220b1111a1111101111100
1110111001110a11111101111111111001111011112011202202202222211P2212001201111101111110111011111111121122212112121221102122121122212002211111022a1111a0101111111111
1010101111110a11011111011111001011111110112121221212221121110P2201022220011111111011111011101011212220210101200200121202201202211021112121011a1001a1111111101111
1101111101111a11011011001110101101111110001212111211122212120P2021120212110010111111010111101111002000212012022002122211222212000111212112202a0011a1101111111111
0111111111111a11111011111111101111010111111221120210001111010P2200002012111111111111001111111111111121211101211202211222201122212222222110121b1110a1110111111111
1111010011111a11100010111011111101110111102122012122100222221P1212122202011111111111000101111111101021122022022211212222221222221210221202222b1110a1011111110110
1010011111110a00110111011111101111111101110221002122221021121P1022110011111110111101011101010111110111211110211221220202020222211011011000021b0111a0100111111011
1111011111111a11111111101111101001101111101221221022221121211P1221112222111111111101101111110110211100212101211122222002212212211222112120121a1011a1101101111110
1111111111101a01111111111111111110101111112200122201101222111P2120122212011011101101001001111101012220022222110222222002201122222111101111122b1111a1111111111111
0100111101100a11111111111110111111011100101022111110221212111P1011111102011100011111111101111110201200211222122110120211220220222221120121202a1111a1011111111111
1101111111111a11101001111101010111101111111212101011112111211P1001112010001111111110111010001110122210022201222001212222210212212112222102102b1100a1011111111111
1111001111110a10000111111111110101101110121122012120111110221P2202122222111111111111011110110101200210202122110122200212112202212012210221102a0111a0111101111000
1100110110111a10001111110111011111110111110012021021102221211P1022222101111111111111111101011011022222121122201200211220201120222212121012202b0110a1101111101011
1111111110011a11111111110111111110111011121110022202111111012P1212100122110011110111100111101111122001220122120102120202222202210122111220221a1110a1110100111111
1111001011111a11010111101111011011101111120011212120012211221bP222122121111011101011111111111111110222111120211120211201222122101011211110222a1010a1111111101111
0110111111111a11111111111101101111000101100122122220220111010a0PP2002010011111001110111010111011200212220212210212022222222222112221111100122b1001a1101011101011
1111111111111a11101111110110111111110111121212202101212212111a220P100101111101111111011111110111102211211021202022222222022222211020120111101b1111a0111111101111
1110110110001a01111111111111110111101111112222100100212101001a221P002111100111101101101111111111211020111210121120221222202002021101011112112b1101a1111111111111
1111111010011a11101110110011111111101111120220020220112110202b2021P12221111111101110101011101011212121022211021122222010221222201011210012121b1111a1111111011111
0111011101111a10101110110111011110101111121012111121220110222a22220PPPPP111111111100111110111111221120011112220222001222002222210122012020122b0111a0111111001111
1111101111101a00111111111110010001111111021210111122010021112a2112220121P10111111111011111111010121202200202021210220112102220021212200110001a1011a1101111111111
1111101111101a11111110101011111111110111120211111011120111112a21010221221PP111111111111111111111211121112112201222222102202221221200011222200b0111a1111011100100
0111011111111a11111101010111110111111111101101101120222001021a1220200202111P11111011010101010101121021211212100220012222111112010111010110111a1011a0111111111101
1101101110111a01011100101111101101110101120220100121202101121a22212112201111P1111011010110011100112211111012210211201011111122201111010111111a1111a0100111001011
1101101010111a11111111101111100111111101120222122110222212111a220111122211101PPPP111010010110111020220021221010102221121210221011011111001111a1100a0011111111111
