89 6
129 113
122 49
126 101
64 67
119 18
56 105
111 104
8 43
26 34

1011110111110101111101111001111111010011011110011111111011110110111111111111111110101111010010111110111111111001111110110011110110111111111111111101110111111111
1111101111111111001011011111111111111111111011100111111110111010111101101101101111010111101111111111001111111101111111111010111111110111110111111111111111111111
1011111111110011101001101110111111101111111111100111101111110100111111110111101011111111101110111101101111111111111110111100001110111111110111101111110111111110
1111111111111111111010111111011111110101011110011101101011110111111110101001111100011111111111111101111111021111011111010220110212112211110110011111111101111101
0101111111111111000111010101011111111111101010011111111111011111111010100110111111011111110011000111111112201121102120121011121021111111111111111111111111101111
1111111010111101100111111111111111010011111111111111111111111111101101110001111111011111011111111100101112122110221121111011200112101121111110111111111101111101
10011111111111111110101011101010111011110111101111111111101110101011011111111111011111110P0111011101111011110201221011222220002112011021111110011011111111111011
11011110110110011110011011110111110111101110111110110111111111111111111111111011000111111P1111110111111121021011120220102202020220221121110111101011101111101111
10111111110101111011111111111111001111111110111011111111111111101111111110011110110111111P1101111111111101220202221211212021202121101111111111111111111111110101
01110101111111110111111101101011111111111111101111111111101111000111100110010101101101111P1101111111100122111212002222212221211221010121011101111111111101111111
11111111011110011101111111111110100111110111111111101110110111111001111111101110101111101P0011111011011101200122222211011211101122100201111101111011111110101111
10011111110111111100001111111110111111111110111111010011101110110111111101101111111111111P0111001111111122111222010111120222100100221111111111100110101111111111
11111110100011110111111111110101101110111111111101110111111111111111110100111011111101011P1111101011111122211111100211212122122022101021111011111111111111111100
aaaaaaaaaaaaaaaaaaaaaaaaaaaaaaaaaaaaaaaaaaaaaaaaaaaaaaaaaaaaaaaaaaaaaaaaaaaaaaaaaaaaaaaaaPaaaaaaaaaaaaaababbaaabaababaababaabbbbbbbbbabaaaaaaaaaaaaaaaaaaaaaaaaa
1111111111111110110111111111111100101111111011011101111101111111100111111111111111101111P11111011111110101111022122120201022111010110211111111101111111110000011
0111111101101110111111011111111111010110111110111111111001111101110111110110101111011011P10111111110111102110112121120201110112211101011111001111110111011111110
1111111100111101010111001101111101111111111011011111110111111110011111111111111110111110P01110011111111120222101221202111121210200101011111111101001111111111001
1101111111011111001001101111000011111101001111110110111111111111111110111111110111001111P11011010110111021201201222122000201012122112221111111101110111001010111
1110111110111010110011111011111111101110101111110111111111111110110111011101110101101111P00101111110010112120221210112222221111220000111111111110110111111111111
1111101011121111110221012101120012101211111011111111111111111011111111111111111101101111P11011111111001102011212221122012021011010112221111011111111011111111111
111110110111211111221121222200221112011211011111111010101101aaaaaaaaaaaaaaaaaaaaaaaaaaaaPaaaaaaaaaaaaaaabbbbbbabababbbbabababbaaaabbabbaaaaaaaaaaaaaaaaaaaaaaaaa
111111010111002211001122001221122222101222111011111111101011a101111111111111101101110111P11111011111111121011012112221220121120202200111010111101100111011111101
110111100112020211212022110010110121122012111001011111111001a111111011111011001010111110P11101010101111011011010102111112202210211221121110011111111011111111111
011101111111111220220120111220210101101120111111111111111111a101011111111101110101111011P11101111111111021222121120112211011111121222201110010111101011111111101
111111011110222112212100201011211222221122011111111111111111a100111111011110111111111011P11111111101110122212122121202021011112110211220110110110111111111111110
001111111112021202122222212212101101022022111011101101110111a110111011011111011101111111P11110101100111111100121111222001010201220222101111101001101011111111001
111111110112200112121102112112120111221202001011010101111111a011011111101110111111011000P10101010111100101122201221112221212112221121111111101100111101111101001
111011110001110221121110211120212211222120011111110111111001a111111111111111111001001011P10110101101010101101122121222110102010001021201011111010000111110100110
122022112122112221222201222222221221202211110101101101110110a111111100110111101010111111P01111100011000011112002222102220111002110122000110100111111111111111110
211122222222222221222102211102011221112111001110111001110110a110111111111111011111111111P11110111001110021211222001001121102001122022121111011111111101111011101
012211111121122211222222022210212002220211110111111100101111a111111111011111111011111111P01111110111011111221011121020110210021221112120111010111110111111111111
111201002122102222022112000202210022020221111001010101111111a111101111011010010111111111P11101111110111111112101212211212110110121112021110111111111111110110111
112122220211222122222222222202220101110211101101011001111101a01111101111011111110011111P010111111111111122212202121012211221100212200221101011101011111111111111
112112111212110112211012121121121121021110111110101111111111a11111100101110110111011011P111111101111111012020222101021112121121221211210111011111011111111101110
202221122220201220112221202202211210211211111111110111110111a11111111110011011001111001P000111111101111111122020211222201222212122102001021111111111001110111111
111011112022222212022022222101010120122100111001011011111111a11101111101010111111100111P101111111111001111111212112021220121002102212001221111011011111111111100
022221222122022022211121121122011221220011111011111111111111a101111111111011010001111110P11011111111101111012111101121101111112222022212120110101111111111101111
100200022022222222211011121222212202202202101101100011111111a1111010111010110111110010010P1101011111110111011222121022110011202121211012121110111100011111001010
222111120020002212021202220212220221012222111110111011111011a1101111110101011100111111011P0111111111100111122020102211021210120011011221121100110111110110111101
110210112112211222221200222202021001211000101101111110111111a1101111111011011111111111101P1101111010101111111102022211220221212212202010011111111111111111100111
112111112122212222221212220222012102122111101111100111111111a1111101111111111100110110111P1111101111101110102211101202001020011121121200001111111011110011111100
111120022012122002212122222202210201211010011111111111110101a1111111101111111111101111110P1111111111111011120011120112011111222222112102121111101111111110111111
212110211120202012012022022021022201122222101111011111011111a1011111011111111100111111101P0111111101111001122120210101201212021012120222200111111111111111110111
120221222002210202222222022220112220100122011101111111011111a1111111111011111011111111111P1111110111110001120102121222200101221001222210021101111110101111110110
112202022112112122000211211222220111022111010100111011101111a1101001110011111111010111111P1111010011111111122120112212222201211202112122221111111111111111101011
212122221122122222122220222202212012210122111110111101011111a1111010111111111011100111101P1101111111111111112122011102202110021011212202111110111101111111111100
121122201212122220211102222222101201210211111101101011011111a1111111111111101111101111111P1111111111111011121221002101221012112202200111011111110011111011111111
110121022212220222220120222222222111122112111011110010110110a1111100111111111111111011101P1110111110110111021121101201211220112100220021221111111111111111101111
201122222110212022021220212220012220110112011110011111101111a1111111111111110011011111111P0111011111011111102110221211112111012221112111220101111011111110111110
212201022122220220212222212201212021212211011111011111111111a0011010101111111011111111111P1100101011111111021011012212112112220222012022121101101110111111111101
222110211121121120210112220221210111101111111101101101111111a1011111111111000011001101111P1110111011110111102121111222212101220202211110221110100111110111111111
120221111212012201200211020110200011001101101111111110011110a0111111010100111111010111000P0111010000111110110102111202222212220210111001111110110111111011111111
211121021021111121212202221020110111110111110111001011211202a2210212102221122110111111100P1011111101110110022222120102120122112112112212111101110110111111110111
222111210110200122210121221120100011111111111011121012010102b2122012212101112211111110100P1011001011111111122220201222212201112210011212211110101111110111110111
112221002012101101020211212112111111111111111111101012212111a2101100121002111021111110001P1111111011111111102002121222120002121021212212221111111110111111111101
201112121212220022021000011222010011100111101111122122210121a2111222221211012202111111111P1111010111101011000212122010210121201122021112211111111011111101111111
200111210210220202212010120102101111110111001111110211010010a2121020212001122012101011011P1111111111111111000212222222202212211122221122121011111100111111101011
122011210221210221121212120012111111101100111111120121021111b121112210122221220111100111P10111011111011111021220111222111120210112201111201111111111111100110111
102122011201011122221122220020011101111111110111121222121221a21221212112122112210001111P001111111111101111021212122220221212021120121222011111111111111011111011
111101110111101111111111111110111011011101101111110212202221a0222221111211012212111aPPPaaaaaaaaaaaaaaaaaaaaababbbbabbabaaabaaabbaaabaaababaaaaaaaaaaaaaaaaaaaaaa
aaaaaaaaaaaaaaaaaaaaa111111111111011111111101101112212202122b1021210201220222221111P1101111111111111011011122121122222102022211122100202211001111111101111110111
01111111111101010111a101111011010111111111111111121221112211a2012000112120221211110P0111101111011111111110121122220121202121021102202120210111111111111101111111
11101101111111101110a001111010010011111111010011121011121201b0111222112221021112001P1111011101111111111111012010200211221100210201111211110111011110111111111110
11111001001101011001a111111111110111011101011110111111120111a2210122022102122021111P1111010001110111100111121222010001121122012121122222001111111110010101011111
11111111011101011111a011111111111010101110111111112111121122b1212112122111112111101P1110101101111111101101122210211112212112221200222201111110111111110011101111
00111111111111111101a111011011111111011111101110111110212111a1112201111221212221111P1011111111110111111101111110111101110111111011111111111111001011111111110111
11111111001111111101a011011111111101111111111111111011220122b1101022112112102012000P1101111001111011111111111111111110111011110111111011111110101110101001111111
11111111011110111110a111111100110111111101111010121111202012b2011200220122200111101P1111111111110001111101011111101011011011111101000111110111111101111100011111
11010111111111111110a011010111111110101111110011122111111102b2211120022122002222110P0110101011100110111011111011110110110111111101100111100110111111111111111001
11111111111111001001a111011111111101111101111101121221210201b1222211211011201122110P1110101111011111011011101111111110111111111110111011100111101111111111111110
10111011110101111111a111111101100111111111101111121222012021b1121020210021001201101P1101111101111010111111111111111110011111111111110111101101110111111111111011
11101110111101101111a011101111111101101111011011012111202222a1212212221101221012110P0111111101111011110111111001101111101111111011111111111111111111100111110110
11101111111111011101a101011111111011100011111111102212110111a2121112001122022220011P1011111100011100111110001111101111111111111001111110111111101111111110011111
11111111110111111111a101100111111111111111111101021022212221b0122110101122012012111P1111111111000110111111100111111100111111111111011011111101010111110111010111
01110011010111111111a101111001111011011001111011111101002010b2222001210212102212111P0111111111111111111101110110111111111111111111111100011101111111111101111111
11111111111101111101a111011110111111101110101011110121121121a2121210011211121112110P1111101111111011111100111101111001111111011101111010111111100101101100111011
11111011011110111100a111111101111110111101110111111112011111a2112011221211211112111P0011111111111110111111111101111111111011111111111011001111111111101111101100
10111111111011110010a111110111101011111101101101112021121011b1011112022122111111011P1111111001011100110110101111111111110010101101110110110111111111011001111101
11010111111111110100a100011101111111000111111111110211111021a1121212122212012021010aPPPPPPPPP1110111110111111101101101111111111111110011111111111111111111011111
11110110111111101010a110100001110011111110111111122020022221a0211110212222122121101a111111011PPPPPPPPPPPPPPPPPPPPPPPPPPPPPPPPPPPPPPPPa01111111111111111111111111
11111101001011111111aaaaaaaaaaaaaaaaaaaaaaaaaaaaabaababbbaaba1221122211211120121011a111101111a110111101110111011101111111111111011111P11111110011100111011111101
11111110111111111111111110111111111101101111111110202121112220110201022222201022111a111111111a110010110111111111101110011111111101111P11011111111110011101111111
00000111111111111111110110011011111110111110111112021212112122101022202212212101111a111111000a111101111110010111111111110110110101110P01111111101110011111101111
11100100111110011111101111011101101111111110101111110111111011111011111111111110110a101001101a101111111011110111011110011111101111111P10111001110111101111111011
11111101111111111101110111011111111110111011110111111101001111111110111101111101111a001111101a101111101010101111110111111111011101110P11000111111111101111101010
11111111111001111110111001100101111011110110111010111111001110111111011111100111111a111010111a101101100101111011101001001101111111111P11111111111111101111111111
11111011111110111001101111101111111110011110111111111111111111100110001011111111101a011111110a101111111111011111220222212121011211101P20201222111111000111111111
11111011101111110111111100111011011110110001110010011110111100111011111011111101010a111101111a111111101110011110221211212211011121110P12011111111010110111101111
01111111111111111101011111000011111111111110101111110011011101011111111011001111111a111111111a111101001011011111120121112121122200011P12202101111101111111111111
01111111111111111111111111111001001111111010111111110101101111111011100101111101111a111111011a112111101121022210122220222222211012010P11002111111111111111110011
10111111101100110111111110111100111011110212210022220202222221222111122211011111101a111111011a112221022221221212121212222212120112122P12211221111110101110011111
11001001101110110011101111100111011110101022021012011122202221022221110000101001100a111110110a012001010202011022222112022001220022112P21222111111011111111010111
11111111101101111110111111011001111101111201102122012221211211021222110111110111111a110101100a101221201120122220122222222121102102111P21122121111111111111111111
11101101111110111110011011111111011111111201022121001211100222112211211111111111111a111111101a012221220221221022201222221212221221112P20112021011011101110110111
11111011011111010110101110111110011111111012121201211022122212102021111111111101011a111101111a110020022122211122102022222020022112110P12212212111111111100011101
10111111011101111011111111101110111111111121220201022111010212110001021101111111111a111111011a012211122222211112022222212112000111022P10201211111110111111111101
10110111111001111111110111101111111111111222012221220001222020200212121211110111110a101111111a012222212121211212222212222220021200011P02212121011111111111111111
11110111101011111011110011111111111101111212211210121111022002111212122201111110101a001111111a011111111112212102122212212122220121212P11211110011111011111101101
11111111001011111111111011111111101111111200210122122221211222021221010111111110110a111111011a101120112112112122122202021102222222221P12011011111111111010111101
01100111011001110111111111101010111100110101111120221221122112221220222110100001011a111110111a110220112121212112122222200200221211012P21211112100011111111111011
11110111101011111101110011111111111111110021012212112121012111112022122211111111111a111111111a111210121112121221201011122122022212212P11112012111010111101111011
11011111111011011101111111111111111001011222021202012101212121211221120211110011001a001011101a111122200212201202222102222222020212111P21212121110011111111111111
10100111001111111110111111001111110011011222201111120210122110121210121010111110101a111101111a112211121201002122221212222012202122221P21202022110111111111111111
11111111111111111111111111111101101100111110112220111221212210222101111111111110111a111111101a112222211111002112201222122200221201111P12102100011111111011111101
00101111111011101111101111011111111111111201221111202020221021012102211011101011111a111111101a111201122202112210211122122202222111102P22220121111101011111111111
11101011010101011111111111110111111100010221220110212122101212200022211101111100111a110101111a112011122211222202222222200102122220212P21111112111111011111110111
01111011111011111001111111111101100111111220221222211101122121111111022101111111101a101111110a012112212221221110022222002222220112121P22022122110111011111110101
11101111011010111111111111110111111111111110122222022100011022202221111010110111110a111101111a002202222121111222221102102122020211202P01002011111110111011100111
11111111011111011111110111110111110011111122221211222111021110221220111211111011111a011111101a011121222120102112221102020202222212122P22211122101111101001101111
11111110011101101111111110111101011100111111221201022211211122202200202210100111011a111110011a00112201112212121222222021102011111111Pb10012211101111111111111101
11101111011111011101111110111111110001111122112202022021210122122102221010111101101a101101101a1101211101212211112221222120222021212P1b12212112111110110111110100
11111111111011110111111111110111111110001110222121120201111222202121101110110011101a101101111a111222022102122121122010201220222112P00b12011021111111111111111111
11101110111111111111101011110111101110111121002112221211102102211202102111101011101a011111111a11112112222211211222112220221221221P101b02001222100111111111111111
01111111111111101111111111111010111111111020211222212111020122121212202011111100011a110001111a11222201222011111022112221200200111P202a01000120111101111111101110
11111110100011111011111110111110111111111101012121112111212112110201210211111111111a110110111a101210222212121022020012202221112001120a01121122110101110111110111
11110111111111011110010001111111011111111212021211110121220020222111220211111110111a110011111a111222111211212222210222002220201121212b22021021101110111101111111
00111101111110000011111111111110110011111222110211212222102220202221211110001101011a000110110a012221010101011202212220220222022221211b22112111101111101100011001
11011111111001111000111111011111101101001222020012012112101122022112001010101111101a110111111a012112112002211212101210111120110111101a11111111011111111111111111
11011101111000111111011111111111111110111122122110212101101021121222111210111111110a110010111a112022022121112211120021210201122110111a01011101111111111111101110
10111111111111100111100111101111011100101012012112022112211120220221122110111111101a111111111a112102010121012122121221122111120101111a11101110111111011111111111
