72 14
5 107
122 49
126 101
64 67
119 18
56 105
111 104
8 43
26 34

100a10001111001a11111a0111111111111111111111111011111011110110111111101111011111111111001111011111001a111111111111111111a111111101111101111111111101100111001111
101a11101101011a11101a1111111110111101111110010000111110111101111111111111111111111111001000111111111a101111111111011101a110111111101111101110101111111111001111
111a11111111110a11111a1111111101011011011111011111111111110011111111111101111111111101011111111101101a111101111101001110a111111101010011111011011111111111111110
111a11111111111a11111a1111111011101011111100111111111011110111010111111111101111111011011101101101111a111101102110122221a222222012201211111111111111111111111001
011a11111011011a01111a1111011111111011101111111111111111111111001110011111111011111111011011111111111a112112202200011122b122122220122201101110111111111111111111
001a11010111010a01111a1111101111010111101101110001111111111110110011111111111111111110101111010110001a112221121222122012b202211220210001111111111111111110011011
111a11111101011a01111a1111101111101011101011011111101111111110100111111111111110001110101111100110101a112120202021000111a202102121212111101111001111111111111111
111a11110111101a01111a0010001111110111101000101001011011111111111111111111111010111100110101111111111a002010212021221201a212222221222211111110111110011101111101
100a10111010111a11111a1011101111110001110111101111110110111110011111111111110111111111111001011001010a102212201221202102a121012221222220111110111111101111110111
110a01111110111a11111a0111011100100111101001111111111111101011110111001010010111110110111100101111101a012222101012221112b112110220202021011111111011110111111011
111a10111010111a11111a1101111111111011110101101011010111111010111110111111111111111111011111100010111a111010010120112111b121211101012221011110111111111111011111
111a11111111110a10110a1110011111011101001111111111111111101111110011111111011111111111111111011111111a111202002221211112a211210121121221111110110111110100101101
111a11111111111a01101a0111011111110101010110111110001111111011111111111110101111111111100111111111001a111202212222211002b222101112222201011010111111110100111100
111a11101101111a11111a1011011111111010111011111111110111011111111111101110010011101011111111111111111a111222211121000122a121200210222110111111111111111110111101
111a11111111011a01111a1011101110101111001111110111011101111101101101111011110111101111100111011111111a112201010222122122a111101022011120111111110001111111010111
010a11110111111a11001a0111111111111011111111111101111111111100011001111101110111101111100111101111111a101110202221222211b211211121221101111111110001100111111011
111a11011001111a11101a1000011101111111111110111111110011111111010111111111011111101101111111111111111a110101121211010221b202201021102210001111001111111011111011
111a10010101011a11111a1111110111110111111101111110010111111111111111011111111111110110111001111010110a111111020200221222a211221120001111111111110111011101101011
110a10111111111a11011a0011110001011100011111011111111111111011111111000110111001111111110111101110100a012212112011111110a212121122122120111111111111011011110111
001a11110112210b01222a2111022211122001122111101111111011100110111111111101011111101110110011111101111a112201120121110112b201221022111201101110111101111111110111
101a11111100021a12222b2011220111121011211011111111110111101011011101111111111110101111111011001101111a112222112121222221b121221022112210011111111111111111111111
011a11011111021b20122b2200111120220121202011000111101110101111111101111110110001111111111101101111111a100212211120122121b012020201202111111110111110111011111111
111a11001010102b12101b1102011020102012122211111111111010111011011111111111011111111111110111011111111a112201211111001221a101222122121201011010111111111100111111
111a11001112111a22011b2121001220212011222111111101110111110111111110011111111011011111101110011011110a102201212122122011a110011211111121111111111101111110110111
010a11011112021b01012b1112222221022121112101111111111011011101111101101110111010011111111111111111011a012012222012120022a201221221102211110111011111101111111111
111a11111010212b22122a1111210100221220110111111111010111111100111111110111110111110001101010011010010a111102102101101202b102021111112121111111111111101111111100
101a01011111100b12121b1112011110222121222011101011011101111111111110111011111101011111110111000011011a111121021222222022b112202012210101111011101101011111111111
111a11101110120a12202b0222212212200210022111101111111110110101110111110111111111111101110111111111110a111202112111222122a212121221210121101111111011111101111111
111b21220202222b22212b0121022222121200112011111110011010011101101010111111111110111111111101101011111a111112112211111021a111101202210011110110111111111100111110
110b20101020102a01021b1022022201210222201200111110011111101111111111111101100010111111111011110110011a112021111121002111b000212211122101101111111010111111111111
100b12002212220a12220b2000201021021122001211011111111101111111111100100111111101101111110110101111111a111111222220212111a212012202212210111011111111111100110111
211a21222010222a02122b2220022011220112201211111101010111110111111011111110111101111111110011110110101a110012111222020121a111100121222121111111111111111111111001
110b20111112110b22022b2222222221201011112211110110000111111111111101111100111101101111111111111111001a112112111002001220b211222211211211111111011101111111110111
112a10112201222b10101a2022212102121112211110111110110011011111111101011111111111111011111101111111111a111112112111110222b122121202012210111110111111111111111101
102b12110221201b22220b1222200011111110021001101111111111111111111111110111111111111001111111111001111a111110211202112111a121011212002211211111100111111101101111
200b12112112220b20020b2222221002222011120211111000111110111111101011111111111111111111110011111111110a111112121110121102b210122202201120021111111111111101001110
022a11001120220b22200b2000010221102110012001111110111011011101010111111001111011111100111111001011111a110111121120012121b002212122011012211110111111111111011111
222b22220011022b10012b2022222222101222221011011101111111111111111101010111111111111111011111111101111a001002100212201211b101210012111021211111111111111111111101
022a22201222110b22120b1111222221220111120011111111111110111110111111110011110111111111111111111111111a000112200222211222a112221202111002211111110110111011011111
210b22111222112b12222a2222001120121211202011101110101111010011111111011111101101111111111111111101111a111111121000222012a221202212111110211111111111111011001101
012b02212221212b22122bababbabbbabbaaabaaab11111111100111101011111110111110110101111011111111110011110a111101202211111222b020211222221220201011111111101111001011
211a21201012220a1222121222112222221121010b01111101111111110111011111101111111100111111110100101111101a101112210121112122b212112120102010111001111101101111111101
202a22121022002b1220202012022121021221202a11111111101011110011110111110011101011101101111100110111111a110112112102021221a021011122221210010111001000110001111101
122b20122102111b2201211200222221210022202b01011110110100111111011101010111011110110101111101110111111a110102101110010111b102222102212222001111000111111011101110
212b10211011212b2222022112022221210101202a10101111110011111111110100010111111111111111111011110111001a111112222212010112a211001222222001121101011111111100111101
221a20011120022b0220012212221222202110222b11011111110111111110110001111001100111010011111111111101111a011012221111120012b122112010021222221011101101110110111010
112a12220200002a2220122012222012222112221b11111111111011010111111111110111111111110111111101111111111a111112122122222121a221222221221121121111010111111111111111
101b00122210001b0202222220200222211021222b11101111111111111001110111011110101110110111111111110111011a111111102112220111b210122221212122210111111110111111100110
111b22111101122b2122022102222222211210222a11111111011111011100011111111110111111101101111110111111111a011011221122212110b121221021120222211111011111111111111111
110b22111200022b2221102200022221221222112b01111101111111111111111101111111101111101111111101110101111a001101221201120012a111211012211101111111111101011011101111
112a10211011111b2211101110211111011111111a01111111111110110110111110011100111011111011111111111011111a111101121221222211a220112221022122211101001001111111111110
020a00111121102b1120011221011211111111011a10111111111111111100011111111100110111111010110111011110101a101111111012120121a010212100202220111111101111111111111100
200b20012122112b1222120201120111111111111a00111111211001110212201101220012122210100011111101011111111a111112120202202022a211111101110201121011101110111111111111
021b02211012221a0012111221012101011111101a00111111102122122001120201010212001102011111111111111111011a111112111121111111b011100222022012111111101111110111100111
211b02222111022a2212222011012100110111011a01111112201211021222122102212111111211111111110111101011011a101112102021122212b111021111121211100110111111111111111011
201b20200222102b2222221102212211111101111a11110111221120221100012220220111202012111111111111111111011a111110210201022200a212021000212100200110011111111111111111
011a01121110111b2001210110201100111110101a01010111202021222122211212200221021222111110101110010011111a111012212122122122a112121211021202020111110101010111111111
101b01220111221a0122221022212020111111011a01101111221110200210011221021111211201110111111011111101111a111111110212222211a021020122210021221111111001110111111101
112b20222221210b1220112202222101111111111a01111110121212200220110112102221121122101011111111101111111a111112221101121122b010021202112221101111111111101110111011
101a10011110111a1111110111111011111111011a10011011121222102110002122122220121111111011110110111111110a111110211212122220b222221122112102200101111111111111101111
011a11111110111a1111111111111111100101111aaaaaaaaabababbaabaaaaaabaaaaaaababbabaaaaaaaaaaaaaaaaaaaaaaa111112221202111222aababbbababbbbaaaaaaa1011110111111111011
010a11111111111a1111011111110101111101111111111002012211012101101222112122222101110111111110111101111111101122112122112211112222100200122111a1111111011111111011
111a11111111111a1111111000111001111111111111111111012102201012001020121102202111001001101101100111111011111021111112212120222022222202221110a1110010111111111110
111a11110111101a1111111110111111001101111111110011212211220112102112122011112221111111111111011111100011111000112221121222122211111201222111a0110111111111111011
111a11010111111a0111111111111111010111000111111000211222112221111202211111221221101011111111101101111111111112222112212111122121111202222110a1111110110110111110
111a11111011101a1111111111011111111111111101111110122122020220212222210221212212110111111111001111111111111111111111101011001111011011111011a1101110011111111011
111a11111111111a0110110111110010010101011101011010222120112211222122220221222121111111111111101111101110111101101111111101011101101111011001a1111111101111110001
110a01011101010a1111110111101111111111111110011112112121122012222210101022011122111111110101111101011101011101100111111101101110111011111111a1110111111110110111
011a11111111111a0111010111111111101111110110111111222011111102201121121101211112011011110111011111111111110010111101110101000011111011111101a1111111111111111111
111a11111011111a1111110111111110111111011111111112201112222110112201222002121212110111111110110111111100111111111110101110111111110111111011a1111111110111111101
110a10011101101a0010111111111111101011111111110111102112011220010102102201121121110111111110111110101110111111111111111111111110011111111111a1111011111011111011
111a00111111110a0111111111101001101111111111011112022002120221221122221220222211111011111111011101111100111010110110110111111110111111111011a1111011111111101111
111a11101111101a1101011110011110111111011101111111201211210212112120211110222021011110010111101111110101011110110110111110111111111111111111a1101111111101111011
111a11110111111a1011111101111001111111111111011011121212220122202111212220212200101110111110101100111111101101111111101111111111001110111011a1011111101111111111
101a11111101001a1101111010111011010111111111110112021222120112012001122212101001111111101111011011111011111111110011011001111111111101011110a1111101110111111111
111a01111111111a0011111111111111111111100111101110201112021212220122221101010122111111101001111111011111101011011111011111111011111101011100a0111000110111100111
110a11111100111a1111111111111111011101111101111102101001111122212211222111111200110001111110101111111110111111111111110101111011011111001110a1011111111111101011
011a11111101011a1111110111011111111111111111111111221211222212121012202012102011111011111011111111111111111111111111111111111101111111110111a0101110111101101110
101a11111111111a1101010111111110111110111111110112102121022011122212011221122212001111110001011111110101001001110110110110011110010111010111a1011101101111101111
110a11111111011a1111111101110111101011111110101111021122220021212120111222110222111111101111101101111111111111111011110011100111111111110001a0011011111100111111
111a11011011110a1111111111111111111111111111111111122122110012222202220022011120101011111111111110110011111110101111101111111111101101110111a1111011111111111000
101a11111111110a1101111111111111111111000111111102122111122110211110211210001121110111111111011011110110011111101111101111111100110111011110a1111111011101101111
101a11111111111a1101011111000111001100111111111111211211222102101212222011101021101010111111111111110111111111110111110111101111100111111101a1111101111011101111
111a01111110101a1101011111101111100111011111111001111110111111101101111111101111111111111111011111111011111110011111111001010111111110111001a1111111001111011111
110a11111111111a1101110101111101110111111111111011100111111010111110111110111110111111111111111011001111011011110111101111111101011111111111a1111011111111111011
111a11001110100a1110111111101111101011011111111111111101110110011111111111111101110111111111111111111010110111101111111011111111111111111111a1111111111111110111
010a01111111011a1111111111010110111111110111111111011111111111111011110111001001011111110111111111101111101111011222201211111222012202112012a2101101011110111111
111a11110111011a0110111111111110011101110111011111111001011111111110111010010101111011111111111111111101111111112212201122200110011202012111a0111110111111111111
011a11111111011a1101111111111111011110111111111101110111111101011111001111111001111011111111000110111111101110121220201222021002022122101222b1111011010111000111
111a11111111110a1111010111111110111111101101111111111111111111111111111111111011011101101011101122211112110122222121221022100201120212112111b1101111110111111111
101a01111111111a1110111111011111111111101200111221211221121122101110221010001111111101110111111101122002222111022222210122102222122222212200a2111111010011101011
111a11111110101a1111111110110101011111111201022211021221101210222111102100111011110111111011111110212122221211122220221222211210000220201112b1101111011110111110
101a11111011111a1110111101110110111111111111120220212100111022221222011210110110101011111011011122022221211002012202222100222021121112210220b2111100110111110111
111a01111111111a0111111110111110111111011202222201002100212112122221002001111100011010111111100121211222010012221002222200110220012211111202b2111101111111110111
101a11011110110a1101111111101101011001101212011222201002021012001121222201110111111010111111101011022110111012111222022200222220111112002111a1100011011111111111
110a10001011111a1111011110110111011110110121111001022101211202211200121111111101111111011010111010012101022212112022222021202220100202221120b1011110011101101111
111a11010111101a1111111111011111101111111022200122102122211201212121222211101101011110111111111111122112112011222110101100200221211222212120b1111111011110111110
111a11111111111a1101111101011011111011111221121202212211002212121200021111011111111111111111011120120121111111112210212202202211022001121202b2110111011111111111
101a11101111111a0111111110111111111100110101122112112121112222212200112111001011011111111011111111212221122001022220112002112222110220212122b2100101111111111101
011a11111111110a1100101111011101111001111222212020221211201222112120110110111111101110011110111121112100222211022022012212021202001221212221a2101101101111111111
111a11101111101a1110111111100101111111111221200011121222111202102101210211111011111111011110011112111101212010120221222011222221101220021011b1011111011110011101
101a10111110111a1010111111110111101110101120102022122200201111111212121111011111110011111011111111100110211112022222222201122200202112121110a1101111101111110111
011a11111111111a1110011111011011111111011121112210212212012220211122221211111011111011101111101111222202121011022020222220021112011222110211a1111011110011101101
110a11000011111a1111101010001111111011110010222212111211001121122122122011110111111011101111111111111020122222222202012222020222121112121021a1101111111111011111
111a11011111110a0010111101111111111110110121112012121011222221211111212211011110111111111111101121212110101100221202201212120201211122022121a1100111110111110111
101a11111111001a1001111111111111111011010101011201011212122101121111120111110011110111101011011120021111011221201212122212222021120211211012b2111111011101111111
111a11111011111a1111011111111011111111011211021200121011110211202221110111111010111000110111011122121122212101122220212222112110100022200122a0111011111111001011
111a01111001111a0101111110011100111100111110002201010222111000221002121111101101011111111111111112021012101112120212022221022220111211111222b1111111111111111110
111a10011111111a0011111110111110011111111011211111121221121211111220010101101011110101101111000020220202222022222112102220222022221111110222a2111101101111111110
010a10111111001a1111110110011111111111111201010111010221221021022022210011011010111111011111010021211121112200022222220212011222000210012010b0111111110110111101
111a11111111110a0011111011111111110101111222120121121021111112011220012111111111101101110110111022110111011222102202122202112112222211012011a1110010101110110001
010a01111111001a1001011110110011111111111221022212112111220212012012122110110101111111101110111120112212000111022222211222222221210221120112b0111111101011111111
011a11111111111a1111111111111111001111101212211201102210002121212201200001111111111111111111111020211102102210220111221221120200111212112122a2111011110010111111
111a11110011111a0111111111111110001111110121202012121211100211221102212011111111011111111111111112200111000021122012002122112212121101122202b1111111111011111111
111a01011111011a1111111111111111101101111021012121120020121110121021112111110111101101111111101101111010211111122222202101120001122112220221b2111111011111101111
111a11111101111a1111111111111111111111111012120221220012221212122011122011110111111111001111101111021111211122222212122201122010220111221020b0101111111100111010
111a10101111111a1101111101111111111111111211112122011202121122101012211211101011111101111111011122100212222000121220021222122021221221100200b2111111001101001111
111a11111111111a1010011111111110111111111222122211111111121221221200211011101011110111101001101112102200202211202121221222211121101101110111a1111011110111111100
101a11111101111a1111110101111010011111111121121122122222102202220212102001101011111011111011110110212222221000111220211110221211011011111111a1111111011111111001
111a11111111010a0101111111110111101110111202222222121002210021122221211110100111111001101011111102221002122012210112121121211101111111101110a0111110101011111111
