101 110
139 3
122 49
126 101
64 67
119 18
56 105
111 104
8 43
26 34

111111011101a11111111101101101111111111111111101111111a1111110111111111a11111111011011011111111001111111101111110011111a0100101001101011111110010000110111101110
111011100111a11111100111111111111011100111110111111110a1001001110111101a11111011110110101111110111111110110011111110111a1111110111111111111111111101011111011110
111111111110a01111111111111111111111111111111100111111a1101101011111111a01111111111011001011111010111111111111111011001a1110111011110011110111111111111110011111
110011111100a11110111001111011111111110101111111110111a1110111110111001a11010111111011000111001110110110220102101212111b1102022212021211111111101111011110111111
010011110101a11111101011111101100100011111010011111101a0111111011111111a01101110110111111111111111110101011222212011102b2112221210111220110110110011011101111101
111101111111a11011111111110111111101101110111111011010a1111101111011110a11111011101101111111111111111011110121100222112b0111122222122111111111111111110111011011
111111110111a11011001111111011011111111111111111011101a1111111110111011a11111110001111111011101111111110211112211111021a1011112101112021110011001111101111011111
111011111111a01101011110110100111011001110111111111111a1111101111111100a01111111001110111101110110111111221022212022120b0221222022011221111111111110111100111111
101110011010a00111110101111111111011111101011110110111a1111111001111010a11111110101110111111011111111111111122121120002b0120101120112120000111111111101111111111
111011111111a10011111111111110101111011111111111110110a1111111100010110a01111111111110111110111101011111112221100022112a1200122112221211111111111111101111111101
111111110101a01110111111111100111100011111100111101000a1111111101011111a11111111111011011111011101111110212000011201221a2121021012110111111011111111010110111111
110110011111a00111011111111010011011011110101111111111a1101001101111111a11111101111110111111110101011011111122110121220a2112222202122201010111011101111111011111
001111101111a01111111111111111111111101111111111111100a0111101011111111a11110111011111111111111101011111212112121021210a1111121221122121011111111111011101111001
111110111111a11111101111101111011101111101010111111111a1110111110111111a11111000110111100111111111110111111111122021002a2221221102111211110111111010011111000111
100101111111a11011111111111010110111111111111110111001a0111111111101101a11111011010011111011110111111111102221022222212a2121112122212101111111111101111010111011
011011111010a11111111110111111111011111111101101111110a1111111111111010a11101111111011111100111111111111221101202021020b2212111112201221111001011100110111111110
101111111110a11111111011111011111110111111110101111111a0111001111110111a11110101110111100111011111110111212222222101121b1120210102122021101111101110110001101111
111100111001a11111111111011110111111101111011111100101a1111111110101111a11110111011111011111111110010111212201112021121b1210121121200121111111101101101111111111
111111111011a01111111111111100111110111111101100111101a1111111011110011a11101111111111101011011101110111212212021112102a1220020012120120011011111111110011111011
111111011010a10122221111110020111011020211111101111111a1111111110111111a11001111111111111111111101111111112221121112212a1002220201121211101101111111111100111111
110111111112bbababbabaabbbbabbabaababbabbbaaaaaaaaaaa0a0010111111011011a11111011111110111111111111111001122020211112111b1101200220211211110101111111101011011110
1011111111010202111110021111111021212120111111111111a1a0111100111111011a11111011111110111111001111111111202201121020220b2112110112212111010111110111101101010110
1110111111111011211201012212212122121021111010111111a0a1110010111111111a01111011111011011111100111111111111222220122200b1012201222011111111110111111110111110111
1110011101121021122012211202011120212222120011101111a1a1111010111111100a01101011111011001011001110011110022002000121200b0222202121010211011100110111110111011011
1101111011121111021110222212122122111011211011111111a1a1011111111111111a11110110011011111010010111010010201122101011120b2222120112211111011111111111110111011111
0101100101100111111220011221022202121101120110111101a0a1111111111111111a10111111011001111010001110110110210111010212212a1200101100202221111101101101111111111111
0111110111121011010212210110021221222102121011111111a1a1001011111111110a00111111011101001111110110111111111222202022111b1211212212221111111111111010111111111011
1101011111021012212110011101020112212111121110101111a1a1101111111111111a11111111111111111111111011110111202212211222221b1100212001101211111101111111111011101110
1211201121012001022222102222212221022012211001111111a1a1100111010001111a11111110011111111111010010111111211221212001100b2202211111112221011110111101111111111011
2100112122222222020201220022122222211121121111110111a1a1111101111111111a11111011111111111111111100111011111202111211122b1212220121222111110111111101111101111111
2110122012202212200220022020221201211120011011011111a1a0111101011111111a11111111110110010111101001111111122112221211021a2112211221102021101110101111101111111111
2200221222122201021212220201022211012011011111111111a1a1111001111111111a11111110001001111111011111111011121221202022021a1111012122110221111101011011111011111110
1211212201121122202220221220222011122222221111111001a1a1111100111111110a10101100111111110111011111111111122011221112112b1020211122221111111101111111001111011011
1220220212221222221222120121221221200110021110111111a1a0011111101111111a01101001111111110011110111111111202120020120102b1111211112002121101111110101101111111111
2120011211212212112222102022222121220201001111111000a1a0010000111111111a01111101111110111110111111110111110021120021022b1101211011201201111101111111111110111111
2202201211122222012211211201212122222221221110111111a1a1011111110110110a11101110110111010111110010111111111021021122010a1210210201112022101110010111011110110110
2221112122222222222122222222212120221212201111111110a1a0111111111111111a11101111011110101011110111111101101222022120011b2122110212211212020110111111101111111111
1212102210222211202220022221101221202120121111111111a1a1101111010011111a01111001111111111111111111111101111001222221000b0002101012121211121111111111101111111101
0112122200121122212022212122012121102121021101111110a1a0111111110111111a01110110101001110101010011111001111211220210022b1212112122222210121011011111101111111101
2220120222222202222200220222220221221221211101111111a1a1110111110001111a10101111111101110101111111101111110121111122011a0122201110202011121011110110111111011100
2012222201201012222021222122022221122220020111101101a1a1111111011110111a11111111111111111111011110110111100221121112200a1112211102210210121111111111101101111011
1011120122222022212122122221212222210201121100101111a1a0111111111111111a01101111111111101010101010011111111222011202111a2112112200001111221111110111111111111111
0211211212122211122122222022222211102212020110111110a0a1111111011101111a11111111111110111101110110101111001122102112112a2022200021211212011010011110101111111111
0222212122122201202222120221022101220021201111111110a1a1111101111110101a00111101101001110111001111101110111011211221122a1121222000021212211011111111111011111100
2210211212212221220010220000100102121111200001101111a1a1111111111111111a01111111111111111111011100011101011221222221222a0200221121221222021110111011111111111101
2222112121121220022002112022222211111012121111101110a1a0011111111111110a10111101111011111101111011111101111021011212000b2222112121212121121111111101011100101111
1211201121012000012220021220122221000101221111111111a1a0111011001111111a01111111110101111101111111111101101002020010212b2211111212111221100011011001111011111011
2112122222201122220112222120021112212112010111111111a1a0111111011111101a01111011011111111101110111101111011110202120112b1212021122102222011011111001111100111110
1120112112222212122222221020222111011222221111111000a1a0111011111101111a11101101011111111011011011111111010221111121212a1012221201211022010111111101111110111111
1111122202202121020202221020222102222220010111110111a1a1111011111010111a11111101101111111101011011111111101021200102212b0000021112122012111111111110101110111111
2112112121210012122121112120120111111111111011101111a1a1111011110101111a01110101111111111111101111101101011112011201121b1122211112202221121111111111111101011111
1220222111222022021222100221111011111101101011111110a0a1011010111110111a11111110011100011111011101011111111112201111012b0011121220122122201101111110111111111101
1222221111220121202121212211110011011111111111111101a2b1111010022211111b12212112010101111110110111100011011012212110110b2120202221202221021110111111110011111011
1212122122122210122222100220121110111111011101101002a0a1212221221112212b01210101111111110110111111011111111202211221121a0211222122222201001111101111011110111001
2011110121212002201211221212222011011011000101111122b2b0122120121221110a20111102101111111101111100111011000210211111212a2210212120122102221011110011111111111111
2101212021112101222102222111112111111111101110101021a0a0120222111100102b11100211111111111011110011110111111110002211021b1210222022111210101111111101111110110111
1022221022202222112010212211211011111101111111001111a1a1211002111122122a11202101111111111111111101111100011102111220021a1220010121112222201111111110111010111111
1010020012112010000202111201121111110111010101111121a2a0221121002122121a12200122101111111101011011111111111122211111101a1021111212221201201111101101011111001011
1212211111220211100101111211121111111111110111111120a1a2111021021221222b12112222110011010101111011111111100001022112122a0220122102221121011111110111111001110111
0110011111011011111011110111110110111111111111011212a1b2012101020201221b12121121110110110111111011111010010222002121212b2200001120011101110111111110111010110111
1111111100110011100111110101011001110101110111111221b2a1120111112202110b21022100101111110111011101111011110221020120012b1201220211111220211111111110101111111111
0101111111111111011101111110100101110111110111111110b2b2102011210210021b21112011111111010111101001111110111120101122110a1210022022021122111111111101111101111110
0111110111111111111111011111111111011010111111011112b1a1112111111022102a12102012001111111001111111111101111201202102211a1122100221101111010111111011111110110111
1111111111111111101111110011000111111111110111011222b1a1121222122122111b11201212011111111011111011111111111222120021011b0112221111222120111110111111111111011011
1110100111100110011011111110111101111110110111111010b0b1122212122121112b12212222111101111011111111111111111101110221201b2222211101112002211111110111011101111000
1111010111011111000111111101110011111011000111110211a0a1221111222122221a11002112100111101101010011111111111101011101111a1011110111110011111011010111111111111111
1110111111111111111111011111111011111111101111011222b2b2222101212212211a21212220110111111111111111011111111111111111111a0011111111111111111111011111011111111001
1111101111111110011110000111110111101011111011110111a2a0220001222210110a02211221111011101011111111110101111011111111111a1111111111101111101111111111011111111111
0111011111111111011111111001111101111110111111110111a1a1221122102122122b00120111111110111011111111011101111111011011111a0111101001111111111011110110111111111111
1011111101111001111111011111111110111110100111111122a2b2222120112002220b00112011111111111011101111101111110111100111011a1001111111010100101111111111001111111001
1011011011011001111101101011111111111111111001111221b0a1021112220122221b21110012011011101111101111110001111111111111001a1111111101111111111111111011111011111111
1111100110011101011111101011111111101111111111011112a1a1212021221111112a22210220000001111111110101110111111111110101111a1111111111111111111110111111011011111111
0111111110111011111010111001101111111111011011101121b1a2112022211120120b11101010111111101111111110100110111100101100011a1111000111101011111111110101111101111111
1111111011111101111111111111111011111111111111111200a1a2111210101201112a10121111101111100011011111111101101111111111110a1111010111110111011111111111111110101111
1011111111111110101110111101111101111111101111111121b0b1222122212221112b00121210111110111101110001111010111111111111011a1110111110011111101111101111100111111100
1011111111111111101111011111011111011111011111101210a2a1001222122021112b12111120101110011110111111111111111111111011111a1111101111011101111110111111110111111101
1111011110111111011101111110100011011100111110110021b0b1212222111112111b10011222111011111101011111101111111011011111100a1111111001101111111111101111111110111011
1110101110101111111011011110101111011111011111011201b1a1222120220222012a12121120110011111111111111111011111111011010111a0110111100000111110111101111101111011111
1101011111110011111111001011011101111110111111111021a2b0121112120100220a10101012111101010111100111011111111011101111011a1111111111111111110111010111111110011101
1101001111111110111111111111111011111110110111101112b0a2210202000221001b00201112011011010010101111110011111111101111111a1011101111111111111111101011011101111111
11101111010101101101111001100001aaaaaaaaaaaaaaaaababa0a1012011112112121a20222221100101111111110111111111100111111011011a1101101111110111111111111111010101111111
01011111010111110100111111111111a100111111111111122120a1121220101222211b22020000011111111111111111111111111111110111111a1111011011111111111101111111110011011111
11101001011111111111011101111110a111111111011110120122b1221012200121011b00222112111111111111111011111001111111111111111a1100111101111110011110111101011111110111
10111101111111111111111111111111a110111111111111111011a1101111011111111a10101101111111101111110110110101111111111111111a1101110111111111111111111011111110111000
01111111111111111111111111111110a011111100111110101011a1111111001111111a00111111101101111010110111111011111111111111011a1110111110110101111111111111111111101101
11011111110111101111010011101111a100111111011111110111a1111111111111110a01111101111011011111011110000111100111111111010a1111111111110110111111111111111010111001
01111110110111110011111111111111a110101111111011010110a1101011111011011a11110110111110110111111111011111111111021111201ababbbaababaaaabbaaaabaaaaaaaaaaaaaaaaaaa
01111111111110110111110110011111a101101010111111110111a0011111101111111a1111011111111111111100111111111011101112111221211201012221111211111111111111011111011111
11111101111101110011111111111111a111110111111111111110a0111111101011111a0111111101111111011101011111111100111101212021212220111001221102122211111011111111111111
11111101011110111111011111111111a101111110011011111101a1111101111010111a1111101111111111110111111001210122212211122212112020022101011222220101101110001111111111
11010111110111111110111011100111a111111102101212211211b1010022222211221b1111111111111001111111111201220112122120222212201222222211012012022011101111111011111111
01110011111000101011101111111111a111111111002201121121b2211221100111212b0111011111101110111111111112211221122012111022022212022222210212012212011101111111110001
01111011111111011111111110011011a110011112111022122021a1020112212222221b0101111110111111111110111220102021011122102120210022022221221211011121001111011101101111
10011101110011010111111111111111a111111112222212201112b0121211210010212a1011101011111001011111000212120221022112221220022021222121112201212121111011111101110111
10011111111110101101111101111111a111110102122211112110a1012202000121221b1110111111101101111110100201211122222111000102212101122222021022101102111010111111111110
11111011110111111111111001111101a011101111100110211012b2220212221111111a1011110101101111111010102220211120110221200112222220220110021112212111111100110101111101
11111110111101111111110111101110a111101110220201112022a0110220210012121b0010110111111110111101111112210121122102221200220222222110111021212202101100111111110111
11111111111111111101111010111011a111110110121121112210b1121101221220122b0110111111111101111111112122202122121212222211012000222201220021201121110111101101111011
01111000011100111111110111101011a101011111121021010112a2221110202110111b0111111101111110110111100221121222222112212201102122202210112222120202011111111111101010
11111101111011110111011111111111a110101112211120110201b1100222000211110b1011111110111111111111100121020220111221212212122202221110211201121121110110111111111011
11110100110110011111101111011111a110111112102001210102b1221112111212121a1101110001100101111111110220112211021122221221102221202211011112020221110111111111111111
01010101111111111111110111111101a111001102022211221022a1201212210012102b1011111111101111110101102022011112202010221122201021020220221121120122111111111111111011
11111110011111111111011111111101a100111112210111100112a2111222222201222a0111111111111110110111112212120201112201221100012212021222120210101210110111011111101111
11111110111011111011111111111111a111110112020221100121b1111021221001111b1111011111111110100001010211220121211211022222222220022021212212112111111111111111011110
11111110111111111111011110101110a101001011111211112001b2121221012112222a1101111110011100111111002020111211122102222202211222202212122221221002011011111111111101
10110111001101101111111111111000a101101111211111122201b1221012101201111a0101111111111111111110112111111111122021222212122222222202112211122112110111011110101001
01101110111011111111111111111101a011111010010122011212b1001002221002012b1111101101111111111111112121221212201102022021221221200112112122110212011111111001111111
10111011111110111111111111101001a111101110011012121101b2222212121020222a0111011110111101111110111222102210101122222220021212220221220122111112111111001111101110
11100110101111110111101101111011a101111112100121000201a2111102001021121a1111111011110111011101110101102221012222202121122122021221110221021212111110110111111111
01010100111011110110111111111111a111111101212122211121a1101201122121121b1111111111101101110111010112210202212110002212201001111110211112112202101111111101011101
01111111111111001111111111110101a101100112201111211022a2202211201121120b1011110111111111111111111220022121201122020210221111221102121012211111110111111111111011
10111001111101111101111111110111a110111110121221022111b0012022222011121a1111111011101111111011102102102020202222002222221222121021122211122211010011101011111000
10111011111111111111111110010010a110001112222212002201b2102112202220002b1101110111001101110111111021212101122221220212122122222120210112200122111111111100001110
01100110110111111111111111111111a110011111012010012122a0122222110001220a1110111111101011111101111022112112112011000201202122220120111121221221110110110111011110
01011111111011111011100111111011a111111112112111111221b0112111002121221a1111101110111111111111110121001221110122222222222222222120121011011122111111110111111111
10111101111111101111111110110000a110011111122212010122b1222110122211121a1011101111111001111011112120012111120122202122022220111001122122010211111111011111111101
11111111111111111111111101101111a111111112221212111122a2122120000200120b0111111111010111110011011111002121211222222022020212221011022200121221011101111111110111
01110111111111111111111110101110a011111111122112120220b1112210111201011b0111111011111011111110110112122111110122212221110021020111011111110110111101111110011111
11111100111110011111111101111111a110111011022202112212a1120222221100102a0101111111011010101111112111122111110211010112221022212110111111011101110011100111101111
11111111110101101110111110111110a111010001022210211220a2221221212212201b1111000011101111111111002001100011201201122120221110211110011010100111111111111111101111
