142 45
17 105
122 49
126 101
64 67
119 18
56 105
111 104
8 43
26 34

011101111011111111101011111111110111111a111011011000100001111111111111111101111111111111001111110110110111100111111111111110111101111111111011101111111101101111
111111111111111111111011101110111111111a011101111101111011111111101111100110110111111101110111111111111101110111011110111111101111111101111111111110011111111101
101110110110111101111101111111111101111a111001100101110010111111111110111011110111111011101101110111101110111011100011101111111110111111110100111111101110110111
111101111111111111111111011110111111111a000111110101111111111101010111011011111111111111000101111101110022221112002220201021122111102221111101110111111111110111
111101111011011001111111111110111011111a111101011111101101111111111111011011111111101111111001011101011112111200111211211110220112212121111011010111111111101110
110111111111111011111100111101010111111a011111111110111110110011110111111111111101111111110110101100111102212021112211110121120121221221111111111111110110101111
101111110110101101011011111111110111110a011010011011011111111111011111111101011101110110101111111110111122020120111121121111220021210221111111011111101001011111
111111111101111011110001111111111111111a101011111011101101111111111111110101010111110110111110110011111101020122122201200212222122101201111011110111111111101111
110101011101111111100111111111011001101a111010101111101111010010110101111110111011111111111111010010011121121012022011202021102222121221111111100111111111111011
101111110111111101111111010111111011111aaaaaaaaaaaaaaaaaaaaaaaaaaaaaaaaaaaaaaaaaaaaaaaaaaaaaaaaaaaaaaaaaabaaaaabbbbbaabbbaabbbbabbbbabbaaaaaaaaaaaaaaaaaaaaaaaaa
0010111111100011111111011111111111111111110111011101111111111111110111101110111110011110101011110111111122202122020212010222020211222120111111111011111100111110
1111101111110111111111111101111101111111101111111111101111111111110111101111111110110111011111101111101020002122221111112102102110121021111110010110001111111111
0111001111111101111110010110111111110111011010111011110111101110101001111111011111111011101110110110111101121221120211122011012211022111001110101111111111111101
1111011011011111111011111111111111110111111111110111111101101111111011101101111100110101110101111111101111222111010201211012122211010121111111111101111111111101
1111111111111111101111110111111111111111111010100011110111111111101111111100111011111101110011111111111101211212112210222211210121121120111111111111011111111111
0100000101111111111111110111111111111111000110001101111011011101101110111011111111111011101110101111010100112022221111220112112111222211111110101111101011101111
1111100110101111111110101111111111110111110111111111101111111011101111110110011011101011110110111111011122121112222102210021201101012111011111111100111100111111
1111110101101111011101111101001111110010011101111101111101101101011111011111111101110111111100111111110122020021002222102101221201110211111111101111111110111110
1011011011110111111111011111010111111111111010111111011111111101111110111110011111001101111111110110111011111221212222122011212202001221111101111101011111111110
0011111011011121111221222221011000222122011101011111110110111110011111111110111111111011100111101111011021021020210001210221112021211220011101111111111111110111
1001011111121211221111102210022220212102021110111111111111111101001111011111111011101100011110111111101112222202220211212202222211212111111111111110111111110111
1101101111121222211212112022222112020212121111011111011111111011100110111111111100001011100111101111110120202111200121220112012212022220111010101111111111011011
1111101111101121120202221012211101212112011111111111110101011111111001111111101111010011111011011111110122002221222021022001121211102211111101111011110111011110
1111011111102201201220021012212022120220211111111111011111111111111111110110111010111010101101111111111122122110020112222121120111001211111111100101011011101111
1011111111122222211021122220120112221211100110001110111111111111011111111111011111110011111110111111011102201211220120112221212212221011011111111011101110111101
1111110111111122022211212111121211122122211001111110001001110111111111110011111111111111101100111111011002111101011000222112212122222000011001111111111101111111
1111111001121222022121111220201121212211221100111110111011110111111111111111101101110111101011111111101022202220112111110110221101012221111111111111111111110111
0111011111102212122222222222022201122121221111110111111101111011111110101111111111111111010011011111011112112222222220012221121222121101111111101111111111101111
0012122210122202122022002122212012112220111110111110110111111111111111110110011011101111111100011001100111012112221102221111211220101101101111111001111111111110
2202012122102122122110222022102101211212211010011011011111111011111111111111111111111101111110111111101012021101221022012112120220122101100111111011111111111101
0112002122112222122220212012221211121200111011111111111101111111111111110100011010111111011110111111011110012112202212212212102222012111111111101111110111111111
1220112200222220212212211022021211002202111001111111111111111111000011101110111111101111111111101110011102121210120001122122022121012111101011111101011101111100
2111211112022222222222201222101111012122110111111111111011010011111110111111110111111101011011111001010112111112212102002112222211011220111110010111111111101101
aaabbbaaabbbbabbbbbabbbbbbabababababaabbbaaaaaaaaaaaaaaaaaaaaaaaaaaaaaaaaaaaaaaaaaaaaaaaaaaaaaaaaaaaaaaaabaaaabbabaabaaab211212211112201111111110111111111111011
121210101011222021222122202221011111112011100111101110111111011110110111111111111111111111101110010110101111112100221001b001011012011222121111111111011101110111
122012222112222202210212222222202212120002100111011101111110111111111111011111111011111111110111111010010112222210122110a121201201110012221100101111111111111101
202122111102202220220122220210222212122121111101110011111111111111111111111011101111111001111111011111111112100212210121b201221111221102121110110101011001011111
102120201221222200202212022022210112212212101111111111111110111010101111111011111000101111111011111110111011212012212102b212222211222020121100111011001111111111
212202121202022122222120022201221022022211101011110111100111111011111111110111111111111101011111111011111111121111121010b221021222112020111111011010111111011111
120210112020201222222221112220220221212010111111111111111100111010111111011111110110111111110111011011111111112212012121b201002221221211211011111111111111111101
210012202110021101220120122221002121010121111111011101111110000110111111110100011111111111001110111011111112121120110221a212112211220022100111111111101111111111
020221122212220210021221222201021120011221011111111111111110111111011111111111111111011101010011111111001112200202221101b200121221202210010101111111111111111111
122211021212212202222112222212210100211211110111111011111000111110010111111110111101001011111111101111111110021202201111b211221221112011121100110111111101101110
121120212112022222222022222220122221210122101011111111111111111111001011110111111111011111010011111110110101121222101002a112210022121112211111110111111101111111
210221212110122212022102200002022111122210111111010101111110011101101101111111111111110111101011111110110102111122212220a101221220012121211011111101111111111101
200121220122201022220021122202211212201212101111111101101011111110001111101111001101111111011111011111111112201202212210a021221011211211121011001111111110111101
222021110220122022221222112102012211211021011111011111111111010111111111011011010011111101110010000111110100222201211121b222112101102222221011010110010111111101
011121222211202220122211222102211221212221110111111111111111011001111011111011011001001111111111110001111111120110002220a102101010121221201111111111010111111111
011111012012112012220122102020101220101121101111101111110111111111111101101110111110111111111011111011101112002010221020b222112211220112221111111111111111001011
221112201112021202022022221221210212011212110001101111111101111111111101011110110111111111111011111011111101120221011011a022201112220021121011111010100101111110
022121222211110202220111221121100111111111101111111011111111111011111111100110111111101001111111101111111112101011121221b112011110102211001101110101111101111111
002112021111121212222110211221111011111111111111111111110101111111111111111101111111011111111011101011101100212120101002b001211201221211111111011110111111011111
021201220122001221011110012102211001110101100111022221221201112110202012222011100110111111110111111111011111012222002221b021012122102020201111111111111010111111
002211010012012212221211220100101111110110101100112220220111021122211122211012101111110101110111101111001012212002212111b111022221011222221111111111010111101110
210100012120022021222020101020211111100111111111100202110112000210011211212111121110111011111111101111110011100120112200a111111122212110210101011111101111111111
202212100201112221012222210012211011111111110110121211211222222212122222221222221111011111111011010111011112222222212012b012121221102001111111110111111110110111
221202100112112011002101212001211111111100011111100110210002221102111122102020221011110111011011111100111111012220021220a221201202221212111110111111110110011110
221122101101201101121211001212011101110111111111112111112200112120111121121111210111111111111111111111101010110121001021a212112122022211111101111011000111111111
102221102110222211211011222111111111111111011111121022210112200112121122022101211100110111111111011011111111021211211012a021011112012002010010001111011011111111
101111111110111111111011111111111111111111011110121202021121022202121201111211201101011111101101011111010111220022222211a010122220212221111111100111111111101011
100011101111110100111011101111111101011111111111122101022222202122111212200221111111111011111001111101111112121020121000b201112002211211120110011110111110011111
011111011110110011111111111011111111111111111111111122200121210201101021112112201101110101110101111111011111111011020220a110222122021112221111111111110111111111
111111101111011111111111111111101011001111111111121221121112222111222121110202111101111111111111111011111011211210001121a110111022121101101111111111110111111011
111000110111111100110100110111011111111111111011122212222111222122012120000220010110111111110111111001111102102122221111b212010222211202110001111111110111111111
010111111111111111101011010111110110110111111110120211011012010001201101112211211111111111111001001111110010002222220012b211122121221222221111110011101111000111
111111101111110101010011111111111100111111011111102011220211112111122121102012020011111111011011011101101011111111101111a111001110011111111111101011101011011011
111111011010111111111101010101111111111111111110102022122112121112222222212212111101010111111111111011011011111111111111a111111011111111111111110111111011111001
011110101001111110011011111111111011111111111111112002101101112212202110121120011011011111110110111110110101100011101101a011111111111111111111111111111010010111
011111110111111111101101111001011111100111111111112021222111102102111002210121221111111100011111001111110110100111111111a111110111111111110111111111111110111011
111011111111111111111110111111111111101110101111112212121201211102011222210212111110111111101001111001111111101111111110a101111111111110010110111001011110110011
101110110111010001011100010110111111010101111111111210012121221022200012211211101101111110111011111111111111111111111111a111111111111111100111110111111111011111
111111111100111111111000111111111111011111101111120210112002211212102210211212221111111011110111110110111000111011111111a110101111111111111111111011111111111111
111111011111111111101011110111111111111111111010112111111222211112220121212222121011110111011111111101111100111110101111a100111100101111111101110001010111100101
011011111111111111111111110111111011101111011110010212202210221121210222101112121011111111111101101101101111110001111111a111111100111101111011111110111111111101
111111111110101011111101101111010100100110110101120220211121001222122121102122220101111011101111100111011011111100111111a111010000111111111111111111110011001101
111111110111011001111001111111111111111011111110101210222122221110111100011101221111011111101111001111110110101110111110a110111011111111011111111111111111110001
111111101111111111111111101101110101111111111101011002122212101101220102110021201011110111111110101111011011111101101111a110110111111111111111111111101110111111
110111011111101111101111011101011111111101111101001022211112111221221210201201211111110111100110101111111111101111011101a111100110111110111111110011110111111110
111101111111111111101011101011011111011111111101102011021112222111002221222211111111110111011111011101110111110111011111a011111111111011111111111111111010111000
110111111111111011011111111110111111110110101111112210022221220211211122021201021111111010111111111111110011101001111110a111111111111111011101111100111111101111
111111110111111111110111111111101110111111111111121021121222111122111122211110211001101111111011011110111111111111100110a111111101111111011111011111111111111111
110111111011111010011111011111110011010001111111121011200220121122210212122212221111011110111111111111111101011111111111a011111111111101100111011111001101111111
111011110100100101011111111110111010101110111111120222112202122121022110202222221011011011110011111101110011111111111100a111111101011111110101011111011111111011
111111010110111110110101101111111101011011111111001110111011111111111111011111111111011111110110011101010110001111111110a011010010111111111101111111111101111111
101110011111111111111011111010111111111001011111111101010111011111011100111101111101111111011100111111011111100111000111a100110111011111111011111011001111111111
111111111111100111011100111110111101110111010111011011011111111111111111110111011011110111111101111111100111110110111110a111111111111111111011011100101101111111
011111110111010101000111111111111110110111111011011111011011101111100111001101101101101110111011100011110111111210212221a200012122220112212221111111111111101111
111001011101100011011111111011111111000111111111110001101100111111111011011101111111110111110111111111101111111002111201b102211110112211200212111111011101111111
111111111100111011111101111111111111111100110111001111101111001101101111111111111111110111110011111111010001110212122112b221121222112112012102101110101111111111
111111101111101110111111111111101111111011111111111111111111101101011110101011100011110110111011122210022111212222201222a120222012222211121120111100111111111011
111110111110110111111111101111011111100111112221101121220021222102120002011111111111111000111111201122111202011222222022a202212121112202111211101111111110111111
110111011111111011101011111101011101111111221010210121122102200221222222111111111101101101111111021210121222210221102220b222021211010212122222100011110111011001
aaaaaaaaaaaaaaaaaaaaaaaaaaaaaaaaaaaaaaaaabbbbbbaabaaabababbabbabaaaabbbaaaaaaaaaaaaaaaaaaaaaaaaababaa2111021120221122022b222222211211201102201100101101110010111
0111011111111111111111111011111011111101101210012211211122112110122211101101110111011101111111111201b1202212221011222222bbbbbbbaaaabbbbabbbbabaaaaaaaaaaaaaaaaaa
1111111110111111111111101111111111101001120010121211101012120211120102021111111111111101111110102201a11112000110122202100020202222002101020220010011101111000111
1111111111101111001011010111111001111011011102121122122201022211021121011111111110001111111110110110a20102112101212221212222221202122111012212101111111111100111
1011111001111111111110011100111111111111020221122022002121211121111210001111100110011111111111112110a21110220100222120222122112212122222212212101111011111110111
aaaaaaaaaaaaaaaaaaaaaaaaaaaaaaaaaaaaaaaaaaaaabaaaabaabbbbabba122120202211101010111101111100111112122b22011100112210222122122222102220112220000111111011101111101
111101110111111111011011011010111011011111221201211212202112b221202121111010111111111111111110110000a02112112122012222202122102122012111022112110001111011111111
111110011111111100010101111011111101100110202020122111120202a101222111221101111111110111011111111121b21212210102011212212220022012022102012212101001111111010111
101111110111111111111111111111111101111001201211121022201221a112012100121111111110011111111111111200a22122101021122221220022222112222122002010111011100111110111
111110111110111111011111111111111111111111122100102122100122a121022122021111111010111111111110012222a21202221112122220200022221111101202221211010111111111010100
111111011110011111111101111111111111110112200112010211210211b011101110211101110111001011111011012122b12111122202021000222202212221111211111102111111111001111011
111111101111110111011111011100111110111010211201111220211112a211212022101111111111110111111111111212b11212101222222022220122102202121212021201101101111111111111
111101010111011110111111111111111111111111212111011212020211a212121022011011111011100001110101102110a12210122202122222212222202112012211202211011111110111111111
111111110111111111111010111111100111111111102112212101111100b222220211101001111111101111110111111220b21120122200211221210120022022002121121121111100011111111111
111011111010011001111111100111111111010101000112111102101121a121221121101010111011111111011111112201a11221120212222001222002102212001100112121101101110111111101
101111111101111011111011111111111111111101122222212021222102b102021220121011111110111111011100112221b12220101010221221020220202211112002120221111110111111011011
111011011011101101101111101111011101111112210221212202221102b100222112121110011101111101110111112222b22211212112102221202222222120112201211100111111001011111110
011111111011111111111111111111101010011112022012022111122012b202212202011111011011111111011111112212a22122121121202222100221220120210212122122110100101001111111
111001110110011111101110110101111111011110221011221020121220b021102110021111011111111111111111100112a12100210202222212220222222212111222110022111111111111111011
111101100111011111111111111111111111110110221022211122121222a222120002021111111111111010110111012121b00212221200222210010222000211022220212112111100100011111111
111110111111111111101110101011111101111112210112022121101121a202201112101011101111111011111111000221b10202000010122222222212222112210220111110110111101111100111
110011111111110111111111010111001011011112012122212122220001b122122112001101011111111011110111002122b10010102101111212000101222212212121112221111111111010011111
111111111111110111101101110111111111111012210101202201202121b002222102201111011111101110111111012122a22011111202110202112121222222020121121112111111111111111101
111111111100011111110111011011111011001100221111111112021110a202101122021011111011111111111011111221b00111211120122222022222222201112112221101010011000110111101
010111111111110111101111111111111111111112202202102122020211a001121111201111110111110111110111110121a12201112222200211222221022112122220122122111111011111101111
10110111110111111101aaaaaaaaaaaaaaaaaaaaabbbbbbbaaaabbbabbaab122221022211010011111111011011110110210a20221122102112022111021111101111011111111111111101110111101
10111111111111111111a1101111111111111110111221211002220102022002200210120110101001111111111011112012b00111201121212221211211112001110111111011111110101111111111
01110101111011111111a1011101101010111111022022112122101021221221120211101001111011111111110111102121b22211111100112111002222112111001110111111111110111101111011
