3 89
143 112
122 49
126 101
64 67
119 18
56 105
111 104
8 43
26 34

11111111011111101011a111a111111111101110111110111111111111111010111111111a1011111011111110000011111110111110011111111011111101101111110011111011111011111a110111
11101111111110111101a111a111011111111111101111101110101100111110111011110a1111110111011101111111111111111101111101111111101111111111110100110111101101111a111111
01111011111111011100a101a101010111100101110011111111111111011001111111110a1111100111110110111111110011111111011111111111111111111011111001111110001011111a101010
11011111110011111101a111a100111001011110100111001111111110101111111111111a1000111111110111111111101111112001022002112211212222121212211101111111011111111a111111
11011111100111011110a111a101111011110111110111111111111111101101010111011a1111110111111111111111111111111111102021020102221212121022201011111110111100101a101111
10110110111011111110a110a111111111110101101111111111111110111111110111101a1001111111110111110011111011110121222002210200121100112121111111110111110110111a001011
11111110011111111111a011a110111101110111101111111010111111110111100111111a1111111011111111011111111111111111111112021111210221222222111111101111111110110a111110
11110111111111110010a110a101110111101111101111010111011110101101111111101a1111111111101110101011110111112220102211211212222121211122220110111111111111110a111011
11100011111111111110a101a011111100111111111111110111111111100111111101101a1111010011111101100111111001112212112120221221112022210211212011111110111111100a111111
11100111111010111001a111a111011111111111110111111111110101110111011111101a0111101111111111111101101111111112122221202201112111021202212101110101111111111a111011
00100101111011110010a110a011111011111101111111100011111101110110010111101a1110111111110110111111111101112220021111022220011100211222101111111111111111100a111111
11111111111111111111a111a110011111111101011101001111111110111101111111111a1111111011110111111111110111112221221212112121002022121111212110110011111011111a111101
11011110110110110111a111a111011011011111111011111100101010111101111111111a1011111011110100110111111011112001121001012222202002100212221101100111110100011a111111
10101001110111000111a111a111111111110111111101111111111101111111111111011a1101111011001011111111011111110202010012110111111222012022221111111111111111111a101111
01011111011111011111a111a011111111110001111111011011011011110010111111110a0111011111011111111111101011110212102211202210211201012022211111111110111111111a110101
10110101011111110111a111a111110111101110111101111110111110111110011101110a1111111111111111111111110111112121110122012212221212112212220110101111111111011a111111
11110111111111001110a101a001111011111110110111101111111111011110111011111a1111101101101101110001011101111211012211122211222121121211111101110101101101111a011101
11111101111110111000a101a111111111111110001111111111111101101111111110111a1111110111011111100111111111111211120221221122211112222002101111001010111001100a111111
01111111111101110011a110a110111111000111111011111110111110011100010100101a1110011111111101000111111011010000211220202012210002202220011101011111110111111a101111
10111111010102112112a121b022101122210102111101111111110011111101101111111a1111011011100011111101111011112112002021020221212221012112122111111111111111111a111111
01111110111102102122a012b011210112121210121110111011111110110101100111110a1111111101111111111011111111112112111111200221110102012121221111011111011101100a111111
11111111110020022212b122b110021022221110200111111111111101111111101101111a0001101101011101111101111101110002001222112122112201210121201111111111101111111a111011
11111010111221212102a221b220110211100212111011111110111111111100111111111a1010111111111111111111111111012221011112100221111222022201220111010101111111111a111011
10011011111010210122b001b211202121102221121111101111101110110100010110111a1111011111111110111111011111101211201202221211210200222002121111001111111111101a111101
11111111111111122211a101a221121200212120121101110111111101001101101111100a0111010101111111110000111010101221121002122221222111122022120111111010011111111a111111
11111011111122212121b102a122111122012011111101111111010011000000111111111a1110111111011111111111110111011222112010212222212011222102221011111111111100111a110101
11110011111101212112b111b110112202221111021011011111111101010111100111101a1110111010110011011111111111110221002212221121102202112120221100111111111101111a111111
01111111101212212101a111b122111222112211121111001110001110111110011111111a1111111110110011111111111101111112222120121212221202120022011000111110111111111a110101
22220122212222022222a221b201221022122212120010111111111110001110111111101a1111111110101111011111111111110121121221111021211201011112112011111111111110101a101111
11221220112222220022b221a222020221112101201101111111111111011111101111101a1101111111101111111111011111112211222220222220212222200222111110101010011111101a111011
11221202220210212222a202b222200221110100111111111110110010111111111011111a0110011001111111111111111111112211112001122221202120112210201111111110111001111a111101
20121201112022120200b012b202222021111102201011011101111001111110111111111a0111111111011010101111111101110121120111020010010112201201211111111111101111111a010111
11122211222220210222a221a102112020021211021111111111111111100010111111111a1111111011111111111001111101012211102121120120110021211111202110111111111101111a101111
22101210122120221201a222b200112021222220221111111100011111101111111111101a1110111111111111111111111110100212202112122210112210112221122110010101111011111a011101
20120212101112111210b122b222222112220211201100101011110010011111111110001a0111110111111111111011111011101110012021001112102121212221111012101101101111011a111111
02220222122020222101b222b102021010101120120111111101010111111111111101111a1111001111111111010110101111110111122211222212022002222221210222001110100111110a111110
00111211222212222220b220b222222112112210111100111111111011011111101110110a1101101101111111011111111011111112020210111001220211201100212211110111110011101a011111
11101122122012112222b020b212221022012000220111111011011110011101101111001a1111111111110111011111111101010110101111122122201120111110112202101111111110111a011111
21202221022221202200b022b202021012100101101111111110101111010111110101111a1110111111100111011111111110101111112011222222222101111121022011001111101101101a111111
20201111212202122121b200b222120210221012211111111111100111111111110011011a1011110100011111100101111011101112221110102212212122212112121202111011001111011a001111
11110221102200222122b221b220111211221112211101110111101110111011111111110aaaaaaaaaaaaaaaaaaaaaaaaaaaaaaaaaaaaaabaabaabaaaaaaaaaaaababbbbbbaaaaaaaaaaaaaaaa111110
21112221210121121221b212b122002022212222211111111111111111011111111111111111110110011011110101101100011111111122011201222011101112201101011010111110111111011011
11202112022222212221b122b220211122122022120001111101111111101111110110110100011111111110111011111110111100111122201120121121021201220011111110101111010111100111
11220011021212001222b212b222201220112222111100011101101110101011110111111101111101010111111111110110011111110211202211222022121020012022121110010111111110011111
12122211122112100102a111b222220111220211121110011111011011110100111111101111110101111011101111111011111111021121212111111122111222100112201101001011101110011111
21021202211210222212b022b202222020000211221111111111011111111000100110101011101101110101001111011111111111101111122021122012202210212122221011111110111111111111
12222212220022222221b001b022020211110212021111110111101111101001111001111111011111011111101011111111111111112110221112211221220202221122111111111111111111111111
21220221001200022212b200b022120222201122011111010011101110101001110100111111011110111101111111101011010111022122020002202221020110221112200111001111111101111111
22210121120022222220b222a222002211210120221111011111111101111101111111111101110111111001111111111111111101121120111101001221120121111012201111111101111111100011
21222211022121212100b212b102222112202021101110110110010001111101111110111110101111001111111111111111110001110121111122001122112200111211011110101111111011111111
21221220100101121202b120a122222001111101101110111011111101111110111011101100111111111111111110101110111111120220101010112110102102200220021101111111110110111011
20112111201110121002b222b111212111111110101011111111101110111101111101011001010111111110011111110111101111102110222222021112210122021102211101111101101111101110
21101211101012110202b122b222112101111111111111110100121012111121121120222201101111111110111111111001101111121012211202200122110021211111221101111010111111111011
11120102121211122112b102a011111101111111110110111222122020221022012200111122120211111111100111111111111111101110011111122221202121111212201111010011011100111110
12101122121212201222b022b111022111101110111101101212221202111222110021110002212111111111101111110011111111122200112122202110101012102222211111111101010011111111
01021210210011001222b122b112121111111101110111111222101222020202012120022121012011111111011110010111111111101111121111001222112222201211221101100100111111110111
20222221211221111221b211b111102111111101111111111211121121021102221211110102002211111110110101011111110111102222221111002001121212111222020001110111101011101111
22212122212102111121a101a210020111110101111100111210011101112211212201011120211110110100101111111101110111012111201122112121211222012212121111101101111111101111
22212201021100022222b211a212111111111111100111011212120122102121211000011210122110111111011111101110101111120122120202222222121212101122120110110011110111110111
11011111111111011111a111a10100111001110101010101112222221002212221111111121102221010111111111111111111110001122110aaabbbbbaaaaaabbaabab0101111111100111110111001
10111111111011111110a101a11110110111110111011110122111020212221212112112110222100110111111111111111111111110001122a1020201122202212211a1021100000010001011011110
11111101111111001110a110a01011101111111111111111011121221111012012221202001112121111111111111111101111101111102120a1100102211211212202a2201111110101111101111111
11011011111111111011a011a10001110010111111111110112102010202212021102221100222001111111111111111101011111101121120b1211111001201022120a2221111101111110110110111
11111111111111111111a110a11101111110111101011011000002111101210110111202200112221101111011000100111111110112112021a2012202121110121112a2121110011111111111111111
11111101111011110010a111a11101111111010111101111020022212002021221010212111222201101110101111111100111111112201122a0221211020121122221b0210111111011011111101011
11101111000111111110a111a11111110011111011111001101101112102212122211200121222210111111011000110111011011001001111a1110101111100110111a1111111101111111111111111
11101100010111101101a111a11111111111101111011111112022011221002222022112011020010111011111110101010011111111011111a1110111110111111101a1110111111101111111111111
01111111111101101111a011a11111111011011111101101110101210120020111102121012110210110011111000110111100111111111010a0111111111111011001a1111011111011001011111111
10101011111110110111a011a10011111110110111111011111110122122022120212200211111021111111110011011110111011111010111a0111110111011111110a1111111101011111111011100
11111010001111111111a111a01110111111101111110001022221120122122121122121120222021111111111111111111011111111111111a1111111111110011110a0111000010111111111111101
01111110111010111111a111a01110111111011111011111010202011100122121222112012221211111111011011101111111101111101011a1111111111110111001a1101111110111101110111011
01111111111100111111a111a11110110111011111011101111110211211212200101122122011221111111100111100111011110101110111a0001101111110110110a1111001111110111111111111
00111111111101111111a000a11111100101111110111101121211211111111112112120221222221111101001101111111110111111011110a1111110111111111111a1101111111110111000111111
11111101001011101101a101a11111111111111100110111011110200211012121220021022212201001101111111111111111011111111100a1101101111111010111a1011111110111111011111101
11011110111110111010a111a01111111101110111111101100110121112211211001212211211111101011011011100011111101101110111a1101111011111110111a1111111111101111110110111
11111101111011101111a111a11011111111111011111111121221202112212122122122122112011111001111110111111101101011111111a1110111110101101111a1011111111111111111111111
11011101110111010101a101a11111111111110101111011121202221220210120110122110121101110101011111111111011001111111001a1001011001111101110a1111111111111110101111111
01111111101011001111a111a11100111011111101011111100012120111112102221101121112111110011101111111111111011111100111a0111101100111111111a1101111111101101111110111
11111111101010111011a111a11011111111111101011111112211110121122200112111122211201011111111011111111111111110111111a1111111111111111111a0101011111100110111111011
11111111011110101111a011a11011111001111101111111102012202112100222122102202021011111111111111011111111100011100111a1111111111101100011a0011111111111000111100111
10100111111111010111a101a11011111111111101111111111010111220111221221112002210011111111011111101011111110011111111a1111110011100100110a1111101111111111111101101
11111111111011100011a111a11101111111111111011111102201112112212120110222101220201111111101111110111111111111111101a1011111111001111100a0111111110101111111101110
11011110101111111110a111a11110111101111001111111120022200122122212102122010012211011111101111111111100111111111110a1101111111111110111a1110101111111111101111010
11111111110111110101a011a01101011111111111111101111111101011111111111011101101011101011011111110111111110110111111a1101111010111011111a1111111011011111111111111
11111011101111111110a001a11101011111110111111011001011111001011111011101110111111111011011111111111101111110111011a0110111111110010111a0111111111011111111111111
10011110011111111111a100a11111111010111111111111111110101100111101111110110111111101100111110111111100011111101111a1111111111110111111a1100111111110110011100110
11101111111011111010a111a11011011111110110111101110101101101111000101111111111011111011111111111110110011111111212a2101112222122222201b2111120010111010010111111
11000011101111111111a101a11111100110110111110110011111101111110111010111101011111111111101010111110111011111110012b1212211112011101111b0101220111111111111001111
11111111101111011111a111a11110111111111111111100111111011111110110101111101111111110101111101111111111111111101022b2011111122210120101b1212020111111111111111110
11111111111111101111a111a11110111010110101110111110111101110111111110111101110111110111111101111102202212201201102a0022222210021122112a2202221011011111111100111
11111000111111101110a111a01101010111111011211112212021201111202020211122111011111111111111101101012021100212221121b2101012221020222122b2112022101111111111111111
11111011101111111111a111a11111110110110110212110122210111111201202111011111110111111111111111111212211221001111220b0222222020212120202b2221200010111110111011111
11111111111111111111a010a11110101111110101002020122111201222022122202001111111111110111011110111212212111021212202b2022222201112022222b2201200111110101111100110
10111111111100111111a111a11111111101111111020011212121112102100202222221111111101111111011011111012111122122112111a0222222220011221210a1122111101111011111111101
11110111001111111110a111a11111110011101112110021022201121100212020212211111111010111111010011110022222212122110202b2222220220122211122a2202212010111111101101111
01110110101111010111a011a11111111101110111222220212212201102222222112011111101111101111111101110012212110112110122a2222222122220001220b1112111111111011111111111
10110000111111111011a111a01111111001111011221112121111121211122211101110110101111101011011011010120212201221122222a2100122221220122200a1210121111111001111111011
11111101101111110111a111a11011111111111101102220122201212212120212222211111111111111110111001111202221001011112112a1222220202221100221a0010212110011011110100111
11111111111011111011a110a11111101011111112002110000212011111012221120220011110010111111111011101221120122212202120b2212121112210220122a2211111111011100101111001
11110110111110100111a101a10111001101000102212111122120222112221112211112110011111111101110101111221101222122212110a0112222221212212111babaabaaaaaaaaaaaaaaaaaaaa
11111101101111110010a011aaaaaaaaaaaaaaaaababbbababbaabaaabaabaaaabbbaaaaaaaaaaaaaaaaa01101111101101112122220111222b121212220222002220200110222111111110111111011
10011110111111111101a111110110010011110110112101122222110212122222122112111111111111a11110111011020112020210112202a120202222122220001212202221101011011111101111
11101001111111101011a110101111101110111011221201211212200122112212122021111111011111a11111111111010010220112022120b102002221221112021210121121111111110011111011
aaaaaaaaaaaaaaaaaaaaa111111111111101011111012101022222211210111111121102110010111111a11111111111220222200222002200b221022212102111210112111211111111110101011110
011011111110101011111110111111010111110111200111121220112212101222212221110111111110a01101111110022211211122110222b222212222021212211211222210001111111111111101
111111011111110101111111001011111111111111112022120211011122121210020100101101101111a11111111100222212212212212222a201222222120221220112112112111101111110111110
110111101101101111110111011111111101101111202212000112002212001222201110011111111111a11111101111220222202111102222b110211222022122221121122211111100111111111011
111111111111111100101001111111111101111112212022220201011121222222011220110110110100a11111101111221101201111010212b222222221202202221022111021111011101111001111
111111111111111111111111111110110111011111012220011121201211111201120220111111111111a11111011111111221102122201210b222222221012211211121110121111111001111111101
111011100111011101000111111111101001100011222122220112022212110212221120111011111011a01111111100221011100021200022b020122222121122221211221111110111111111110011
010111111111111111111111111111111011011012022212102211210202122212010211111110011111a11011111111220111011102112021a220222220220220010112002120111111101010111111
011111011101101101111111111111111111111101122112121201001110122221212222111111000111a10111111101122222110102212122b112122122222220101022110222110100110101111101
010111111010111111111110111010001111111101221212222101100201102102100111111111101111a11011111110021210112222212222b212222220222121112211120212111101110111111011
110111111110111110110111101101101111110102201122221221221212022211110122111111111111a11001111111222221110222212202b221212202021122220212121102010001111111001111
111111110111101001101111111101011001110102022012010221212212222102111001111111111001a11111111011121122001111011222b121022221222112222122001022001110110110011111
110001011111111101111111101111110011010110222110222121212022110121012211111111111111a01110011011211111102112122222a212210210212000111011222212011111111111110101
111011110111111111110110101111111111110112121202111210110210011102121012111111100111a11111111111201102212212121222a212010012222002112120121012001111011100001101
111111011111010101110010110110111110111112121221222211112221122010112111011101111111a11111011111222201220212122112b111101201112111110111111111111111111111111110
111101101111111111111001111101110111111110121022101122121211101220202201111111111101a11111111110112212212000022121b221110222022111010111101110010101110111100011
111111111100111010110111110100011101110112121112221201111210122222202211111101111101a11111110111111211121102211121a011012122211111110110111110011111111111011110
