4 11
31 110
122 49
126 101
64 67
119 18
56 105
111 104
8 43
26 34

1101101111111111111111111111011111100110a111111110a0101111111111110101101110100110100111010110111101101011100010111111110001010111110110111100111111101011110111
1110111101111110011111111010111100111011a010111111a1111110110010011001111111001111111110111000110111011111111111111110111111011111111011111101101111101111111111
1011101110011111111111001111111011111111a111101111a1111111111101110111111101110101111111110001111111011101101111111111011111111110111111110011111111011111010101
1110111111011111011110111000111111111111a100111011a1111111111110110111111111111011101101111111011101101112222212221112212220112211211111011111011101111011011011
1011101001001111111111100101111011111101a111111101a1110111110111111111111010111110111111011001101101111102222221221212102221020112112211111000110101111111001011
1101111111001111111111011111111011110111a111100111a1111111111111111100111011101111011111101111100111111102000202201122121121120102101210101111101011111010111101
1111110111111111110111001111101011111100a011111111a1111111110001101111101111111111111111101110011000111121210020021110220202211211022211101111011111111111111011
1101111011001101101001111111110110111111a111101111a1011101001111011111111111111111101011111111111000110122202021010201021210100212220121111101001110101011010110
1110101101111111111110111111001111111111a101101111a1111111111111111110110110011010101111111110111011111112120211101121210222221111201221111011101111110111011010
1111011111111011111011110111011111001111a101111111a1100111111111011111011110111011110111100111111111111111221012100112001222111222121211111011111111111111011111
0111100111PPPPPPPPP011111111011011110111a111110001a1111111001111100001110001111101011101010111101001100101221211122211110122122112111111111011100110011111111111
0111PPPPPP010111111PPP010011111110100111a111100110a1101100111101111001010111111111101111111011000111101122211211112211112212120210100211111111101110101101111011
0011101110010111000111PP0011101101001011a101110110a1101011100111011111001011011111101111110111011110111012200110221122112222220211221221111111111011011001101101
101110111110111111111111PPPPP11011111110a111111011a1010111100101111001011110001101111111101111111110011112121102200212212101222100212121011110011111111111011110
00101111111011111101001011101P0001111011a111111101a1110011111001110011111110111111011110111100111100111122212120012211202122222121000111111111101011100110011110
010111111111110110011111110011PP01011110a011111011a1110110111101011111110111011111111111110111111011111121122212211021111000211100112211111111111111110111111010
01110111110111101001111001111110PPPPPPPPa011010011a1011111011001111111110101101011011111111111111111110121212012121120120112212122120211111100111111010011010111
1011111001101111111111101110011111110111P110011110a1111111111011101101111011111111111011111110111111110110202222012222101210221222212120101111110110111011111111
0110111100110111101111101111111111111111P011111110a1111110111101111111010111111110111101011011111110110011211110212001122221112121220001011111111111110111111011
1110110011122111121121202020002012221111P111111101a1111111111011101111111011110111011110111111111111111111222101112020012121211200222010111111011011110111111111
1110111101112012210120121102210211022010bPPPPPPPPPa1111111110010111110111111111111111111111111111111111111111100221111112221102121222000110111001001111111001110
0111100011112012222221122210212221100101a111111111P1111101111111111110111101111101101111110001111111000111120001120112122111212211122210001100110011110111100111
1110111111122222221122122222112221001222b201111101P1111111101111110111111111111111110111111101111110100122102112012121022100211110012111111111001111111111111100
1111111001001201110220100212221111221210a111111011P1110111110111000101101111011000101101111110101111111101222101012221121222221212112121100111011110111111101110
1111111110111222221021021102221221222220a011111011P1111111111111111111110111111111111111101110110111111001021101201102210111021201022120111011101110111111010111
1110111111111102222221211110222220221112a110111111P1110111111111111111111111111aaaaaaaaaaaaaaaaaaaaaaaaaababababbbbabaaabbaababababaaabaaaaaaaaaaaaaaaaaaaaaaaaa
1111001111122022112222211111121201102110b111111111P1111111111101101101111111111a11111011111011111111011100111222111122120111022212120120111110111110111111111110
1111111110122021212121011122211211211222a010101111P1111111011110101111111101011a01111011011111111000101012110211100212222100211202220210111111111111110111111101
2221000101220210202022212102002201001222b211111111P1111111110111111111011111101a11111011001111101111010101112211202221002111012212212221111111111001010101111111
2211222222122222102112121202000110121122b110110110P1011100111111010011111010111a10111111011111111110111111111211020202222212021112111011111011101111110011011011
2222101111221122202012221221222122122001b110111111P1111111111011111101110111111a11111111110111111100100110211221111122222112021012100221101011011111011010101111
2002122112001100021222222120111021122120a210111111P1111110111111111111111011111a11111111011111110011111120110101011010221122102210211111101111110111111111111111
1211111211220222102220220222212102121202a211111110P1111101111110110111111111111a11011011110111111011111011112112202012122112221021222111011011111110111101111111
2011212112202120122210212221221112121012b000101111P1111111111111101101011111101a10111111101111111111011012122121110102221121221011222211101101111111111111111110
0222012110221200211222011222211020121112a111110001P1111111111111111111011111111a11011100011111101111101111111222100122210222101102211000111011101100111111111110
0012110211122220022222100220221101011012a111111011P1111111111101101011111011111a00110111111110011101110111111211011121112021120210201112101111110110111011111111
0220102122110212221122222220222122210011b111010110P1011001110010111110111101111a11111100111101101101111111100111020101201222210001111010120111111100001111001111
2110001010121022212002220222202001211111b010110111P1111001111001111111111111101a01100111011111011001010111111112121101210212121200222000211011111111111110111101
0011121211022222212220122112222110210120a111101101P1111111111111011110101111111a01111111111001100111111101012012122121111112112101201022211111101111101111111111
1012112011120020021022122221022020221222a111111111P1111111011011110001111100111a11011111110111011111011111120222020101001000220221221112121111101111101011111101
1110011111012211222221022220122001010122b111111111P1111111011110110111110111111a11011111101111011111111011021212120021002202200202221112211111111111011101111011
2222221101111222012110211122120121122222b211111001P0111010011110111111111010001a11011111011111111110010010112111111022201210222221112221111111111101101111101111
2021221022002101222102202202201211212112a001111111P1111110101111111101111011010a01111111101111111111111101112021210221221120021212222012200111011101111111111111
2222221021121220020120221112222112012221b000111011P1101111011111111101101111111a11111001111111101111111101120112121121121222211211022120000101111101111101011111
2212122022122221012022100012220120210001b210111111P1111111111111111110001111011a10101111111110111101010111120121222011222212121110211210020111111000011000111111
2102112021120122222222221120222121210120a111101111P1101011101110011111101101110a11110111111111111111110110112011121210121111121200202012111110111111011011111111
1110220122220202220220202222201001222210a111111110P1011111111111111110111101011a11111001011110000111110011121220022211221121211111212201221110111101110110111110
2012122211020122222210122212200222202111b111111110P1011111011101111111111111011a11111111111111111111111100122012121221111012000221120222121100101111111101111100
0121121122022212221022222022212010011210b011111011P1111111111100111111111001011a11110011101111101111010101122101102210122101010221011212221110111111101011101011
1221222122222222220201122000221212121101b211010101P1111110101111111111111111101a11110110101110111111111111002211122002121221121111102020111110100111111111111111
2111101122222220102220121221122011111111a110111010P1111011111011011011110111111a01110111110101101111111101010212102101212211020200100121120111111110110111001111
0222112012112211120212122200122101010111a111101111P1111111011111101101100011011a11111111111001110011111001021112211121022101120022112121121111101011111111101010
1221112010220220101221122012122110101111a111111111P0211122222010201110212122221b11111111101001011000111011111210122010110121011111011221111111111111111111101111
1212111101121221211222122020011111111110a011111002P2112021010121202010002121211b11110111001011011111011111122211122012222011022211221010210100011111011101011110
2222220110012211221212211122102111111111a110110111P1121121100001112122120121202a10011111101011110110011111112111100210111111221201112211211110111111101111111101
1221102210112121122010022012122100110111a111111112P1010021012111111121112101212a11111111001111101011101111122220110120220210011220011121101111111000111011101111
1201120022112210010212110110122011110110a111111010P2022211212212120012012111022b11011111111111111101111100112220112111222120111222012201021101110111101111011011
2211121221122112000222111111221111101111a111111112P2202221222202011220100211221b11110111111111111111011101121100001222212200120201201112211110111110101111100110
2111212101111222222211200111101101111111a111111112P1220011220000201021122012102a01111111111101111011111111111121112102211212101012120122111111111111011111110011
1110100111001001111101111011111111110011a011110112P2101110112200022121112201211b11011101111111111110111111011222021220222202122211101101121001111111111111111111
1111101000111011011101110110011111110011a001111001P2120121200111102122002211201a11110111110111111111111111112121222002022111112112102111021110111111111111000011
1111000111101011001110111011001111011011a101111100P0020010112102222021122112020b11111001110111110110011111112222212012121001200222201102221011111110111111110011
1011011101111011101111011111111111110101a111111110P1200211122102111110212102110a11111111011111111110111111112112202212121221011112112201211111011111101111111111
aaaaaaaaaaaaaaaaaaaaaaaaaaaaaaaaaaaaaaaaa101111102P1201222202102111112202212120a01101111111001110111011111111112212121111001221222102220201011110111111100111111
10011111111011111110111100110111111111111110111112P2210222112111011120200101101a10000011101110111111111111121111220222122111122120212221221111110001010101111111
11110111111011101110101111111111111111111101111112P2221021122212211012122211022a01111011111111111001101111110101011010111111111101101111111111111111111110110110
11111101111111000001101101101011001111111111101112P0112101011102001111022112221b11110111010111111111111111111111111111111010111001111011101111111111111111111111
01111101011111111100001111011111011111111111111111P1202001010112111010011202021b01011111001011111111011111111111101111010110111101010011111101111111011110111111
11111110111101110111001111110111111111110111111010P1212211110100210222102221120a10111011011111111111110001111011111111111111101111111111011111111111111100101111
11001111111101110111101001111011101001111101111012P1222222102201112111202121122b11111111111111111011111011110111111111111001111111100010111011011001111000111011
11011111111011011111111011101111111111111011011111P2121110002121210122012112102a11111111111111111111111111111111011110101111111111101111110111101111111110111111
10111101111111011000111111101111110111111111010112P0112221212111121212120222122a10111111111111011111101111101101101111011110111101101110110010111111111110110111
11111010111010011111101111011111100011111011110002P1212211111012201211220221211b11111101111111111111111111111111111111010101111111111111111111111111111111101110
11111011110111011100101111111010101011101100011112P2112102200111220101221012220b10111111111111110111111011111011111111111110111110111101010111111011110111111111
11111111111011101111011111111001001110101111111112P1211121121011021120112112202b11111011110111101011111111010111101111111111111111111101111111111111111111000111
11111101011011101111011111111111111111101011111110P1122221101211122222111102011b11111111111011011111111111101011111111100111110110111001111111111111111111111011
11011111011100111110110111011111111010001111101111P2112112102022122210110011110a01101111111111111111101111111111111011111110111111111111101110111111110111111111
11111111111101100111111111100111111111101010111112P2021011010010011122021212020a11110111111111111111001111011111111111011111101110011101111100101011111111011001
01111111101111111111101111111111111100111111101112P2101222100221122112121221221a01111011110011110111111111111011111110100111111111101111111011111101111111110111
11111001111111111111101111111101011101111111111111P2222222011100112202100221200a0111101111111010110111111111111111011aaaaaaaaaaaaaaaaaaaaaaaaaaaaaaaaaaaaaaaaa11
11111101111110111111101101011110001111111110101111P1001011221212212111122110222a1011111111111110011111111101111011110a111101101001111101110010111111101111111a11
01101111111111100111011111110111111111101111110111P2121022110220211111222121201b1111111111101111111111111111011111111a010111101111111100111011111111101010011a01
10111111011111111111010110111011110101001111110112P2202012111201102110212222121b0111111101110011111110111010111110111a110111111111111011111111111110101111011a01
11111011111110101101111101111111011110101111111111P1101111110111011111011110111a1111101111111101110111111111101111110a111111111111011100110101110011111101111a11
11111110101111101110111111111110111111001111111111P1110111111111111111011111111a1111111101111011011011110111111011011a110101110011111101111001011111111111011a11
10110110110011101110101111111111111101011101100111P1111110111111101111010110111a1111101011111101110111110001011111111a111011101111111101111101110111101111111a11
11111011111110111000011111101011111111101111111111P1011011010011101011111111101a0111111111111010011111011110111211202b222120100211221201222112011111110110111a10
11011111111111111110011111111111010011111110111111P0111111111111111110011111011a1111101100101110111111111111111210220a010012121211112222210111011111111011101a11
11111111111101111111111101111011101111101111111111P1110011011100111011110101001a1111111011110111111111111111100201122a221200212112200222221111110110111111110a11
11001111110011111110101110111011111011111101111011P1110111100101111011100111111a1111111011111111021211110122211100220b222211021200212120211201011111010111111a11
01111111111101111111011001111111111111111122210222P2111011101112221221001011011a1111111101101111121112210200210022221a212221102001111221121121111011011111011a11
01000111100111011101111011111111110011111121122112P1121210111020122202121011011a0100101110111111021120121012122100211b222222112102222121212120111011101111100a11
10111111001111111110100101111110111111111220202001P0210210021211120011021011111a1111111110101011201222210122011102212b122112222102001120221201111101011111111a10
11101111111111111110101100110111011110111212211221P0222122220001112111001101111a1111101111111110022122121211220222202b221212222112220201210111111111101111100a01
11111111111111111111011111011111111111111121210012P1222210212212211111110111111a1011111110100011211121022212101021222b022222021212211221222012111011111111111a11
11111101111111011101011101111111110010110220012010P2101120011110221120211110111a1111111111111111102121102111220222220b001222221212121012222111101100101100011a11
11110111110110111111111111111111111101111211121112P2202020002211211112200101110a1111011101110101221112222211222101222a222210122222110122110121101111011111011a10
10011111111111101111111110111011100101111221012211P1211200222222222111221011001a1111110110111101210120102220221202221b212112012022111110211122100111111111011a11
1111101100111111110110011111111110111110121212122Pb0112222220120200221221010011a1111101111111111211022112012111001221b222002220022111112221210101101111111011a10
11011110111111101111111111111010110111111222112PP0a1201211122021111022121111111a0110111111110011022112222120121220121bbbbbbbbbbbabbbbaabaa1111011111111010111a11
1011111011111011101111111101110111010111102122P012a0202210212212211221020111011a111101111111011102112202022211221220200222101001200210202b2212000111011111011a11
101101111110011110011011111111111111010111201P0001a1012212202222020121001111011a110100111111111121220002222121210222012222220222022011121a1020010111111111111a01
00110111111111110111111111101111011011110011P12212a0211211212021000111220111101a000111111111001121011211201111122102221222022201220111112a2120111011111111011a11
0110110111111110111111101111111111101111120P211022a0022211002211110121211011111a111111111101110112011222222121122202222222022201210021211a1021101110111111101a11
001010111111111011111111111111001011111112P2022010a2200122220121010120121101011a101011111010111121022211102222012100102201222012220121011a1021111011101111111a01
11101011010101101011111011111111110101PPPP10220211b1202122210222121112020111111a111011011101101101012021110222012122220021122102121202121a1220111001111011101a11
1101111111111011101111010111111111110P110101211100a1100220022122222220101111111a111001111111001112111120021211122221202222021212111200212b0212111101101011110a11
1111111110111111111101110111111101PPP1111121211002b2200212222122002200210111111a101111111111010112022120212120021221202220202221221202102a2211111111111010101a11
111111111011111111111101110011101P0111111221011222b1011212011222111112221010111a111101101111111122202221112020102222022202020122101100020b1122011011111111111a11
11111111111111011011010111011111P11101110220011011a1112112210212022121211111111a101111111111011012002110122122122222122211220021112111122b1211011101111111111a01
1111101111111011111101001101011P111101101011122122a0121102122202201211001111111a011011111111011111210122201022120222211212210212201022010b2022111110011111011a11
11010110111111111011111110111111111100111111002211a2021111222212211222111101110a111100111111110112222110020221122100211210210222011101121b2212110011111111101a11
11111111110111110111111011111111111111110111202212a1120111222200212111101111111a111110011110100110002002111120222212202222212021111001122b2221111111110111111a10
11111111111111111111011110111111011101111002212010b2201201122200212021221111011a111111011111011122221222211112121222222222020222212222021a1210101101111111011a11
10011111000011111111111110111111111011111201011022a2010112210210120202021011100a110111111111111112202122102211220000211211200022221121012a1212011111110111111a01
10011011110111111111111101110101111111111101112211a1212001202122110221211111010a101111111111110121121220021222122201012222100220122212212b1212111011001111111a00
11011011101111101011010111111111100111111220222212a2221111002122021020001011111a111111111101111012221121111211122120200210222121111111021a1001110010111111101a10
11111111111101110101110011111111111101110111222221a0202200211221111212220110110a111111101111111112122221222221220012111212022220011011011a1111111011111110111a10
11111111111111001111111111111111010111111211212010b1002200110222222222220011111a111011111111111010200122212212211200010011022211111110011a1111111111111111111a11
11111101111100111111101111111011101110110000112012a0220221112220200212021111101a101111110111111122210112111212121121212101212211011011111a1111111111101011111a11
