4 11
31 110
122 49
126 101
64 67
119 18
56 105
111 104
8 43
26 34

11111101111111111111a1110101a101101101101111111111111011111110100110110111111111111110111101111111101011011001111111111110101111a1111111011111101111011111101011
11100111101111111111a1110110a111111110011111111111101111111111110111101111011111011111101111111011101110111001111100111111000011a0101111111111111011111101011111
11101111111111101110a1011101a111100101111111111111001111111101100111110111111111110110111100111111111111111101111011111111111111a1110011111100111111011111101111
11110111101111110111a0111101a111111111111101001111100011111111100111111111111111011111011111111001011101121212111222121012220212a0112101111110111101011011111011
11111110111100011101a1010011a011111111001101101011111111011111101011111111101110111111111111011111111111211002211221202210120202a0112210111011111111011101100111
10111111111100110111a1111101a110111111101011111111111111110111111101111011111111111000110111111111111101121212201210011212222121a1122101101011110110101111101011
00101111111001111111a1100101a110101011111111111011010111010111111100101111111111111100101111111111111111210020201110122101221101b2021101111111100110111111011111
11111111111000111110a1011010a101111101110111111000101101100111110111111111111001110111111110101111001111212120201222100212211112b2111121101111110111111111011110
11111110111111111111a1100111a111111111111111010111111111110111011101111111110111111111101101111011111110221102212112211211221212a1020221111011110111111111110111
11111011000010111111a1111111a111111111111010110101111111101011101101011111101110111110111110111011110111121111122222211212202000b2111111111101111110111111111111
11111101101110111111a1110100a110111110011110111111111110111111111111010001011111111101100110111001111111222210221122111112211212b0122111111111110101111111101111
11111111011101011111a1111011a101011111111011101111111111011011111111111111111111111111111001111101111111221122020212211001100222a2201201011101111111011111101111
11111000000110111111a1111111a010111011101111000011110011111111111111011111010100101111011111011111111101111102201222101111112212a2022121111111111111111111011110
11111101111001111010a1110111a111111110110111111011111010111111111110111111111111111011111111111111111101222212201210211211222112a0110110111110111111111111101111
11111101011101011011a1111100a101111111101011010111111101010011110111101100111111111110110110110111011111111121222111122111121221a0012210101111011011110111111110
11101111100111111110a1001111a101111000111111011111101111110111111011110101110111111111011111111110110011122121212010210202211012b1112121111111101110110100001111
11111110101110010111a1111111a111101111111111111111100110111110111111111110111111100111110101111001111111101021212202121121111122b1210011111101110100111110100101
11001011011111101110a1111111a101111101101101111111111111111111100111111111101011011101111011111101111111212211021111220212100111b0222010111111111111111111101111
11111111101111111101a1111111a100111010111011111111111111110110111101111101101101011110111001111011101111102201121102100202120220b2012211100111111111111111010111
11101100110210121110a1221121a211121002111211101111111111011001111111111111110011011001101101111101111111212110021221222121211202a2012211111101101111110111111111
11111111011222111112b0212112b112022211111111111101011111111111111111111111011110111110101111111111101001122222111012222220211221b2222201111101100111101101111100
11111111010110110202b1212211a112211220222201110111110111110101111111101111111111111001111101111111011111202220012110110221211111b0222011101111011011111100010101
11111110101210222111b1002021a122122012120110111110110111110011111011111011110110111110011101101111101111111122211002101221211021b0122121111111011111111111111110
11100001011111122121b2120022b222202211101111011110111101110110111111100110011111111111111111001111110011111220021112010000212021a1200011100100101001001111111111
11111101001121112002a1111102b211112212211111000111110111110111111101100011111111011111110110111011011110112012122201020210110200a1111021111101111111101110111111
11111101111222101100b1221110a012112002121011111110111101111011111111011111110100001111110011111111111010211210212211120211010112b2221001101111011011011111101110
11111010111211211220a2012211a202110202102011110111111111111101010010110010100011111111111110110111111110020221111111121212012120a0121111001111111011111100111111
11111111111211112102b2221112b222011111212101110110111100111101001111011111101111111111111111001110101111111112201112212100121110b2212221111111111111111111111101
22121002211201000112b1202220a001120121112201111111111111101111111111111111111101011011110010100101100111102202100222201210210221a1120221111111000111111000101111
11002201012222222000a1120022b221212211222210111111111111111111010101010111110101110110001111011001101110102202121222212112212211b2101210011101110111111010110111
11202211211221120112b2002221b002220212220111111110011111101110111111111001111111111111111111001111011111110222002221212200222201a1011001001111110110110110111011
21021111112212222002b2210122b120211111111201111011110101101111011111111011111011111101110110101111101101111021102121122202122220a1101111110101100111111111101011
11120100111112212220b2222202b000122221212001110111110011101111111101111111001011011111111111111111111100211120212212212211122101b1122120100111011111101111111010
10111210121221002212b0222221b021012021212111111111101011111101111011011011111011101111111111110011111111102221222220212111210212a2022211111111111111100011111010
11122111122002112212a1222222b201201121202211001011001111111010111111011111110111111010111111111111111101011121120101101022210021b2102221121111011110100111101010
11111120201221200121a2022220b222001110202101111111110011111111101101111111011110111110111111111011111111111211212121111202211211b1111111121111111011110110111111
22022111200022220222b2111000a222121212122210111111110111110011111111111111011110111011111100111111101111111021121110112222110221a1110212021101101111111111110110
11212022212102012220b2120212b011101222221011111101011111111111110110111111101110111110101011111100001011111221211112221020220220b1212212021111111110111011011101
21021100011202220222b2201212b021221220201101111101101110111011011111111111011011111110111101101111111110011020221102222120212212a2100211101111000101000111111111
02212222122202221100b1222012a021122022022011110110101111101101101101111011111110110111111111111111111111110112221020122022011112a0121111111111111111111110111111
11210221101122122222b2020220abbaaaaabbabaaaaaaaaaaaaaaaaaaaaaaaaaaaaa11101111100111111111111100101011111111221212010111121111222a1112200221011111111111101111101
10211112222022120122a10020122221011111202011111111011111111110111111a10111111111011111111111111111011111111102112222201101202122b1202101111111111111110111101111
12221212111002200210a22120212220201222211211001111111111111111011101a01111111110111111101111101011011110101111112221211002110222b1211112221111111111111111110001
11221220202210220122b22102221202201110211210111011111111111110011101a11011110111111111111110111101110100111121112012101222011220b1012022221101110111111110110111
12222221112201122020a02222221221210112020111101010111011011111111111a11111111111110111111111111101011011111022210122211210022121b1002220011111111111011111011011
21200211021222011220b02220121211022211200101111101111100111111111101a11111111111111111000111100110111111111121121111211202012112a2022111100111111101111111111110
12212110122120012020b22222222121221101110111110011100111111110011111a10011110111111011111100101111011111110221210201122212120122a2002012211111111111111111110111
22112120120212222212b20222211221200012121111110111010111111110111111a10001011110111111111110101111101011111120221211111220112012b1220202211011111111111011011100
12202121222110220000b20202222221221202221111111101011111111111111111a11111101111011011111101110111111111100202021121222000021021b2122121100111111111111110011101
12110222211212022202a22222022021221122021211111101101111110111110011a11100001101110111011111011101001110111211112212210012201010b2111102221001111111011111111111
21202222201021120201a02121222121111111111010111111111110000111111011a11001111111110111010111110011011101111111112012011021110222b1121202101111100011111111011111
21111212121120220112b10221121010110111100110111111100111110101111011a11011111111101110111010111111010111011202112202222202110221a0121211120011110111111111111111
12202121112211212121a12211110221011011011010111100121002112202221012a12221011110111010111011011110111111111021121002010212212210a1020111120101011011111111101110
11122120011121120121a10201222111111111111110111101122121021120112121a02211001202011011000111011101111111111100222201120220222121b1211111101111111011111111111101
11002212110221220111b12120110121110110111111111110122001112211222221a12220001220011111110010011111111111111112121222201112011011a0001102221101110110110111111110
21001221020200010220a00120122220111111111111011111112121120101021112a01222011011101110010011110111111101111010120201111122222121b2102021211011011111111111101110
01101002122221102221a22212112111011111001111111112222022112212010020a21101111222111111100101111110111110111020012211102122122121b2101110211111001111111100101111
22110010210001120112a21221120121100100110101111111211220221112112112a21002110021111111111111111111010111111221121022210100122222b1222202121111101111110111110111
01211022201210022110b22210010021110101111111011012212211020121212101a22221211212111111111111111011111110111212221212012122011212a1220221011011111011010001110110
11111111011111111110a11011111110101111011010111111220111211120212011b11122221102111111101111111111010111111222101012012212122211b1011200111111011110011011111111
10111110111111011111a11101111011111001111111101110112112102120101120bbbaaaaaaabaaaaaaaaaaaaaaaaaaaaaaaaaaaaaababbbababbababbbbaab0112210110111111010111111111111
10111110111011111111a0101111110111110111111111101111111102212201102222202212212101110111111111111111111011022211121110212121001121112220221011011110101011111111
11111111011111111101a1110111101111101111010110110110222112222112120121112111122101111111111111110110101111112222120011211110221010221012211100000111101110111101
11011111011111111111a1011111110111111011110111111010111122201122211112110112002111111111101111110001011111020122111121121221012111122002021011110111101111110111
11111101111111011111a1100111110111111111100010111110110001211022202111111221110110011111011111111111111011101111000021202010121111201012101111101001111101110001
11101111011111111010a1101011111111101001011110100221021001120112121021120001211101111111101110100111111110011111111111111111110111111111110011111111011011111110
10011011111011000110a1101111111110111111000111100112102200221112222110111121122211001111000111011111111110100100011111110111011111111011111011111111111111111111
01110111111111111010a1111111101101111011010011111222222101212222221022011112112111111110110111101101011011011111111111100110111111100111110111110101101011111111
11101111111111100111a1111101111111011111011000111221212201110000222222122211210111111111111110011110111110111111011011010111011111110111111111011111101110111111
00011010101011111111a1111111111110110010111011111210211112211121122011111121122211110101010011010111111111111111111110111001111111111011111011111111100110101110
11111010011111111111a1111111101111101011111111101111121210100020221111122101201101111111111110101111111111111011011111011110011111101111111111111000110011111011
01111100110111111010a1110111101111101111101011111210212221222111101111201202011110101101111111110101111011110111111101111111111010110110110111111111110110011101
01110011101101111011a1110111101011111111101110111002111222211020201222001121121211110111111111101111111111111010111111111110111111111011110010111111011111110111
11011111111100011111a1101111010111000011111101111201111001022211211121220110222211110101111110111100111111111011101111110111111111111011111111111001111111011001
10111111111011111010a1111001111011111101111111110120111222101101112100111212221211111100010110111011111111010100110111011110111111111111110001111111111010111111
11110110011111111101a0110101011111111111111011111121021121012022110010222221122211001101111001100011001111101001111111111111111111111111111111111111111111110111
11010111011111111101a1011111111100011100111111111112221200121212110110221001002111011011111101111111011010101111110111111111111111011111111111111111100111111111
11111110111111001111a1111011111111011111111111111121221111221121102220111201122011111111111111111001011101111111111111001110101110111111111111111111111011111111
11011111001111011101a1110101111111011111111110111021211102222122111221212111112210111011111111111111111111111101111111110111111101101110111111111111011011011110
11011111011111111101a1011011111100011101111010110201101022022012112221222022022111000110111010111111111110111101011111111011101111111111110111111111111011100110
11111011111110011111a1111111111110111101101011111122122001121011011020202220120211111111100011011101101101111111011111111111111111111110111111111110111111010111
11111111111111110101a1111111111101110001111111011120202022111221222022111122211010011111110101001100011100101011101110110111111101111111111111111111111111011011
11011111011111111111a1111011110110101011011111111211212001002211010111122211120011110111110111111011110111110011101110111111111110110000111111111101011111111111
01111110111101110101a1111110111111111111010111101111111111111111101011111111111011111110111011111101011101111010111101110111011111111111111111100011111111111111
11111110111111111111a1111111110111111111111101011111111111111110101110111011111111110111010111001111111111111111111111110111011111111011100111011111001111111111
01111111011111011111a0111011100111111111011011101111111111011111111111111111111101110101111111011111110011111101101111011111101111110111111011110011111111011111
00111111111011001111a111111111010111101011000111111101111111110101111111111101111100101101111111111aaaaaaaaaaaabbaabbabbabaaabaaababbbbaabbabaaaaaaaaaaaaaaaaaaa
aaaaaaaaaaaaaaaaaaaaa111011111110110011110110111011110101111011111111111111011111110111110111111111a111001011112022212021110212202211211010212111111001111111111
100111011111001010111111111111111011110111010111111111001011111110111101110111111101111100111111110a110011111010222222022121122112211121222201000101011001111001
111000011110101111111101111101111111111011110111101101111101110111111111111111111110101101110011021a111112012112122022221220022110121102202202101101101111111100
111110001101110101011111111111111111111111121001122221021120012002211212101111111111111111110110211a211121010012022112222202112102012222211011111110111011011111
101011111111011100110101111111111101101112122222221111122112221100221122111100111110111111000011212a120221112202102222222221222221102102111201111001101011111111
110001111001011111101110111111111101110110212111211101210120222221212222111111101110111111011001021b112211021122202221202111222222212212201212111110111111111011
101011001111111111111111110111110111111111121110121101222122211221112220011111011011001111111111112a022110110202222122022221212111002202210110010111111110111101
101101111111111101111111111111011111110112101111011122122222012121221101100110111011111101101111121a221210101112101020122121122220010022222111111111111110110110
011111101111101111111010111111101011111110110201210221212022120122222110111111111001111111101111221b222111211012122102222220022110211111200122111110111111111111
101110010101111110111111110111111110111111001102122220022221201102211100101011111011111101111110002b121222122220022202212202222022211001222211111111001111111100
101111010111111110111111110110111111010102121121202112201211221102022101111110011011111111111101221a222200210111201220122120122021121222220222111101111111111110
111011111011110010111110111111111111011111121102110122122201222211100022110110011111111011101011011a120221211112012212002020111211121111111221111111111001011111
101111011101110111110111010111101101100012202100102110212200022212212101111110011111111110111101120b101111011212222122222212222020212210222002010111111110110001
111111001111111111111111111101111111110110212121110122020211012101120122111110111111110110110111010b211121122112120222112222202222112211122111111111111111111111
111111111111011111011011111111111110111112212211221100222211211221221212111111111111111111011101220b012220221000222221220122222112001221120222101100101101111111
111111111111110010111111011111101111111101022101120121221212022112201110111111110111111101111111211b021122020022211122112122102120012202120222111111111111001111
011111011101110001001111111111111111011112021111221012202112200212020202111111111101111011111111221a100121112220112200212222220121120212222100111111111101001011
111111010011111011110111111111111111111112100112121111121121211021212021111010011001111111111111221b221210001220102221121110202111111211110122100100011111011111
101001111111111111111100111101111001101110020220210121222222012221211021111001111011111111111101022a022012211100020212222202022222101121202220111111110011111111
011100111110100111111011101111110111011110222022220112221111021120210120011111111011011001000101010aaaabbaabbbabbbbabbbababbbbbbababaabbbabbbaaaaaaaaaaaaaaaaaaa
1011110111111101111111111110101111101111100222011202212110022200212222001111111111110101111011112201022202102012201222212222202200112221212222100101111101011101
1100111111010110101111111111101101111111101101221122112111011202012110101100101100111101001111110222111121001202222222122012222122211220102212111000101111110110
1101101110111101111101001111101101101111111112102222210210222122122122121111111011011111111110110111121111122202022122202221111220111212121221110111010111101111
0010111111011111111aaaaaaaaaaaaaaaaaaaaaababbbaaaaaababbbabaaababaaaabbbaaaaaaaaaaaaaaaaaaaaaaaaaaabbaaabbbabbbbbbbbabbbababbbbaaabbabaabaabaaaaaaaaaaaaaaaaaaaa
0011110111111111101a11001111111100111010010222121002121222021111122111121111101110110111011111112212021220121012122222201121212122020101112102110111001011111111
1010111111101101101a01101001110111111111112201220002211112222112122121111011111111111101111111112001110212001202200021222222222222111210201222101110111111011111
0111111001101011110a11110111001111111111112012222221120211222022202210011111101111111101001111100220011022022110222210121122122222021201001121111110111111011101
1111010111010010111a11111111110011111111112221111212110201212012220011221111110101111111010111102021110222222022202122221221210122102122112021110110111011111111
1100011111111111011a10111110111101111111121222212121121121101111220120201110011001101111011110112112221111100220022222212222221222012220012111011111111111011111
0110111111110111111a10101010111001111111100112210011021120111222002212221111111111101101111101112111020221101202212220222222202222022222201110110011011111111111
0011111011011111110a11011011101111100101121110102222022101010122022221121101111111111111111101111120121120111122110011212220110110111111111111111111110111111110
1011110011001110111a10111100111111000111022222121220121121212112200211211111011111110111111111111222210201111111111211111210012111011111110101110111011101110111
0111111100111001111a11111111111101111111122210022201011220110121022212011111111111111111011110112022111211122222110220122112110111011111111010111111110111100011
