89 6
129 113
122 49
126 101
64 67
119 18
56 105
111 104
8 43
26 34

1110111010111111111011111111111011111111101101010111111111111111111011111011010010011110111010011111111111101111011101111011101110011111101110101111011101101111
1110111101111111101111101111010111011110100101110111111100011100111111011110110010101111110111100111111111111111011110101111111111101111111111011111110111111111
0111011111011011101111011111110111110111101101100111011011011010111011011111111101111101111111101111011111111111111101111111111111111111111111011100111111011010
1111011011111111111111100111110111100111110111101111011111111101111111101111100010111101100111111011111122121120202100220020110212121200111101111111111111111011
1111100011111111001111111011110001111111111111110110111111111011110101111111111001111011111110111010011112201201002112012102121212112211101000001111111110111101
1011111010111111110101110011101000111111100101011111111011111110111111110000011111011111101111111111111112202200111122212122222222010200111110001110101111111111
1011010100111010011111010101001111111111110110111110111011111111110110111111011111111111111110010011111012021222212102121211110022121021101111011111111111111111
0111101011111111100001111111011111111111111101111111110111111110111100111111111110111111110111110110110121121211222222112211101002210101100111101110110101111010
0110101111111111100110111101111111011111101111111011111111110010101111111111111101111101110001011110111112100001221021110222201022210111111111111111111101111111
1111111111111101111111111111111011010111110011111111001011111100100111111111111111111111111010111011101101022120221021122220002211110220011011011111111111111101
1110111110011111111011111111111111101111111111111111111101111101111111111010111111011011011010011111111011120210001121202212110112011110111111111101111011111101
1110011110111011111111111011001111101111011111111111101001011111111111111111000001110111101111011111110102222020222112200121101222122210011111111110111111011111
0110010101011101101110111111011111111100111111101011101011011111111111110101110011111101011011111110110002122102022122022012122002210221111011111011110111111101
01110011101110100111110011111011111111111101011111000011111aaaaaaaaaaaaaaaaaaaaaaaaaaaaaaaaaaaaaaaaaaaaaababbbaaabaababbbababaaabaababbaaaaaaaaaaaaaaaaaaaaaaaaa
11111011101111101111101101111111100101011110111101110111001a1101111111101101011111111111011111111111100112210220122201120101022101100221001111110111101111111110
10111101011011101111001110111011111111011110110111111101111a1101111111100111101110110101100111101111110112111211222121221210012202112221111111101111111011111111
01110111111111111111111010101011111111111011111011111111111a1111111011111111111111101101011111100111111020221211210202022121011212212111010001110111111000111000
11111111111111101111101110011111110111111111011111101111111a1111111111101101111101111111101110111110111111122222202101212211120021112211110111101111111011111111
11111100111110111111111101111011111011111111101100001111011a1111101110111111011111110111011111011111111111021021201110101222212102001121111111111111111111011111
11111111101212002100122110110221201212012211011111101011111a1111111110010111111011101011111111111011111101021212110202010122110112112221111111101111101111111111
10111110111212202121021122102211110210012110111111110111111a0111111111011111111111111101011111101101101101122222112121112111121122110221100111100110111011111110
11111111111021112122120222221211211110121111100111111111110a1110111101111111110011111010111111111110101101012022112012202211122212120201111110111111101111110011
10111101110221012122121112202001101022001011111110111111101a1011111111111101111111111111110111111110111011111121021221222211021222221110111111111111111110111101
00110111011121121010122021002122012221201001111100111110101a1110000001111011111011111110101100111111110122222120200222211201111010111111111111011101111111011110
01011110111120110111201011201221112012211211111011111111111a1111100111101111111111011101111110101111011110121201000122022011122221211011111111111111111111110110
11101111011222112122222111122112012112211101110111111111011a0111111011110111110001111111011111111111111101210012122120222212212212111200111110110111111101011111
10111010111101221122020121121201101122101111101011110011011a1101111101111111011101111111111010101111111011001220011201011100021010211211111111111111111111111101
01011101011222022000111002001120111011102110111111111111011a0111111011111111111101110101110110110111110110022210021012222200111210012121111111010010011101101110
11120102212222200000212122202020202200021011011111101111111a0110111101001110100111110111111011111111111122011221121211210121202011100010010111101101110111110110
22221112101220202022222202221222122121211010111111011101101a1010110101111110110111110011111101111111011122200001101221221212201211000111010110011111111111111111
22111122110222101210222222020200212102121111111111110111111a1101111111111111110000111011101011111111110121011222121111221111122102102221111111111010111101111111
21121222011111222122221001220121221121012101110101011111111a0101111101110101011111111011111111111111111102212110121121211210122122102111111111111111111011111011
12221021102212102212211221200120122201211111110111111110101a1111111111111111011111111101110111110111111121222212122212010211211121121121111111111001111111110111
00022211112120220020202222222222222121220111111011111010110aaaaaaaaaaaaaaaaaaaaaaaaaaaaaaaaaaaaaaaaaaaaabbbaaabbbbbbabaabbbaaaabbbabbbaaaaaaaaaaaaaaaaaaaaaaaaaa
1222221000122102221202021112220221111012221111110111011110111111110111111011111111111101111111111111111110101012221120112100112121112200221111011011111111111111
1120021211222211222210100202202222122212221111111110110111011111111111110110111111101101111111111111111111121120000222120210201010202220110011101101001111111101
1220012100010220021022112222221221011120111110111100101101011111111111001111111111111010101111111111011111112101201111111221012120012121011101111101111101110011
1001111112222222022022201222222201012122221111111111111111111100111111110011101101011111101111111111111111120101011221022020120212112200210111111110110001111111
0112212210122112002222222122200210211202201111111111001011111111111011110111111111110100111010111001111101112202211102122210012222021021221111111100111010111111
0222211212022212222022211101212011211220121101111111101110010111010111110111011110100111101111111111011111122012122121121222012122202111121111111111110111111111
1121001112201022212120122222221221222212121111010100111111010111111111001101101111011111111111001111011111111112011112212211112121201220101111101101111010011011
0212111212202122222202221222212111220201121111111110111111111110101111111111011101111011111101101011111111122211220210202222222202222202211110111111111011110111
2111112212000221122212222122110111122012121111111011111110111010110101010111101111101101111111111110111111101201222222212200120121201121201101111111111111110111
1211112221210202222022221220202202022112111111100011101111111111101111000101011111111011111111011110111111111102021112111021122001122101211011111011111111111111
2001220122220121202012211020122212201101010011110111111111111110110101100101111111111111010111111010111110122111102220101222100222211012211101111110110011110111
0201212202021212122122222201220210112221211111111101111111101101111100001101111111101111111011111101110011112021202112211220120210022221011111111110101101101011
1102101012222112222220120220220121012211211111110111001111110111011110001010101111001111111111111111011111110120011222122221101112112222121111111111111110111111
0122020221012002212211020222102120212122220111111111111011111111111110111111101111111110110111011101111111102021202020122102202121202022221111111100111011101111
aaabbaabaaaabbbbabaabbabaabbbbbabbaaaabbaaaaaaaaaaaaaaaaaaaaaaaaaaaaaaaaaaaaaaaaaaaaaaaaaaaaaaaaaaaaaaaaaaaabbaaabbbaaaababbbabaaabbbabbbaaaaaaaaaaaaaaaaaaaaaaa
1122212221121221222222202201020110220122210011111011111111101110111110111111111100010101111101111111010011112111111201221222210002201101221001111111111111111111
abbaaabbabbbababaaaab1100101110011111111111011111111111101011111111011000111111111111011111110111111111111102220200222122210111212211122011111111010011111110011
11121220210110212122a1211211102100101111101111011101111110111110111111111111100111100111111111111110111011122212200112202022012220210220021111111111111111111110
02112222222221011101b1122221221111110111110111110212122022112211211102121202112111101101111110100111111111021222101221211220102122212212121001101001101111100111
01202021112121111211a2211211101101101111110111111202210222121211202220121222221211100111110111111101110111110122210112120211111121212022121111111111110011111111
11122201211122112122b0021110101111101111111111101200120122022221001112111101222110101110111111111111111111121101012021221110111121111022211101111101111111110100
02112022200122011201b1202122222111111011111111010222221212212020022201122221100211101101011111110111111111101022102022122211121012201221201111110110001111111010
10022222220212112011b1102022112111011111001111101201220211012221222100120222212211111101110101111001101101112211222022112211222222012212220101101110111111111111
01111121012011222222b1201111112110111101111111111210110121211212110011212222112111111110111111111111111110111010012121201211201220002221121011011101111111101111
22122210200201012112a1122020021011111111110110011122212101122202210012012021202111111111111011111111110011012121122211111012222112120011111101111011001101100100
11111111111111011110a0111110111110110110110111101112102212112221211021221002211010111111111111110111111101111200111111212121222201210121101101111111100011010010
01110111111011101101a1111110111110101111101111011201112211212211011111221101210211101111011101111111011000101120221112121202222120212220221011111011110011010111
11111111010111111111a1100111010111111101111111111100221221221121120221202212121101111110110111111111111101121221222220102001211121212211211111101111101110111111
11111111111111111111a1111101101111011111111111101011111221122100222111121122111211101111111011111011110110112222122111222001220102122021111011010011100010111111
11111111111111011111a1110111111111111110111101011212022122022012101112121122022211111111111111101110001111111221112211122221212122012201210111111110011111111110
11111010111110100111a1101101111111111111110111001012212110100211212212111122121110101011111111011011110011112212211121221212112120201020211101111111111111111101
11111111101111101101a1111101011000111111111110110221222112210120011020221212220111111101111111101100111111111101101111111011111001111001111111011011111111101111
11111111111111001111a1001101011101011111110101101112022220012112122222110122001101111110111111111111111001111111101111011111110111111111101111101011101110111101
11011111011111111011a1010110111011011100011100110110001122210121001111212202221210110111111111111110111111110111011111010110101101011101111110111111111010101111
11111100111111111111a1111101001111111011001111111121101010212222021210102121112211111111011110111101111111111111111111011111111100101101011101101101110111111111
11111111111111111011a1111111111111011101111011100112122022111101200122021112202111111111001110111111110100111111111111111110111011101110001111011011001011111111
10111111110101011111aaaaaaaaaaaaaaaaaaaaaaaaaaaaaaabbbbabaaabbababbabaababaababaaaaaaaaaaaaaaaaaaaaaaaaaaaaaaaaaaaaaaaaaaaaaaaaaaaaaaaaaaaaaaaaaaaaaaaaaaaaaaaaa
1110100110011101011100111101111111111001101101110221212122212222222010102111102110111011111111111111011101010100111001001011111110101111101111101101111101111111
1111010111001111111111011010111111111111110111111112210010020011012012102120221210010111111011111101011111011011111111111111111010101111111101111111111111111011
1110101100111111011111111110111110110111011011101121112111022210000100120101212111100111101101110111011101111111101100101110101101110011011100111111111111011110
1111111111110111101111111111101111101111101011111111121111011222211021221212102011001101111011111111101111011111011111111111111101011110001111111010110111111111
1101100111101011110110110111101101110111111111101221222100012111111012111101101001111110011011110111101101011111111011110111111111011111110101111110111111001001
1011111111111110111111111110001111111011101111011110020220121222121122020221121011101011111101101111010011011011111111111111101111011111111111101101111101011111
1111011111111110110111100011011111011111111110111121122112010100020022201120120210111110001000010111111110111101011110111011111111111111111101110101111110111111
1111111111110111110110111111110110111100011111111110011011212101212211122201212000111101111011111111111101100011001111111111101111011011110111111011111111111101
1111000111011110110111111111110111010111110111011222012121112012121022120122122211110111111111011110111110111111111101111111111101100011111011011110111111110101
1111111111111111110111101111110011110111110111111202212111021210112022011212102101111110101101101101011111111111111011011111100011111111110111110111010011111111
1111111111111101111111111111110011111101111111010112112021111021121202212011122211011111011110011111111110111111001111111011110001111111111111101111111111011101
1100111011111101101111111111111101110110111111101222212220112101111102222202211111001111000010011101111111111111011111111111100111110101110111001111111111111111
1100111111111101111111111111111111011111111011111111111101101111111011111111101100011111111110110111111101111111010101111011111101011111010001101111111110100111
1111101101111111111101111111111110111111101111111111111111111001101111111001111111111111111111011101101111111110111111010111010101111011101111111101111101111010
1101110001001100111111101111111111110111111111111011011011111111111111110101110011110110111111110111011111111011111011101101111100101101010101111011111011110011
1000110111111110011101111111111111111111011001111100111001110011011101001101110111111111111100111111110111011100012111122112012212110001112110111011011101111011
1111111111111111011111110111111111100110101111110111111111000111110010111111110111111111111110111111111101111111102102122101021112121111122200011111111010111111
0110110111101011111101111111111110111111110011111011111111111111101100110111101111011111001110111111111011100112010220112012121121122221212122010111010011111000
0011110101111011110111111100011110111111101010111111011111111000101111011101011100111011111111012101220112120112222000212120222212101222112211111110111110111111
1101111111010110111011101101111101011110111210022111220020212222122111021101101111111111111111112102210122220120212121201212222210201112222210111111111111101111
1111111111011110110111011011101111111010121220121120010112122202110202121111111011011111110011011121101221111112020222002210022212020102221222111111111111111101
1011111101111001011101101110111101011011111110212011112222122012211221011111001111111111101110111002110222211022222122121200101221211121101111011111011111101111
1011011111111111111111111111110011101101111101221212122111012111011212110111001111111111111110112022110202111120211221022102122110121120111011011111111111100101
1111101101111111101111111111111111111111002222021002000110220011211122111110011101011111111111111221210102221121222022221010222221022212111221001111111111111011
1111101111110110111111101111011110011111121012000111211101222122211121201111111111011101011111110222111001110202220021202212202120220102002121111111101011111111
1111001111011111110111011101111101111111122012112221112011012112221212121101001aaaaaaaaaaaaaaaaaabaabbbbbbaaabbbbbbbbbbbbaabbbbabbabaabaaabbaaaaaaaaaaaaaaaaaaaa
0111111011111011111111010111111011111111120220211212121201211020122200111111111a10111111011111012110121102102111221201202202222110102001112202111111011110101111
0111011111101111111011000011111111111111120021112121112210110211002022201011111a00011111111111102112221022010221222220212222220220111222202120111111011110111111
1010111101111111111111010111111111010001122021111212212110022101121221110111111a11101111111011110121201020012212222120202222210202011102010112111111001111111011
0111111111101111110111011111111111110001011221222011010102122121222210021110111a11111111101101012222111220210010102222222202012000001212211220011011011111111111
0111111111010101111101111111111111111111112120011021122102112112020121011111111a11011111111111111011010201101112222221122222122011002112111111111111010111111110
1111111111111111101111011111011010110111111211001212211122200211210112220111111a11111111111101111111212211022212101211120222202201222111010211111101111011110111
1111111001111111111111111111010111111110120210112201021122212021121222001111111a11111111111111110012121122112212122012222022222202212000122201111101110111110111
1110010011110011011111111111101001000111121212222112022211002122112102120111110a11111111111010112102111212222102202221120221202021210221211212110111011111101011
1111111011111111111110111110101111001110121112122222201120221220121011221111111a11101111101100000211201012121222222222222110222211112222102112101010110111111110
1011111110111101111110110011111110110110020201012111221220211011210212021111110a11101011111111112010002012212102012112220012020211212021121012011111101111111111
1111011111111111111110111111111111111101121012000122121011222002101121111111001a11111111111111102100210111222112002122122110212111102101222010111100111111111111
1101110111011111101111001111101111100111122111222211112222201221212202021111101a11011111111111112012120212001121122122020202012210022100111120110011100010101111
0110011111011111111111101111100111111111022211222202211101122112121101201101011a11111101010111111221200221120211002210202210222102212202210021101011101111111110
1010101111110111111101111111110111111111101022110222220111212121011122221111001a01101011000101111121202111221101222212202202121121111001122121111010001111111110
0111101101011110110111111110111110100111122211022011011212111122221211011111111a11111011110101111211111022121122020022222212202102111012220222111011111111110011
1110111111111111111101111101101111111111111202212210102201000211111110111011111a11010111110111111112122211221112211210012222221202212221101120110001111111111111
1111111111111011111101111111111011111111102221111112210222200212101122210111111a11111111010110111111021201011202222121021212222022122120121220111111001100111111
0111111111111111011111111111011110111111112022220212022112112010012111121111101a11111111110111112120100022112212121101211222001202110222121101000111011101101111
1110011001111011111110111111111111111111122112221101211202122221210222111101011a11101110100111102201201212020020222222022222012121121012221111110111111101111100
0111111111011111001111011110111101111110111122011012022220202110202221001111111a11111111111011111211102122222210212202122222222011220222212111101111111111111110
1111011111101110111111111110011110111011121011221211222220121212020121221111110a11110100010111110211110022110111212012102122122110111110000101111111110011111111
1111011111111111010111111111111111011011110112022002120012111102011220121111111a11011111110101111222102101221221222020221121120111111001011110111101111111011111
0101011111010010111111101111011111111011112111122211021112121001021121111111110a11111111111111110122000110220212221112111111221111111111111101101110101111111011
