101 110
139 3
122 49
126 101
64 67
119 18
56 105
111 104
8 43
26 34

0111011111111111011111111111101011101101111110101111110011111111111111111111110111011111111011101111111101011101111011101111110101011111111111111111011111011101
0111111111011111101111111111111111101111101110111011111111111011101111111001011111110111111110111111110011111111111111101111111101111001111111011100110111111111
1100111001011111100110011111111110011111111001111111101111110111110111001111011011111111111111111011111011111111110111110100101101111111101101110101111111111111
1111011111111111111101010111110111111110111111111111100111111110110111111111111110101110111111111100111121121202210211112012121011122011100111011111111101011111
111111111110011111111111010111001111111101111111010010001111111101010110111111111111111111111111111aaaaabbbbbbaababbbbbabaabaaabbbabaabaaaaaaaaaaaaaaaaaaaaaaaaa
111111101111111110011101111111110111111100110111101111111101111111111111001110111111111111101101111a111121021012212002101200210122011211101111111111110111101111
111111111111111111101111011111111111111101101111111111111111111111111100111111100111111011111111001a111001212121221222111112021122212001111101111111110111111111
010011111111110111111110111011001111001111101110111111111011111011111111111100111111111011111111011a110012111010100011111201022110120111110111111111011111011111
101011101110111111111111111101111011010110111001111101101111111111001101101100111101111011010111111a111012120122212122221202222110010211110110111011011011101111
111111011111111111111111111101110111111100111101011110111101110011111111111110110111111111001101111a111120102111122202110222202002110211111111110111111111111011
101011011111111111101110011101010101110111111111110001101010111111111111000110111101111111011011111a111112211121101212222001210120120021111111111111111011011111
111111111011111101101111101110111011101111111101111111110101111111101111101111111111111111111110110a111112011001002012002212101112002211101010111111000101101001
011111111011110111111111111111100111110010011111111111111011111111010011111111100101111011110110111a011101011212222112021112000221212011100111111101111111111100
101111111111111011111111111111010110011111011110110111111101111111111111100011111111111111011010111a111110122122110111222211210111121111101011111111111111110011
101111111101111110011011111111111111001110011111101111011111010111111111101111101111111110101111010a111121112122212121220210202120002111101110110101101110111110
111111111111011101111010111111111111111111001111111001100111111111101101101110111111011111111111101a110100012210111012001122122100212110111111011111110111111111
111110011111101111111100111111111101111111011111101110111111111010011101111111111111101011100101011a011111121210222212220202212210122101111111111111101111111111
101111111101101110111111111111110101110111111111111011111111011001111011101111110011111111111111011a0101011021101221022ababbbaababaaaabaaaaaaaaaaaaaaaaaaaaaaaaa
111001111011111101101111111101001110101111011111011011111111011101111111110111111010111010111101111a1111120201022101120a1022221121221120110111111111001111111101
111110111002022222011222212002200212122222111100111110111111111011111111111111110001011111101111011a1111211102200001202b00001102211011111111111111aaaaaaaaaaaaaa
111101111111222112111212012001210122022110111111100111111111111111101001111111101101111110111010111a1111211101020102122a11212120121222110110111011a1111011111111
111111101000112122102201120201111221222221111101111101111111111111001111111110110111111111011011100a0111120112212121011a21012111022210211100111101a1101011111111
100011101110102212111201112101111122212122110111110010100111110011101111101111001101111011110111111a1111211121111010122b10011102212221211110111011a1111111010111
011011111102110112002001120222211201011211011111101110111111101101011111111111111111111111111101111a0111210221111122202b01210102022102111101111111a1111110100011
1111110101102111100222012021120111122111111111011110111111011011111110111111111aaaaaaaaaaaaaaaaaaaaa1100002112111002200b22222222221122010010111101a1011011111111
1111101111122202110011212111021021212211221111011111111111110111111101111111111a011111011111001110100110221201111212202a12221211221021001111111111a1111111011101
1010101111110111011202211122102112001211210110111001111111101111101111110011111a111111111111111101111111021202011220101b11221121121222101111111111a1110011110111
1111111101122201222212222222102221120120121011111110011111111011001111111011101a111111111111110110110111101211221122211b12210021221112111111001000a1110111010111
2100012221022210221211011120201121202221220010111111111111101101111111110011101a111101011101111010111111121221221221222b20110122100111101101111111a1101011010001
1220211212021212222120122122122221222222121111011111111010101111111111111111111a101110111111001101111111210201111200221b01010121212121111101111111a1011110110111
1210112102122212210022221022112112111200101001111111111101111111011110111111111a111101111111111111011101221101222112211a22102210002221211111111110a1111111111011
2112221220221222200120010222122121022211121111111011101111110111101011101011110a111000111110111011111110121211201121211a11221121111120111101001111a1000111010110
0112112222221222002122211222100212002012221111000010111111111111111111111110111a111101111111111110111111202122120101111a12121210220121011001111111a0111110010111
0212112212102102221022212210212212011012121101111110011101111111111001111111100a001110111011111111111111102122112112201a00112111121102111011001111a1111110011111
0222102221112120100021210202202022111220221111011110111010111100111111111111111a111111110111111010011111111201100011201a00122210200222121101111011a0111111101111
1222022201221221221222100220220121200202001111001111111101101110101011001110111a111101111111101111111111101111201211101a22122111121110201211111101a1111110111110
2122001202122221202212021201222121111221221111111011111111110011110100101111111a011110111110010001110111111101212110212a12222221121212112111001101a1111111000111
0221221120212022212222220202210111022002010111011111100110111111111011011101101a001111111111111111011111110102222122021b10011102121121212201011011a1111111011101
1200222012202222122220222021202120122112011011110011110111111111101111111100110a011111111111011101011111110101121202202b02221110011110111211111101a1111110011110
1001122122221222122102022202022220222022021111011101110111111111111111011111110a111111101101111111111011111211211202012b20012212200021121211011011a1110101101101
0120010212222122112222222120121201012221111111001111111101101011011110111111001a010001101111111011111110100120122221122b10001021121211112101111111a0111111111111
1102211110012201112122122222221110012202211011111111100001100101111111011111111a011110011100110111111111111111221012100b12110101110222222111111111a1111101111111
1020222121021212202221222002022122112221220110111011111110111011110010110111111a111110111111110100011001111221122222210b21012112011122202211011110a1010111111101
ababbabbababababbbbbb2112222222111212212111111011111010111111111110111100111101a111111110100111011111101111111112202212a21110022200212211211111100a1111010111001
01110121211202222210b00201102220221211122111010111111110111aaaaaaaaaaaaaaaaaaaaa001111011101011010000111111121211122112b22112200122021022211111111a1111101110101
22012201200221000212b12002222021022122222111110111110111111a11011111011110011011011011110001011111111011111022121202010a02011211112122220111111111a1101101011110
01121221110000121222a22020120120200202000211011101111110111a11100110110010111011111101111111110111110001100221101121202a12202002020220111110111111a1111011110011
12222121120222202212b11220220122111121111201111110111011001a11110111011111111011010110111011111011110001111111211121111a12120212221121122110101111a1011101011111
21022021212201220202a22122022222102012212211111111110111101a11111110011110111110101111001111111111101111111021201121120b21100102101022222210101101a1010011110111
02111111222002212202a02021222222021201001111111111110010011a11000111111111111111101001110000111010101111101111212221221a01221121110211012201011101a1100111101111
12221201121211201012b22212221211011111011110111011100100001a11111111110111111010111011101111111101111111111220122002002a21212112212221211111111111a1101111110111
20112122002200211222b10202112111111111100111011101111111111a10111110111101111001111011101111111011111011011111121111012a21222102201022111211101101a1101001111011
10021022110212122211b21212201110111011101011111112220011202a01210112112211200222111010111111101101100101011122021111020a12121221122111110211111111a1110111100111
22100021121222021012b21211221201111101111111111110202121211a11011210121012021201011111111111111111111111011022212122121b21112121112122112211001100a1111111011111
22111110221121102222b01112021211011110110011111102102210022a21011100201201110011111111010111110111111110011121222122221b11221121221002112211111011a1111111111010
10212101221221110122a11121212021111111100111111111122121221b02021121100102222212111011111111011011110011011011121111110b00102022121212111111111011a0101111111111
02011222211121211201b20111212021111111111110111110221112222b12112122221220210010111101111101111101111111100122111211210a11000201102202111201100111a1101001101111
11121010222222212202a12202001120111111110011111010111110201a21002112201122202200101110111111110111111011111222121222022b22222021011110000111110110a1110100011101
10021012201212221211a11100121111111111001110111102210210222a01121222112120020021111111110111101101111111110212111210200b02112221200210021001101111a1111110011101
11110011111101111110a10111011011111111101010111112002000022b20220022021221022112010110011111101111011111111221221221112a21111101221122112100111101a1011111111101
11011111111011111111a11111110001111111111111011102112121121b12221101111111101111111101110110111111111111101011221102112b10122222111111111210111111a1101111010111
11010101101111111110a10111111111111110111101101111120112011a11221100112121021001111111110110111111111111110201110100112a12122210221120120210011101a1111101100111
00111101111111111111a11101111111110011111111111102220102012b20102121211012220022111100011111110111111110111011212212211b21111211110211122111111111a0111101101110
11111111111110111011aaaaaaaaaaaaaaaaaaaaa111101111011011122b22110210121021200202111111010111001101011111101101121110211b22220222020121022011101111a0111010010111
1101011110111111011101111111111011101111a011111110221022020a01122112012202020201011111111101111111111111111210212212201a10210111220210222111111111a1101101110111
1110111111111011111111001011101111111101a111011110110101101b12111222101210111021101111011111111101101101101110111111011a10111111111010111111101111a0111101101111
0110111010110011101111101111111111111111a111111010021210011b10111222201222022012011110101011111111001111111100110001101a11011111111110110111111111a1101001111110
0101111111111111111110011111101111111111a011111111202222111a01202122012102122221110011100111111111111011111101111101111a01111101011111111111110111a1111111111111
0111110101010001111110101111110111101111a111111111012222202a21021011011222021002111111011111111111011101111111111111001a11101111111111101111111110a1111011111011
1111011110111101110111111110111111011111a111111012220212120a01221122112112221122111110101110001111110111101011110100111a10111110111111011110101111a1111111111110
1111111111011111111110101101011111101101a000111111012020112b22221122122112111022011011111101111011000010111111110111111a01110011011110111110111111a1111101101110
1101110101101011001011101010101101100100a111111100210200020b12121122110111221021011111011101110110011111101111110111111a11111111110111101101111111a1111011011111
1001111111111010111011000111011111110101a101111102122201112a22210221121211021021111110011111111111010111111111110100101a10011111111111111111111110a1111000000011
1101110111110111111111101111101111101101a111111102221001112a12012002101001111111011111111111111111101111101110111111110a11111111111110110111101101a1111101110111
1011111111011111111111011111111111111111a011010101220012112a01121212122011112012111111011110111111111111111011111111101a11111111111101111110111111a0111111111111
1110101111111101000111111110101110100101a111011110002111211a12022111222222011222010011111111100111111011110111101111111a11110111111100011111101010a1110111011111
1101111101110101110111111111010101001111a110111102221111101a20021020220201211211101111111111111111110100110111111111111a11111111111011011111010111a1111011010111
1110101111101111111111011111111100010111a111101111221212101b12011121221022212022111101011111111111011111101111011101111a10111111111110001111111110a1011111010111
1101111101101110111110111111111111101011a101111112111112211a00122112220220221222101110010111101111110100101110111110111a11111101110111101111111011a1111111111110
1111110111000110111110101111111111011011a110111101211011111b21110222111010020111010101101011011111110101111111111010110a111111aaaaaaaaaaaaaaaaaaaaa1111101101111
1010011011111001110111111111101101111011a110111011021001000b12110002221111201212110111111110110111111111111110110111111a111101a101110111111111101111011001111000
1111110101111111110011110011101111111110a101011111102102122a20100122211221111211111001110111101111111111100011011011111a111101a010110011101111111111001010101101
1111010111111110111111110111110111110101a111111112210120222a11101210011222220121111111110111011111011110111101101110111a110111a101111101111011111101101111111111
aaaaaaaaaaaaaaaaaaaaaaaaaaaaaaaaaaaaaaaaa111101011111011101a10111101111011111101011111110111111111111111111100101111111a111111a111011111111101111111000101011100
11110011111111011101110001111111011111011111101010111111110a11110101110011101111111101011111110111100111110110101111110a111011a101110110111111101010011111111111
11011111100111111111011101111111111011111111110111111111111a11111111111101110110111101111111111101110101111101110110000a111110a101111111101111011111111000110111
11101011111111111011111111111111111111111101011111101101110a10111111110111011111111111101111101111101111011010111111202b201122b011011222220121111111011111001111
00111111111011111011111111000111011110101111111111110111110a11111111111111011110111011111111011011110111001111112101202b122220a122221010222112110111111111111111
10111010101101111101111110111111010110111110101101011111110a11010111111011111111111011010101111101111001111111022112021a101122a111020211201221011011111101111110
01110011111111111110111111110111101111110110111111011011111a01011101010011011111101011001011101102100211120122122222220a222202b211112221212201110111111111111111
01011111111111011011111011110111111011110122121202112210221b00211122211110111101011100111101001020110112111000121120221b211012a011012022001011010111101111101101
00011111111110011111111110101111111100010200021111220021111a12112211211111101111111111100111111101011111111020122120222b202121b121012121212100111111111011111011
11101111101101111111100111111011111011010112202222022221101b21121222112111111011110111011110011111121122101022111122121b222222b001121202022221111111111111011111
11111010111101111111100111111111111111011021112201221101122a20202202222211101111110101110101101011111212221222122011202b011212b022122102121201100111101110101111
11111110111110110011101100011110111101110221211110102221211a10221021110111111111001100110101111021111212011210222022212b222022b212112220112200111111111111111111
01111011011011111111111111101111111011111122122020220222212a11201110022111111001110100111111111122112221221111012222222b210200b220211022212221111111111111111101
11101101111111011110011110111111111101110101120000220122212a20202121010211111111111011111011110110112220122121122222200b221222b011012220222222110011111110111111
11101010111111111111111011111100100111011011222110222212121a01221022020210111100111111111101101112112112100010122222011a222212b211111220222211110011111101111111
10111111010110111110111011101111111011111222022121110111102a02112112121111111111111110111111110101212120221001002122121b122222b110122020202100111111111111111111
11111001101111111111111110111110001110111101121122222021112b12110112221011110111011111111101111112010201011210120202122b202200a112121211211201101111110111111011
11101111101111011111111111101111111101111120022120021222222b10211211221111111101111111111011111121121010221221222222210b221201a201212222002002111011011110100111
11110110100110111010110000111111111111111112220121100112222a22122120201211111011111111000111111011110201120021122222220b222021a202221211011021111111111111111100
01101010111111111111011101111011111100111101221021212222222b10021022212211111111111101110101101112111001221111220022221b202122a111102011212220111101111001111011
11111011101111110011111110011001111101111121212022212022121b02122221101010111111101111111111110122020111212110221200222b222210b112202222221112011111011111010111
11111001011111100001011111111111111111110112112211222021001a21221022201211111111111111111111111122220101111102202202201b122102b111112212210020011111100111011111
11111011100110111101111100101111111111011202012222012221210a12010110110210111111111101111010111120211012111110220122202b221121b101020110222112110111111101111111
11110111111111111111111111111111111110111022212212122212211a22221112221201110111111111111101011011220212101110212210222b212222b211102221211222111011101111010111
11111111011100111111111011111111110110101112220112222022122b11222210221111110111111111111101110001122122212111212221202a221020a021210202121121111111111111101111
01110111011111011111111011010111111111100210222100220012202b21212112121011111111111111110111111122221212122222222211222b022210b222202120211002110111111011111101
11111110111111011111111111101110111100101022122221201222211b21022121222101111111010111011101011121222122102111122211221b211102a121112112122202110001110111101011
01010101110111111111011011111111111110110201110022010112212a11120021121211111110111110011110110121122121122112021202222b211212b011211011021112110111010111111110
11010100100110110111011101011010110111111220111111222121111b11212110222111011111110110110111101111212220211201222222222b222222a222211201210112110011011111101111
11111111101000110111111111111111111111111221122202121211012b20202222122111111010111111001111111110221112210120220210222b200220b212201100211211111111111111111101
01111110011011101111111110111110111111110221011202202111122b02001221201110010111111111111111110100021001122211212211221b221212b212110221011101111110110111111110
10011011111110011001111111111111111111111121021102012121210b11122110002111011111111111111111110021201220112102022222102b101222b011022120221222101111001111011111
11111011101110110100110101110111111110111201222012021101201a22121112111211110111100110111110111121021111120222220212022b122221b211220020012201111111111111111011
01110110101101111111101101111110110011011002212222122012212a20121112212210111101111001110111111121202122211101121122212b220222b221222102221022111111111111111111
10111111101101001101111111111010111110110122021121221211120b01022121110011011111111101101100111122001111012221201111101a122212b100101111111111111101110110010111
10010111101111111111011110100111111110011112201112222120101a20122110221111111111111100110111111101122201111112212210122a211211a111111111111101111111110111111111
11111111111111001111111111111110111000101111020111222122200a22202021211111111100011111110111111101012111211110012112121a220122a111011101111111011011101101111100
