142 45
17 105
122 49
126 101
64 67
119 18
56 105
111 104
8 43
26 34

1101a111111111111111111111001a11111111111111a1101011111111111001001111111000111011111010111111111111101101111011111110111011111100111101010111011111111100111111
0011a101011111111111110011111a11111001111101a1001111111001110111011111111010100111111111111111001111011101111111011101111110111111110101100111111110111111101111
1111a011110111101100111111111a11110011100111a1111111101111101111111011111011111111110111111011111111100011111101111111111111100111011111011001111111111101111110
1111a110111101111000111111101a11111101010111a1111110101101111110111111111111101111111111111011111111111111011211202102012220011102022121111111111111111111100110
0011a111111001111101111111111a11011000111110a1001001111000111111111111110110111111111111110110111111110102121211022111122011211221001020100111111111001011111111
1011a111011111111111101101011a11010110101101a1101001110111101110111111111111110111011111111111111111111121211220220120111121101202011021111011111111111111111111
0111a111111110111111000111101a11111111110111a1100111100111111001101111110111111011001011110100111101111111011111221111121111201112121221110001111111111111111111
1011a111001101111111111000111a11101111111111a1011111101111011011011010001111110101110111111111111111100100212202202110102111201211020001001111111111011110111110
1111a111011111111111111111111a01111101111011a1111111011111011110111111101111111111111111111101110111101111111010021222212222211122110221111111001100111010101111
1110a111111111011110110101111a01110111111110a0111011111011111111110111101110111111101011011111111111010002221222012110111211122002220101010011111111111111111111
0111a111111111001111111111100a01111111101011a1111111010111111011111101111011111111101111110110110111111121010102022111201121222101121000111111111110011111111111
1110a101111111111101110011111a11001111100101a1101011111011111111101101111011101110111111111111011111010112122211221122200221222221112100110101111110011111111111
1010a111111111111111111111111a11101111111111a1111111111111001001111110110011110101111111111111000001101112122110020012110222111020022211011111001111111001111111
1011a111111111011111111111110a11111101110110a1111111111011111111111110101111101111111111111111001011111002212222110111212212221012000201011111111111111111111111
0111a011111111111110111111111a01110111001111a1010111011111111111101101111110011110110111111111111111010102111011212222102122122200121111111110101111101111111111
0100a111111111010011111111111a11110111101111a1111111111011101011111011101111101101001011111111111111011100122111120112121212001112011101101010110111101101111110
1101a111111111111111011111011a11111011111111a1011111111111111111011110110111111010111111111111111100011111201202210202211102112102122110111111111011110111111111
1111a101011011111111110110111a11111011111111a1101111010111111101011110111011110111110111101111110011101121202111021221212112212212211110110111111111110011111111
1011a111111001111111111111111a11111111111111a1111011111111111011110111101111101111011111101111111110111012121201011022112202111111211221111111101011111110101011
1111a110110202021022121102111b22212121121111a1011111111111110111011111110111111111111111111101111011011111002221babaabbbbababbbabbbaaaaaaaaaaaaaaaaaaaaaaaaaaaaa
1110a110111200022201120201002a00210110221111a1111111111101000111110101111111110011101111101111000111011112111220b21200222220012111022211111001111111111111111111
1111a001101211122122021211201a01011011220210a1111111111110111101111100111111111111001101111101111110111022211121a21120111111200122120010111111111111111111111111
1111a111101201022122112202222a22111101122011a0101111111111011110111101011111111010011110011011011111111100122211a20211121112200111221211101011101001111111101010
1111a111110212002101122112022b11221222202211a1111111111001111011110111111101111011111111111111111100111012022111a02101212221211202112101111111111111111001111111
1111a111111012012222221221012a22122001202110a1101111111101111111010111011011011010111101101111111011111022002022a21121102212112121222211111111101111011001101111
0111a101111001221221201201211a20122201022111a1111110101011111111101111111001011111110111111111111011111011021002a02120022211202021100221111110111111111101111011
1111a101110101111102111121012a12202100101211a1110111111110110111101111111111111111111110011111100011011112000011a11111011110100111222020111111111100111011111111
1101a110110121220211002111121a11120021111211a1111111111100101101101111111101001111111110111110111111111112121022b10100210212222202121201110011101111111101111010
1111a222202202120220022222022b22110102112111a1111111111101010011111111110100111111101110111111111111110101011202a21011111211211121121010001111110111110111101011
2021b222201012212222201222202b01202122211211a1011100111110010111101100011101110111111111111111111101111111222211a12111012212021110222011111111110111111101111111
1112b012012222222202222221201b21202010121010a1111010010111000110111111111111101101011111110101110111111111021121b12211111001120102201221011110111111111111111111
0021b222112120220220221212002b22221122110211a1000110111111100101111101110111111111111110011111110111111102221001a22112222101221102221201111111101111110110111111
2211b211122222201222222022022a12022112111011a0111011110110011111101111101101111111110110010111011011111120222111a02012221121101222022101110111101001111101110101
2222a022122210222222222222222a12112110021211a1110001101000111111111111011101001111110111111111111011111121021112b10212110201212201221201111111111011111011110101
2222a022122022020222111002000b12121112221210a0010111111111111111100100101111110110010011110110110111110111112211a22011122121211022221222211111111111000111111111
2100b210022022112212122111222b21020110012111a1011111011001111111110110010111111110111111111111110110111111120021b00221110011020212112112101011101111110111101011
1112b212100021222221210202202b22120212102011a1110111110111101101110111001111111111111011111110111011111111112112a21222211021221210100121201101101110111101111110
1210a220202022122200210121122b20220212101001a1111111101111111101111111110110110111110101111111001111110111101122b20201102222221200121110221011111111111111111111
2220a211210212222212220122211b11211120122010a0111110110111010111111111011110111011101111001101011011111111121211a01022212122110220111222121111111101111011111011
1222b111121111022012201221212b20221222112111a1011111111011111111111110111111101111101110111101111101111111122112a22100221100211011021001120111111100100111111111
1220b122111222212202122222012a22221102222211aaaaaaaaaaaaaaaaaaaaa10011111110111011110101011111101011111101022222a02122210221112210111210121101111110111110111111
1111a212220202222022212102212b2111122000101101011110001111111110a01101111111111111111011111111111101001111010210b11100201212010110111201201111111110110111111111
2021b102221212120121001201022a2111221221211110111111111110111111a11111110101101101111011111111011111111001122000a12120121122211202122020221111111101001111100111
2210a221002122220222121222221b2112122202021111101111111111101111a11001111111111011110100111111111100110110101012a12122112211220122122011201110111111111110110111
1211a212112121110211022222221b2211221120220011111011111111101111a11111111000111110101111101111110011111111022201a20112222202112212121111221111111111011101110101
1111b210011210022210222222222b2122110222200111011101001010110111a11111011101111111111111101110001110111111111122b21111121210022202121201120110P10100110011111111
1211a210121001022202122100222b2022121121221011001111110101111111a00111110110101101111111111111111111111111112120b2212221001121201221221102111P111111111111111111
2122a211012222122211002220222b2120010022010101011100111011111111a11011101111111111111011111111111111011111000112a121022012222011020012122011P0111010111100111110
2212b221112120012222200220222a1122111221221111110101111011111110a10011011101111011111111111111110111111111120100b011121111101222022212100110P1111111100111101111
0011b202122112221212222200221a0122102100211111111111111101101111a10111111111110111111110111111011010101100021120a11210121020221110212212201P11101111111011111111
1001b111121120102101210122221a1011111111011101101111010111110100a01111101011110111111111111111110111111011122112b00PPPPPPPPPP12212221220PPP011111111111111111011
2212a210122220120202211201012b0010111111111111111001111111111110a11101111111111111111110111111011100111011012111b0P1210112221P2PPP2PPP2P220101010111011111001111
2010a221221200111221212202111a0111111111011001111020012102220220a11101210110112211101110111111111111011111102022bP022221221011P202P120P2121110111111011111101111
1102b211101201111102120022112b2101011111111011111202221212110001a12102222122120010011111011111101111111111111121P21111001222122212010120221111111111101111111011
1110a111211210221022020201222a1111111111011101101022021121120011b22202012121211100101111111111111111111111120211P21120222102212101212011121111011111110101111110
1111b002220020110012022110202a2111110111110101111111212122010222b21211221222200211111111111000111111011011102112P22121110020110012201212211011111111101111001110
1122a222112210212221210222011a2111111111111110101222102212021222b22012012222222110111101101111101110011110111221P00120221011222222222212121111111110111100011110
0001b220222002221111222122100a2011111111111111111011221001111012a11210112220201110111101111111110111101111102112P01211120122122001122112111101111110001001111111
0111b111211222022211021202012b0110101001101011111221012001212202b21022201102211211111011111110110111111011112222P10222221020212102220202111111111111110111011111
0111a111010101111101011111011a1111111100011101011212221010101011a12221102221111001111111001111011011101111101201P22022212211121210012001111010001111011111110011
0111a011111111001111111110011a1111101110010111011111101212111122b11111221021201101111111111001111101111001121120P00002221111221111011202211111111111111111001100
1111a111011111011111111100110a0111011011110110100212222112220101a21201211112102110111111111111111110111111111101P10202022112221102011101221011110101111111111111
1111a110011111110111011011110a1111011110111111010020021110111100a22221221121201111011001111111111110101111111200P12220011120211012002011120111111001111110111011
0101a011111110111111110101111a1101111111111101111111122220121112b21122212221112211011101100110011010101111102100P22110222121012221122011211011111001100101111111
0110a000110111101011000110111a1110001111111101011122011211120122b12222100102211211110111111110011111110111101222P21210212221122200100121101111011111110101111111
1011a011101100111111111111101a1111111111111111111020111122122211b02010222012022001111111111111111011101111101111P01111111110110011111101111101111111111101110111
1100a101111111101101111101010a1111110111111110111211201121202211b11101111222212101101111111011111111111111111101P01011111011111110111111111110110111101011111111
1111a110111011011110110111101a1101111010110111111122002112102220a01212121021000011111111001111111011111111111110P11011111111101110010011110111111111111101111101
1111a111011110111111011111011a1100001111110011001212221102111012b12220111200212211010101111111111111101011100101P11110111011111111111111111110101111111111111100
1111a101111111111011110110011a1111111101111111111121120102210122b20220121121101111111111111101101110111111111110P10110111010111011101111010111101101110111011111
1011a110000111110110111111011a1111111111111110001221112002110222a12210220221110101111101111111111011111110111111P10111110111011111111111111101111110101111111111
1111a111111111101011111111111a0111110111110111111202211211201221b21221211102102200111111111111011101110111111110P00110111110011111111111111111110111111110110111
0111a111011101111111111011101a1110111011011011110122110010122011b21102211220220211111111111101101111111111011101P11111001111101101010011011111101100111111111111
0111a111111111111101111111110a1011110111111111110211220122112122b20021211110112211111101111011110001011101111111P01011111011001111111111101111111110010110110101
0111a111111111011011111111101a1111100011111110011100220212101022b11211021112122111010111011111011101010011110111P10111011101110111011111111111111111111111111111
0111a110111111110000111101011a0111111111111011110212021221102222a11120211202221211111011111110110011101101011001P11111111111110101111111001111111011111111111101
1101a111111111111011110101111a1111111111010110111022010120111121a02222021211202211011001110111111110111110111011P10101110111111111110101011100111111111111011010
0111a111111110101111110111100a1110010101101111101110022112221201a00220212010011210110101010011111111001111111111P01111011111111101111111111000101111110111110111
0011a011011111001111111111111a0111111111110110111122012222012221a11210112211121211111111111111101101110111111001P11111111110111111110110101011011111010111101111
1111aaaaaaaaaaaaaaaaaaaaaPPPPPPPPPPPPPPPPPPPPPPPPb21101020122022a100211220122112111110111111110111110PPPPPPPPPPPa11110111111111111111111111100110010110011111110
111111001011111110100011P110111111101111111111111P11010211211222a02122220120211211111110110110PPPPPPP11110101101a11111011011111011111011111111111111111111111110
101101111011111111111001P101110111111111111111001P10210210000021a1112101120200021111110011110P011011011111110011a11111101111111111111111010111111111111100110111
111111111011111101111010P111011110101111111111110P02112212121212a11211021222000210PPPPPPPPPPP1110111010101101110a10011011111111110111111110011111111110110110110
011100101111111111111111P111101011111110101110111aPPPPP111111100a11011111110PPPPPP111111011101110111101111011110a11000111011101110011111111111011110101011111111
111111111111011111011111P111010101111111010001111a11110PPPPPPPPPa0PPPPPPPPPP111111111111111011111011110111010011a11011111010111100111111011111111011111000111111
111110011011111110011111P101111010011111110011111a00111011011111PP1111111100111011111111111011111110010011110000a11011101111100111111111000111111111111101101101
111100111011111111111111P011010111100101111111011a10111011111101a11111011011111111111101010111111111111111111001b12211120012112112221121221211111101110010101111
111101111111101101111011P110111001100111111101111a11011111111111a11110111011011110110111011111111001111000011110b12101010211202221202112112220010111111111101111
111111111111111101111111P111111011111111111111111a11111111110101a01111111111001100111111111101001010111111101101b21121121210022120011002112202111110011111111111
111011110111101111111111P111111011101001111101011a11111111111110a00101110101111111111111111111110212102121212212b22220211220112012112201122021111111110011111111
111101111011101111111011P111011111111111112220211a22111010220021b02010111101010111111111111111111201220210022222b12022222022211221201220221221110011011111110101
111111101111111111111101P011111001101011100121202b22220211221220a10011121110110101001100111111112112222121120220b11112220221222111200001101221111111111010111111
111111111111111101111111P111111111111101112211122a22110122212221b22022001101101010111111111110112222121112111212b22122211111122222010222210222011111111111011111
111111011111111111111111P110111101111111122220011a22121202100202a10020101111111111111011111111012122022211021102b22200102022220121121122021110111111111110011011
111011111110011111110100P111100111011111120012222a21121121122121a01111101011011111111101100111110212211000222110b10210101122221021102221122222111111101111111011
001111101111111111111111P100111111010111112200110b22012112211212b22002100100111111100111111101102110120202202012b22211122122222212202011021222101011111111101111
011110111111111111001111P011111111110111121220122a12020202210120b22112111011110111100110111111112111122211221100b12102211212202001012122122002100100111111110010
101110010111011111111111P101111101110101121112122a01001112222111b12221221111111111110011111110111212022111122202b02022221222212120122212100222111111111111111111
111111101110111111110101P111001101111010011112211a00121022022112a21000211111111110111111001111111212101122221212a22121210122221221111122100120011111101111011100
111101111001110111111101P111111111101111022121011a22111211201222b21110211111111101111111010111110011111212201111b22222122221210210010001001221111111111111110011
111111011111110111001101P001001011111110022120120b10022202211112b20021111110110111111011110111101111022210111021b22022202201221111011202012222111011111110101111
111111101111011111100101P111111011111001122221122a20002102122212a11221221101111111101011011011111111122211201102b22200012122220111112121102112110111111111101011
001111101111111111111111P110110101011111101021222a12221222210002a21212120111111010111111111110001221102012221212b22212222122120110122102121110111111111001100111
1111110111011000111110PPa111111101001111122102011a12122111110211a11100211111111011111101111111111201101212122121b12102022212201011111212210101111111111111111110
111111111111110110PPPP00a111111101111111112210121a21221211222002a21012001101111110100101111111010202112010222202a22121002220100012212021211112101011111000010111
10111111111111110P001100a011110111101001122202222b21122121112220b22221120111111101000110111111112212110121022021b20121222222202201122200110110011011111111111110
101111100011111111100011a110111001111011101202222b12100122121212a22221021111111011111111011101101011212121101112b22222222022200111102120202122101111111111111111
110111111101100111110011a111011111111101101211202a01100221222211a12110211011111111110111010110011221212120210112b02222210222222001210201122111111111111111111111
111111111111110111011111a100011111010011121201212a22100112102222b22221011101111011110111111011111022220211221022b22222222222222222200012201221111111111101011111
111111111111110111101111a110111011011111111121102b11110112012111b02201121110011001001001101110111111122212011122b22112220222220221122011111002111110111101011111
111111111111111111100111a100111101111111122002111a10210220100010b10112120101111111011111011101112121201201112222b22001112022222012101111222211011100101111110111
110111100110110111111110a111101011011110112110121a01101201102012a10110111010111111001011101111102102021212010011b22221112212210120101011020120101110111101101111
111101001111110111110111a011111111111110112111022a11112100221111a22200110111111110111110111110112010120221221211b10222120100000012020102122201100111111111111101
111100010111011110101110a110111111011111121100011a22121110211100a02222221111111011110111111011111022110112121201b22110122222202222211021122222111101101111111011
111011111011110000111111a101011111101011112221102b12221021012120a10211110110011110110011011111111112012222101121b22220221002222211122211201000100111111110001010
010111111011111111111101a111111011111111120221111a22021222020000a22221211100111111101111111110102110010202122212a22222212220211021102122212212101111110101011111
110101110101111111101111a011101010111111121111121a12201120220021b11011221001111110111101111110112000120122012212b12210212220222100212221220111110111110111111111
111111111111111111011111a111001111010111101102111b20222220112222b12021011111101110101111110011112112021111112121b10110122111112110111111111101111011111111111111
111111111111111110111111a111101101110111100212121a22101122120112b11022211110101110111011111110112101221210110120b12121221212201001101101011101111111101111101110
101011011111111111110101a101110111110011112210220b22212201022211a12211121111111111111101011101011222202112112011a01102210121220010110111001001111100101111111111
