80 119
104 11
122 49
126 101
64 67
119 18
56 105
111 104
8 43
26 34

1111100101101101111111111111111011111111111a0110111111111101111110101111111111111011101101110111001001111111a111111110101111111111011111111101100111110111111111
1111011110111110100111111110011111101111101a1011111010111111111001011110011111111111111111111011100111101111a001111111111111111011111111010011111110101111110101
1111011110110111111111111011111111010111111a1111101111011011110011111101111111111111011101101111111111001111a111111101101111111111111111111111111111111111111111
1111111101111110011110011011111111111100111a1101110101111111111111011111010100110111111111111111011111111221b121012021112102221221200011111111111111111101111111
1111111110111111111111111111111111100111111a1101111111111011111101111111101011010101011101111011101011012122a000222222122211212212211121111111111111101011010111
1010111111111111101011111110111111111101010a1111110111101101101111111010010111101111111110111111110111112211a012212121212201222201220201111111101001100111001111
1101011111110101111111111101111011111111011a0011111101111111111111111111011111101111111110011111101111011112b221221222212212220110112211111110111111111111101011
1111111111110111111111000111110101111111101a1111111010111011111001110100111011101100101110111111110111101212b211211121101121212121200221011101011110010101111111
1111110111111111101111101101101101111111111a1101111101111110111111111111111111111110101111011011001111102121b112210021210221122221211221111111100111111110111011
1111101111011111111110111110111111011111111a1111110111011100010111010101110101101111111111111101111111110122a102011111010201112112121211001111110011111011010111
1111111111101011111001011011111111111011111a1011010111110011011111111111011111110110011100111110101100111002b021212001021112101101112221101110101010110111111111
1011111101011111111010111100111010011111110a1111110101111110111111011111111111011100111111111111111111110011a022012222012122101210100111111110110111110100111111
1111111001011101011111011111111111100111110a1101011111111111111101111111111011101011011111110011111111101210a120122112101222102121121101111111101111110101011111
0111110111111011110111100111100111111011101a1110011111111110110111111110111100000111101111100101110011101102b220212000022121221022212111111111010011111111011111
0111111011110111101101011011111111010111110a1111111111111111111011001111011011110111110100100111101110112210b122121011100112122211121121101111110110111111111010
1011011111111111111111111010111111111111111a1111111111011110111111111011111100111101111001110111111111112112a222111000121112121121202221111011001111110111110111
1111111011011111101111111110111111111111000a1011111011111111001111101111110110011111111111101111111001110020a112111012210002121122010121111111111111110110111011
0101101101111011101111011110111111111111101a1111110111100110101111110111111000101001111011111111111111011002a110102212010022020111021211110011111011100101001111
1100111101011111010111111011011111101111100a1111111101111111110101011111100111111011101111111111111101012100b022111022021111221221220221111110111011111111011111
1001111111112212202212220222121201122011221aaaaaaaaaaaaaaaaaaaaaaaaaaaaaaaaaaaaaaaaaaaaaaaaaaaaaaaaaaaaa0021a111022112101210121112121221011111001111011111111111
1101001110122110222121221102122121210111211010101101111100111111110011011111111111001000111111101111110a2220b112101121001120211112201221111111111111111111011101
1111110111122012012212221221122110221111021111111011101110111111100111111111111110111111111111111111011a1121a121111121021221220212201200111110101111111111111101
1010110111002222210120110212221221212121211111111010111111011001111011110010110110111100011111111101111a1022a212022120212121021221120121101111111101111011111101
1101111011120112110122221011011102011122111111111110111011111111100110111101110011111111110101111111111a1110b211200111101211121000202201111011110101110111111111
0111110111121122111011110111121100111221221111110101111101111110111101111111111101111011011001110110101a2121a112112211111122122111112121001101111111011001111110
1111010111002222222221201100120211122212201111000001111111101111100110110011011011111111101111111111111a1111a112222121221212212121111211111101101111111110111111
1111101101111202110222211211121121022122211010011101111101110111101111011101111011111111011111110011001a0110a122012122221112201021100110111110111111111111111010
1111111111122121210121222102111121021100200111111011101111111111011111110111111101111011110111111100110a2102a120112212102121212002110011110111001111011100111101
2121121220110022122121102000220221111102121111111111111111001101111111111111110110101111101110101101011a0021a121121222010221112121211021111111111101111100111111
0012221120202020222121220222022212101212021111001111011111111100111111011111111110111011011111111101011a2012a120011211121112102221110221110111111111111111111101
1221210102122100122021200201122021012121011111011101111110111010111111111110111111111011111011111011110a1121b220122210212121102211111111100111101111011101101111
1220111211221200002101222120202122002221100011101111111110111111101111101111011111011111111111111111101a1101a102211012101112102100111021101000001111111111111110
2211211212020100221222212112121221120212001111111111111111011110001101111111011111110101110111011011111a1101b120002112012222101221221101111010111001111111101100
2222212121120222220222212222222102012112201111111100011110101111101111101111111111100111111111110101011a0221a222212212021222202122110110111111101111111110110111
1012220002202222221022222222221100221222210111100110111111011101111110101011111101010111111111111011111a1110b111012221212100101222011201200111111111111011111111
2202111111222111220221202210120122110220211111010111110101101101110110101111010100111101111100101111110a1111b120220012111210210221011220011100111010101111110100
1112121101001202222101002212001111202022201101101011011110101111011101111111101111111111111010011111111a1111b102021120211212021111001212111110110111111111111111
1221222112222211122222211221022111221001121101111101111010111111001111111111100010101111111000100111111a1002a211101201211012121102200121010110111011011100100111
1111122222212112202221202212222222120110111111111111011111111111010111111001111111111011101111111101011a1101b212121222002122022102210012211110101011111111010111
101122111210001220222202222202122120121002011111011011110111110aaaaaaaaaaaaaaaaaaaaaaaaaaaaaaaaaaaaaaaaa1112b122101101011112011122220121221111111111110110111111
112211221222220211222221122200202222112112111100011111110001111a11111111101111100101111011011101111111110110b112110222121111222221211210201101111101110010110110
222111211112220110202222202210222022221010100011111111101111111a01111110110011011011111110110111111111111102b202220222101112202002201021101101111101111111111111
022212211012222022120022022101021121122202111111111110100111111a10111101111101100000111111110100111111111111b021100111212220202211002001011101111011111001111111
202121211020021210212122222121220221022211111011111111111111010a11111011001010011011101111111110111110110111b212211210022221011122120211220111111111111111110111
110211212212212112222022212220221021212112111111111101101111111a01101011011101111111101111111111111111111112b202121112110002000122120121111111111011111100101111
121121220111112012221210222122221201120112011111111111111111110a11111111001111111101111010010110100111110112a122100122100120220012202201111011111111111111110001
101011112220201021101202222210101212212122111101110111101111110a11111111111111111111111101110111111111111012b121120110211002221222211021111111011011111111111111
200122012012222112221021221201121221200011111111111011101111011a11111110110111111111011111111111101111011110a221211222222202211012220001111100110110110111101111
221210122012222212122002221002212112221112111110111111110110111a11111010011111111111111111111101111111111111b121111110010011101200222220221111111110111110111111
212111120212022210212002122222222121121112111111011111011111101a01100111111110101101001101001111110010110112a110221221122021022210001111110111011110110110101111
111112101112101112100111121022000111111011111011111111111110111a11111100110111111110011111111111111011111112b221202101110121121221200211121110100111101111110111
210212202102122021211221111102201101101111110111111101011111010a11111101111101111111110101110011111100111102a221121122102211212212220220100101111111101111101111
222101022120022102210211202121211111111110111011112112001211211b22112112111120211110010011111111111101111111a100212221121211110222002011101110111111111001111101
212222221212220012102101120212211111111111111101121212120011120a11220001212001210111110111101111011111100112b211120112121011112212012012221101101110101011111111
212102220121021001212011221101111111111110111110111112121101201a22112121012121201011111111111111111011111010a122212112122011221202212101201111011111001111111100
012110121210220112122100211221111101111111011111121110111101210a10102201212111121111110111111111111111111112a111212212111120002012211222111111111011111111111111
120120212211212011102210211122111111111101111111020211112111212b20201101101212101011111101111111111101110111b212212100121211202212102112221101111010111110111111
212221222201102121012121201112210111111110111111100100202121101a12201221202212211111011001110111111110101112a120211201111021222121121122110110110111101011111011
212221211201001021111211211111011111110101101011100221101122111b11210212221211111011010111111011111111111111b101110222112222121122120122011111111111111101111111
110111101111111111111111111111111111011011111111110111222211010a12011112220212120111111111101110011110011112b221101022111112212111221122201010111111101111011111
110011111111111110011101110110001111111101000001100022222020211a011222101011221111111110aaaaaaaaaaaaaaaaaaabb221100201222222111112221102121110011101111101101110
101111111010110111111101101100101011001111111111112120212211202b222222212110212211001110a11100111001011111120211111222002201011100110121011111110111111011101111
111111100111101111111111101111111111100111111110102211211111211b210111012212112211111001a11111111011111111122100212122012201021100001212221111111001111111111111
010111110111101101111111111110110101111111111110011210211101101b212102221211221211111111a10111101110111101122111222112222011021201221121010110110111011110010111
110011111110101100011101100101111111111110110011122101110111112b122111211122222111011001a11111101111100111122101201101112212101212202112220001110011101101111100
111111111110110110111111111011111111101110111111121212110200221b211112111111120211111111a11111001001110111111111100111101101100101111111111101111111111111110100
010111111111010101101111011111001111110111111000121210011220011a111122000221202211101111a11110111111111100111011111111111111111111111110010111011101110111111111
111111011001110111011111111110011110111111111111110101201220222b121111211222210110111111a10101111001101011110111111110011101110011110101111001111110111111110110
101111010111011101110111111111101110111101101011110221111101002a012212211211212001110111a10111111111111111111101001111110000111110111111111110011111111111010011
110111111100101111111101111111101011101101111111121012101121202a120221222211111211101111a00111011011101011010101110110011110111100111101100111111111011111110010
011010111111110011111010011111101111111101111111121222101120122b121221122121212111110111a11101100110111101111111110111110011111011011110111111111010011111011111
011001111011010111111101111011111111101111111110110021120111111a112122222221201011111101a11110011111101111111101101011111001111110111001111011010111100110111111
111101101111101111111111101011111111111110111111100202201111102a201112221121121110001111a11111111111111101111111111111110101110111111111110111111111111010111111
111111111111101111110011111100111111111110110100111102222011210b221202120212122111111111a01001110111111101111111111101111011111111111111111011111111111111111011
111111101101101111110111110111111111010111111001120122122222121a221022101111211011111010a11011101011111100111011110111111101110011110011111011100111111111110111
111111111110110111111111111011111111111111111010122222122011122b021221212100002211110111a11001111001111111100111111111111111111111111101111110111001101101111111
111110111111111110011111101111111101101111011111112122102101112b111122122021121211101111a10111110111111111111111101111001111111101001111111011101111101111111110
010011111110111111010111011011011111001111111100121222120122201b122212202222112010110000a10111111011111111111110101110111111011111001011111111001111111111111110
101111110111101111110011111101111001111111111110112202021212222b011111200112111001110111a11111100100100101011110100111101010011111101110111111110111011011101111
10aaaaaaaaaaaaaaaaaaaaaaaaaaaaaaaaaaaaaaaaa10111121112112202111b201211011121012101111110a11110101111110110101111111110111110101011111111101101101111111111101111
01a011111111011100110111111101111101111010a11111102122012121102b221111122211210211111001a11111111111111111111111011111111111111101111111111111111110111011111101
11a010100110111111111111111111101101100111a11111112222221221102a121122021212211111101110a10111100110111110111011001011111111111111111111111110110110111011111001
11a111111101011011011110110110111111111110a11111112111102221012a021011000211221201011000a01100011111011111111111101011111111111111111011001111111101110111111011
11a101111111101111001111111110011111111011a11110111111011111111a100111000110101010111101a11101111111111011011111001101111111011111011111010111111111111111111011
10a111111111111011111111100111010111111101a01100111011111111111a110010010111101111101111a11111100111110111011111111111111110111111110111111111111111101111111111
11a111110111111101111111111111110011111111a10011111111111111111a011011100111101110001111a11111011101110111101111011110111011100111101110101110111011111111111111
11a011111010111110011110111101111100111111a11111101101101111111a111110111000101111111111a10110111001101111101112221212112221122020220021110201111110111011011111
01a111101011111110111110101111110010111011a01001011111111111111a111111110111111011111101a11110111101111101101011121100122120202001022111212221110101111111011111
11a011101101111110011001101111101100010111a10111111111110111101a001011111111101101011101a11101111111111010111112112210110212000122220212121101100101111111111111
11a101010111111110111110011001111110100101a10111111111111010111a111101111101111110111111a10111112112200221021212212012011211222112121101022212011111101111111111
11a111001011011101011110010011011001101102b21122112212220212112b201220101111111111111101a11100001121002111122121220211002220222200122122201222111111111111100111
11a111011111110011111111101111111111011111b11222111221220021222a200111111111101011110111a01011112210221120211221021200222211200112001121002112111011111110111011
11a100101101111011111111100101111110111102b11102012011212201022b121201201101111111111111a10111112212111122111001220121220121202222122221221011111110111101111111
10a101101111011111111101111001111111111112b22111201100221210201b111122221110111111111101a11101111021111221102012222202120202222121110101021212111110011011101110
11a011111111111111111111111111100111101101a01102211222002122222b121111001010110111111111a10101012210202110210210121200222120222101122111201211111111110111111011
11a011100101111111110111111111111110111111b11122222220022121012a012212211111101011101111a1111111020abbabaabbbabbbbabbbbbbbababbabaabaaabaabbbaaaaaaaaaaaaaaaaaaa
11a111111011110111111110101011111101111111b11121201211222120120b220212211111111111100111a1110101111b211120222022220021222220002210122022212022111110011111111111
01a111110010011111011110111110010111111111b22120000121101002221b021202221011111111111111a1111101122a112102202210222222122221221122110110212221011110110011111111
01a011111110111111110111111011110111110112b12021121112121222221b221121200001001110110101a1111110112a122121212222122022222220212101100201000112111111111111101110
01a110010100011111101001011100111111011112b20221112111222111212a212221011111110001111111a0011111111b111221221022122122222011222211112111201212111111111111111111
01a111111111110011111111101101101111011012b11212120220210112111b021122211111111111111011a1101111222b221200210222221221222200212021212021021121111011111101111110
10a010110111110011111011110101111101101012a22111202221012121002a221111121111111111101110a0111111222b220112212220020122122100202012121200201122111011111111011111
01a111111110111111111111111110010111111112b10222222101011221221b222012121111111011001100a1110111122a211020111211222222200100202000201121202221011111101011111111
11a111001111101111001111111110111110111012b22101012011202112222a201012111111011101111110a0111111211b110102122212212112222210221201112212221012011111111111111101
01a100011110111111101101111011111111111112a01221211222012220212b022120211111101111111111a1111110001b201112211122211012022022110111120221210012111110101011111111
11a011111110110110111011010101111111111100a00200000102210002222b211111101011110011001111a1101110022b102212110202221202221112211110020210112000101011110011110111
01a100110111111000111101110111101111011010b22121111021101200122a112212001101011101110111a1011111120b220121110211211002200202100111122112212210111111011101011111
01a111110111111001111110111111101111111101a12222121010201202210b200221200111111111010111a1011101212a111221222211210122220002121110010211200120111001011111111110
01a111110111111111110011011111111111111112a22221022100210022222b101002120111111001111111a1111011221b120011222220212001200021221201211002100002001111111110111110
11a001110001111111111111111111110111111101a22221101211211120221a202100121111010111111011a0101110221b021211211220102202222220222211121221210222101111101111011100
11a111010111101110111111111100111111011111a12210201012021121102b021121221111101111111110a1110111112b010201112201012202222212211111110112110111111111101111111111
10a111111101101000111101111101111100111112b02110012212111221121b022212120111101111111011a1100101212b002022110202022222212212212220012122121101111110101111100010
11a111101110101111011111111111111110111101b11121100011110122212b112110211011111111010111a1011111220b212102101022222222212220202221112122021102101111111111001110
11a010101111011010110111100111111111111112a21122122011220222121b011012111111111111111111a0011111100b111210211211210022222022102112202220012001011101101111011111
11a111111011011111101111111011110011110112a12011212110122221201b111221221011110101111111a1111111000a201212121212220210022221220111112212112201110010011110111111
11a110111011101011111111110111110100111111a21111122202200112222a112022201111111011010111a1111011022aababaababbbbabbbabbb0222122110122120111021111101001111011111
11a110111111111111101111111111111110010112b21201122222222022211b121201201110111010001101a111101112212211221211020021010b0222122222221202101222111111100111111111
10a110111100011101110011101011110101011012a22021222222212212021a200212011001111110111111a111111122111221210122012101212b2212201111111111101011111111111111110101
01a111110111101111011011011011111111111112b21122211021221000121a111122101111111111011001a111111121101120210201202102111a1222121110010101111011011111101101111111
10a111111111111110111111111111011111111011b12221210210121012212a122212111110011111011111a111111102212112221110121122222b0202011111101111111111111101110101111111
