72 14
5 107
122 49
126 101
64 67
119 18
56 105
111 104
8 43
26 34

1111111111010110111a111010111110111111111111101110100001100a0101101111111110111111111011101011110111110101101011111001111111111011111111001111011101111110101111
0111111011101111100a111011101111111101110111101111111011111a1111111111111101111011101110001111111111110111001110111110110101010101111110110111011011101111101101
1110111110111001111a110111011110111101101011100110111111111a0111111111110110111111001110111110111101111001101101111111110111101011011111100110111001111011111101
1110111000110111101a111110110111011111101011100101110110101a0110111111101111011111101100011111101111100111121011121121110212122100212211111101101111100111110111
1011011100101101111a111111111111011111011100111110111011111a1111111111111111111111111111101101111111111110211021120101121122221222110111110111111010110100111111
1111111111110011111a111111011111011111111111100111110111011a0111111101101111111010110101101011001111111122111122222102112221021122212211111111111101101110011101
0110011010010101111a110011011110101100111010111101111101111a1111111111100101111100111111111111101111111112122011211101012112212220121210100111111111010011111111
1111111101011101010a101101111111010110111111011110011110100a1010111111111111110111111111111111110111101121211001212102012021101221221211010111111111110001111110
1101111110101111111a111111110001101101101111000011111111110a1110110010111111110101111101111111111111111120102121021020111212201201222211100111111011111111111111
1110111111111111111a100111111011111111110101111111111111111a1010101111111111101111111110111101101111111101122122122111110120111121102110100111111111101110111111
1101101111111011111a100111111101101111111101111110101110101a1111111110111111101101111110011011111111011102022021222211222212222121111221111111111111101101101110
1110111111011111111a001111111110111111100111111111111110111a1111111101101111001011111011101111111011011110011202110122012121111200220111101101011110111111111011
0111011011011111111a111111111111011111101011110110111110111a1111110011110111111011011111111011111111101121212022101120221002210222211021111111111111101010011111
1011101110101111111a111111101110111111111110100011111111011a1111101111111111010111100111011111011111010011111221211122111112121010001121101101111111111111111111
1000111111110111001a000111110111110001101111111111110111100a1011111111111111111111101111111110101111111122121021022101102212111011122211011011011111111101011111
0111110111111111111a010110111111101110110111111111101011111a0110100101111110111111110101111111111101111110210122210211202222110120121221110111110111111111111111
0101101111011111111a111101111001011100110110111111101010011a0111111101101100111111101111011111111111111112210212022021221211222212212021010110101101100111111110
0011111101101111101a001001101111111011111111101111111111110a0111110101010011110001111000111101111111101111100222211122122200102210212221000010111011011111111111
1111110111101111110a101111110001011011111011111011101111101a1110011101111110111111111111110101111110011102201021121202112022100122122021111111111110111001111011
1111111111112222222b221110021112112101121201111111101111101a1101111011111111111111111111011111110110111111122010110222222111202222122011111111011110101111011111
1001011110120111002b121222221210222110012211111110111101111aaaaaaaaaaaaaaaaaaaaaaaaaaaaaaaaaaaaaaaaaaaaaaabbbaaabbbbbabbbaaaaaaabaababaaaaaaaaaaaaaaaaaaaaaaaaaa
1000111100022220202b02012221100210020102111001111111111010111111111110110111111100110110111111111110111102011202121121111111120111222111111111110101001111111111
0110111111102120021b22111121221210111120211111110100111110111111111101111111111111111110101010001011110122121200121201111022002122221211111111101010011101011111
1111101111110111111b02110122220110121011100111111011011101111111110111110111111011111111101011011111111112102221222102002022221101211110111111111111101111111111
1101111111120121111a00111222112112012022121111111101111111110111111011011111011101111110011111111110011120120101222001121110112210002111111111101011011110111101
1111111011111022112b12010210200111112211020010111111111111111111111010111100101111111111111110111110101122220011212102201121210002110221011111111111111111011011
1111111100122111110b02211202020212221011211101101111111111111111101010011011001101111011111111001111111112202111112021022211121120220221111111001010010111100101
1110011111112211112b12122010221202122201201001111111111011101111111111111111110101111111110000111111111112222010122022011210220100212201111111111111111111111111
2122121102222222222b20000220222212012211221111011111101111011101100110001111101111111111011111101111111120222101111012220101222222212201111111111101111111111101
2111210110220222201b12222222221121002102221111110111110111110100111111011111111111101111111110001111011102211122222111021222101210210211111110011111110111111111
2110221202112202120a22121222222121211200211111001001110110101111110111011111011011111011100111111111111121120021221112221201200212211220101101111111111111111111
1222212222020202220b11222222220220001222121101110111110111111011111110111101011111111110111011111011111112011111121211211220102112012011011101011110111111111011
2110100111122220122b22222221202221112202101111111011111111111100111101011111111111111111111111111011111121121112122121202102020001222111101111110101110111110110
2211112211121212221b20112221112122220100011111111111101001111111111011111111011101111111111111111111111122101102211121121022220121001111111111011111011111011011
0220200002122202222b22222111220011201121221111111100111111111111111110010111111101111100111101111111111001121202210221202212120200121221221111111101111111111111
1221201122112222021a21222200212222221220220011110101111001111110111111111111111111110111111111111101100010100010211221111011112210022112220011111111111111110111
2111110112222121221b02220022002222202201220111111111010101110111001110011111111111111110101101111111111011110212122122101222022121121212121111111111111111110011
2221110222210212001b00022121221211201120211110111111111010110110110110011011111111111011111101111111011101102201111120202112011101100111111111011110110011111011
2100222012112020201b12222010221111122122111111101101001001111111111111111111111111011010010001101011101111112211111121212012201022100211020111101111110101001111
2112120002122022220a22111222221111210012221111110111110101101110111111011110111111101011110111111111011110002222112102211221221211001122211110110101111110011100
2110210200222221000b01021212222111122102220011111110011111100111110100110111111011111010100111101111111011100212212122012021222001210101121101111111101110111011
1220111120020112002b22222012122110222120101111111111111111111011011111111111111111111111111111011011011011121110121102212211201011210222200111101011111101111111
1012220120120110021b10102121112011111211110111101111110011111111011101010110111111101011111111111001011111102211101201201020201100121220021110110111011011101011
0210122100011021221b11221120022111101112011111111101110011111111011110110011110111111111111111100100011111120222211101210111021211021211121111111111110101001110
1120202021121202222b12222021022000222102111110111111111111001110101110011111010010101111101111011111111111122112121212221210212121021121221111111110111101111111
0212011222202210112b20221202012112112221120111111111011111111101011110011111001111111111111111111001011110122112112201012210112121121022111111010111010111111011
1222111211112122222b12200022222121111221211101111111111101111101010111110011111111011111001111111110111111122121020110121121122202100012211011110111111111011111
1211010221012112222b10202122222020222202211101111101111111101111101111110011111111101111110111111101111011110212122212121212212200001022121111111100101000111111
2012201001202222222a01200222222220211111121010111100111110111111111111101111011011110111111111111111111111112122110201112202211222000121111111110101111110111011
2221222222122212222b02222201222022212211220111111111111111111011111100111111111111110111111011111111101111120112120122202011222121212222111111111111111111011111
1212212101200121111aaaabbbaaabbaaaaaaaaaaaaaaaaaaaaaaaaaaaaaaaaaaaaaaaaaaaaaaaaaaaaaaaaaaaaaaaaaaaaaaaaaaaaaababbabbabbbbabaabbbabbbaabbaaaaaaaaaaaaaaaaaaaaaaaa
1111201122122112220122012102221101111101111111111111010100010110111110110111111101101111101001111111111010111122212121221112212222112022011111111111101111111111
1000112010101011221012111120200111111111011111111021121002120221222121022220121111011111110111111111011101101021011022202222221211122122111101111011111011111111
2110122000121210222011020202210111101110111111101001121220002112101121110111121111111110111010111011111111112112211201011001211220212221111110111101111110111111
2010211212221212011122211220022111101101111111110021101111012102201022122221101211111111111101111110101111112220111222121200122010021121201111010111100111111111
2112211221111121200211102112120110111111111111111102122122112221221201122221211201111111111101111111101111122121211112102112021201111210011111111101001110111011
0120121211221111222112021002121010011111111111011222002101110111010102212111220211111010001111110111011110101212101201112222110111101221121111111111111011111111
2211211112222201122020212221112111111111111011111112212002221012221020121011121210011100110011111111110111122212211111202222010022222112221111101111111111110111
2110011222201200010101122111201111111010011111101020110210102211202212111110011110111111111101111111101011102211122110211121100021001202201111111111111011100111
101111111111111111100111111111111111111010101011122011012121222221220222122222121111111110aaaaaaaaaaaaaaaaababaabbbabbbbabbaaaaabbb22211221010111111110110111111
110011010111111001111111111111110111111110110111111112121110222111102020111111121011111011a111110011101011121101200200110211021102a11001121111111110011111111111
111111111111111011110110111101111101111011011111012210112012211121112220220111221101111111a011111010101111121000112121111122210201a11212121011110111111111111111
011011011010011011110101101101110111111111111111111121022022012121021111220002021100100011a101111011111001102212112112121021122022a20011011011111111111111111001
011111111111011111111101110001111111110100110011001212201120121111210211111010120111111111a111011111111101112100121212212201110121b22011211011111111111110111111
111111110111111111111110110111111111101111111111020111122010212211222112111212201111011111a111111111011111120222010112101221021111a21222020111111111011101111101
101011111111111110101111111001111111111111111110122011222010121111001112112120121111011111a011111011011011111101101110111010111110a01111011101111001110101110011
010001111111110111111111111111011110111111111110112001020221121111102012020021120111101101a010111111100101111011111110111111111111a01111111111111011100111111111
111111111111111111111111110101111111111111111111102122211111122120222201010221101011111110a110111111110111111101111111110111000101a10110110110111111111111111111
101111011111001110110110110011111111111101111111121202112122200201211021001221211011101010a111101111110111111111101100110011111010a11101111111111011111101011111
011011101111011111111110111110111111011111111110121221122220111100222112222101120100101000a111111111111110111101110001101011010111a10111111111010011001110111101
111001011110111111111011101111111110001111101011112221200000222022202212110102121110111111a111111111111001111111111101101101101111a11111111110001111101110111011
111110111111111111010111111111110111111011010111102112201101202102111221112112120101101111a101111101110011110111111101111011111111a11111101111011111011111111111
110111001101111111111101101111111110111111011011111122211221022021121021222121121111110101a111111111110111010011011110110111111111a01011101110101110111010000110
001111011111101111100011111111111111111111011111011121222012011102221121222211221001111111a111101111011110101001111111011110111111a11111100011101111011111111100
110011111011101111111101111111111001111101111111122102111012220202202202201111110110011101a011001111101001111111101111111111110110a11111110111110010111101000110
110111111001101110111111111111111111111111111101112102222120122021211211012222021110011111a111010111011110011111111111111111111100a11110111111111111010110111111
010111111011111111111100111011011010011011111111121112200020222112120212221202011011111111a101110101011011111111111111111111111111a11101100110111111010111011111
111010110111111111011110111111101010111111110111012101102110101220112212221011211011101111a111111111111101011101111111111110100110a10111111111111111011111111111
011111101111101111111110111111110101111110001111101211121121021210212021120222211111111111a111110110111101001011111111011111111111a11111111111111110011111111111
aaaaaaaaaaaaaaaaaaaaaaaaaaaaaaaaaaaaaaaaaaaaaaaaaabbbbbbaaaabbbabbbaaaaaabbbaa001001111111aaaaaaaaaaaaaaaaaaaaa1110111111110111111aaaaaaaaaaaaaaaaaaaaaaaaaaaaaa
11101111111111111111111011101111111111111111111110121121121221112222212201212b02011011111111011011111111111111a1000111110001111011111000111111011111110110111101
11110110011111111110111111111001101101111101011111122122120011011122111002122a22111111010110111000101111110001a0111111101111111110111100111111111110110101101110
10101111111111010011110111111011111111111011011110222111021222022011012201001b22011111111111110111110111111110a0111011001111111111011011101111100111011111011011
11100111101010101011111111111110011111111110110001111111001010111111111111111a01110111100110011111110111101111a1000101110001101111111110111110111111111110011100
01011111111011111110100111111101111111111111101111111010111111111111110111111a10111111011101111111111011111111a1111100111011111111111110111111110101110110110011
11010111111111011111111110111011110111101111111111101111011110111110101111101a11101111111101100111011100110010a1011111110101100111111111110111101111111111101101
10011111111111111111111100111110111011101101011110111111111111010111110111111a11111011110100100111001101111101a1020221111122212201211210120110111110110111111111
11010111011111111111111011111111011011111110101111110111111011010111101111101a01111110101110000111111101011100a1221221222202011012010010222111111110101111101110
11111001101111111111111111111111100111111111101101111110111001100011011111111a11101111101110110111101101111111a1212110212020222121222121222111011111111110001110
11111011111110111111111001011111111111010111111111101011100111001011111010011a11111111010111111011221120212222b0121222200220222210011022111222101111110011111101
11111111111101111110010101110111111110111222200122121201221011112202102010111a11111111111111110122212121101212a0021222202210200222201110110110011101110101111111
11111111111111111111110101110111111111111012121202221200120210212221122110100a11110111111110011111020021200022b0102202220200222122221222210122111110111111101001
00111011110111101111101111101111110111011110211221201111000221102200012111110a11110111110000111020211212122101b2222222222220222011020011110120111010111111111111
01111110111111111111111100111111011111111121200122112021111111111221120110111a01111101111111111122021122221101b2022212022222212211211112121102101111110110110101
11111010111110111001111011111110110101111210102222022210122110022211021200111a10111111111110001121022120201002b0212222212222122001222210022222101111101111011111
11111011101100110111111111111101011111110211102212122211122211210210211211110a11111101101111111012210211112221a1122220222011020200110122102211111111101101111101
01111111101011110111111111111011001011111010120002220201121122102122001011100a10111110111111111100111211122222a1220222200222221122221221221222001111101011111111
11110110010011111111011101110111010111111121110112111120220221111211101211111a01000111111111111102111110222212b2210222222122202011212121121221101110111110011110
11111100110011111010111111111111111101110112021210122021102122101200122101001a11101111101111111001112121022220b0201012120120202001022012220111110111110111111111
11111111110111111101010111100000110011111122122111101101222122212120012211111a10111111011101111120220202220212a2220200220020211211102100111121101001111101111011
00111111110111011111011011110111111111011202111101022021201022102011021101110a11111011111010101121002002111021b1202022120220221111212221211201111111111111111111
11011111111111101111001111111110011101101202021202100021112122101102122111111a11100111011111111111012022201121a2222112120222222101111120201101110111111111111111
11101110011010111111111111111101111110011022011102001111221222121212222201110a01111010101011111011121021002012b0022220222122222012110021121122111111111111111111
01110101111111111111110111110111111011110021200121211122001122110122121211111a01110111111101111112212112221020a0002021101222222112011001110112110110111111011110
01111111001111101111011111101011111110111212022101122121022222221112112011111a11111111111101111122212202112011a2120212202220002211110121111120011111111101111111
10111110111111111111111101111111111101110112200212011212201111122100012011111a11101010111110111120110121012212b1122102212021002120222112121210010111111111110110
11011011111111111111100111111111101111111222211121101222121221121012021211011a11111100101100111122122111210122b2222222222202100210221211122002111101101111111011
11110111011101110111011011011011001111111020212011212020221011112020101011011a10101001111101110002122022022202a2210122221222122111121112221212001111110011111111
10111111111111000111111101111011110111001210101201222201222212212211011111010a11110001100110100121211010110111b2120122221210220011001202121100011010111101111111
01111111100101111111111011110111101011111012122001211201200220222102112111110a11111111111110110011121222221121b2222022222220222112022022222020010110010110010111
11111011111111100111111111111111111111111111120212212012211221110110112011111a00111011011111111102211122111102b1022002022222111222112221111121111111011111111101
11111111001111111101101111101111011101111211021222111122121222121021122201011a11111111111111111022121112210221b1222122112222122110101121121201111011001111110111
11111111110011111111111111110110111111011002121121221222210022121012211011011a11111011110110011121112210122122b2222211112202122100011221112222101101111111110111
11110111011011011110011111111111110101011012221221000210212201210202000110111a11011111111111111122021212121012a1202012201012122112021112202002001111111011111101
01110111101011011010111110110111011011101220121000111122012212112020201111111a11111011101001111110111102202011b0222221222112122212111021111222111111111111111111
11110110011111111111111111111111111111010222212111220211111122220111120210011a11110010001011111122222002210120b1222122022200212122210121222222111011111110111101
11111111111011101111011110110110011101111202111120220120111211210201122111111a11111111111010110121122210211201a2211212122222211002121222111110111111111011111011
01111101111101111111111111111111001111110221211100120220200202221221221211111a11110111110110111112111121202121b1112111021001202011111011111110111111100111110011
11111111100110111111111001011011111111110212012212022121211101111222211011110a11011111111111011021101111112212a1221220010120122111111011111111101111101110111101
10111101111110111111101101110110111111111202221000222212221220212021122211111a11110111111101001112022122211212a1112102212211210111111011011111111111111111101111
