1 21
158 108
122 49
126 101
64 67
119 18
56 105
111 104
8 43
26 34

11111001101101111111011101111101111100111101110011110111101111111111111101101111111011111111111100111111a1001001001101001011101111111111111a11111111111100111111
11101110101100111111101111111111111111111111111111111111111111011010111111111111111101001110100110111111a0011111100011010111110101111101000a11111110101001101111
11111101111111100111111111111111010111101111011111110111111111010101110110101011111001111011110111111111a1101011101111111111110101111111111a11111101111100011101
11111111111101111101110111111111111111110110111011011001000111111111110111011101111101011110011111101111a1210202211211022222002020111111111a11111111111111111111
11010111111111111110111100111010111111110111101101101011111111101101110111111111101110101111011111101111a2101212222112111111210120221211111a11110111111101011111
01101110111111110111111111111111011110100111111111110111111011111111111111101110110011110111011111111011a2120202002122212010101110222201111a11111111111101010111
11111111101101101110011100101110111111111010111111010111011111101101111111110001111111101111110111110101b2012100110112121121010211222111111a10111010101111111011
11101100111111001111010111111111111001101111110111011111111101011101011111111011111110110011111111111111a1110112222221211011212111200101100a11111111001111110110
10111111101111110100101111111111111011111111111011101101111110111110111111111111110111011100111111111111b0221211211210122220121221121111101a11011111001111110011
11111111111011111101111111011111111111010111010101111111011110101110110101010110011011111111011111011111b2220220012222101122021111122111111a11100001011110111011
01110111111111111111111110001111101111111111111110011011111111101111110111111011110110101101111110101111b1122212110100021221102121111110111a10111111100011101111
11111110100111111111001111111111111011111001011111100111111111110111100111111111010011011111100111011001b0121110221222010220101210221121110a01111011101111111101
11010111011111011110100111010111111110010111100111111111101111111111001001111111111111111111111111110111a0001111212121102212212002022210111a10111111111111111111
11111111111111011111111111111111111111111111111111001011111000111111011101011011111101111101111111111111a1002211212221122211001121010121111a11111111111111101111
01111111111111011111110101111111111111110111111111111111111011111101110101101111110101000111110101111101a0112222201112022110122012220211111a10101100111101110111
11111110011111111111110011111011111111111111111111011110111010110101111111111111101101101111111111001011b2002011202012110012211222212011101a01101111111011111111
01101111101111101111111101111111110011101011111001101110111111101111111101111110101111111111111111111110a1212210210211012112211012122111111a11111101111111111010
11101111111111110111001111111011111111111110011111111011111111111111111110101011011101110111110111011011b1010222120122122111012211111121011a11111011000011111110
11111101111110011011110110110010111010111100011101111111111010110111110111111111111111011111110111011111b2011221221111111211211122111211101a10111101110110110010
11aPPPPPPPPPPPPPPPPPPPPPPPPPPPPPPPPPPPPPPPPPPPPPPPPPPPPPPPPPPPPPPPPPPPPPPPPPPPPPPPa111111111010111111111b1011111021211210100101120021121111a11100111111100011111
11P0111110121102121101012121020222120201120011111011011001110011010110111110111001P111110110110101111111a0202202100200101121210212100021101a10101010111110111111
1Pa1111010122222200102222100201210121122111111001110011111101111111111111111111111P110111111111110110001b0221200112112122222101221102020101a01110111111110111011
10a1111101100210020210221221102110011012211011110111001101111101111011101111101111P111111110111111101001a0202121211221122022201221121211010a11111111111110111110
11a1111010112122011121121221012222221201101111111111111101011110010111101111111101P110101101011111011111b1011122212212210222221122020201110a11010011101110111011
01a1110111120202001121221101121211020210221101110111111110111111111011111111010011P111011111111111111110b0112222100100111201112111011101110a10110011111111001110
11a1111111122220100222102121002221021121201110111110111111111111111111110111111101P111111111111101111111a1111222002222012202221101201101111a11111011011101011101
10a1101111120011112101111201121121100110211111101111101011111010111011011011101111P110111111111100001011b2112120002220101101200112001210111a01111000101111101011
10a1101111101212221102122101212222022000110111111111111111111111111111111101111111P110110101111111111111b1222111221221100021221211001211111a10111101111110111011
21a2112220100211120221222200120111222211011111111111111110111001001001011111111011P111010111111111101111a2100221102221202222221111221221101a11111111001110110111
21b1122210102122012022000200122211220211121101111011111011011110111110111111101111P111111110111111011011b1211211112111110002211220210111111a01010001011111111111
01b2200101220002001222201221222221201101101011111111111111111111010111110011100111P111111100110111011111a2220220011020121122112111200101111a11101111101111111011
22b1012221020222220022212212120202100122111111110011110111111111111111001111111111P111101111010111011111a0210001112122012111201112122121111a11111111001111111111
11b1112110102200222220122102222111111120201100110111111111011111110111011111111110P110111111111111001111b1202011001111210221112221112221110a11111011111111010011
11b2222022222212220210002212211121101121120111111111111101111111111111111111101111P111111011111111001111a2212221212002212221122021222111011a11111110111111111111
02a0211211222221202202220001122112212111121110011011111011110111111111101111011111P011111101010111111111a0110102212112122110111112222012221a11111111111011111101
10b2110121212220222210222122212101212112121111011111100111111011110111011110011011P010111111111011111111a1020112111121221011222212201012120a11011001111111010110
22b1221120000102020022211002101021201211211110111111001111111101111110111111111101P010111011111111011111a0100012200111102002211222122121100a11111111111111111111
22a0021222221212202222120220212021222122210111001011001111011010111100111110111110P110111111101110111111a1121200221120212202221001210222111a11101101011111101111
21b0112202020222021020222212222221211001101111111111100110111001111011011111111101P111110111111110111000a1002122210112121211202220101222121a10111111110011011011
00b2010221221212111212222120020121200221211101110110111111101110100101011111111111P101111011011111111111a1122111001022122221220222201212121a11011111101111111111
12a1011011022101200122022221021210211122211111111101010111111101001011111110111111P101111110010101011001a1002020201021011120021112100211011a11101111111111111111
12a2112101100112022022022120002222111021011101111111101111011110111111111110011111P011110111110100111101a11222201210220babaaabaaabbbabbaabaa11111101001111111110
22a2121220122022222122221122222222012212111111111111111111110111111111111100111111P111111111111011101111a00212101222011a2210120221021212211001111101011111111110
12a1212222012221012001222002222122210021021011111011111111111111111011111111101011P110111111111110111111a11212211221211a2211111121201121121110111111111011110001
01b1201122012120212201201111220211211222210111110111111111011110011111101111111111P011111111011111000111a11000012222201a1221212220112022201111111111101111011111
12b1111110201221222102002212212221021221111111011011111011111111101101011110100111P101111111111010010111a01122122122122b1220110221020120101101111111111101111111
11a2111011222202222122121212200221210000221011111001111111111111111111011111011111P111111111111111011011a11222110022111a2020201112121122111001110111011101010111
11a0012111210122212212222212202221122211201111111111111111111110110010111010111110P101111110111111111111a11212122212020a1210110102122120111011111111100111101111
21a1111200221212222001102222022222122012111111111110101111110111111011111111111111P101101111101100111011a11021210120102b0000221211202110221111010111111111011111
12b2021211100220220222022211222210112110021111111111101110111111111111101011110111P011111111111110111110a01122112121112b0211211101121210201110111111111110110100
11b1121110112202011100212211022111110111111111011110111011111110000110101111111011P101111101111101110011a11101210111112b0100211122102012201111111111111111101110
11b1221122122121101120121212202010101100101010101010101111011101111110111001001111P110111111000111111110a11112222201002b0221222012112011221111111011111111010111
10a0221121212111212021011220012111011011111000111102121110121111221011212021110211P110101111011111111111a10212111210112b2221211211012111200111110110111111111101
20a2221222122001222022201100222011111111111111111112102222101222220122121211011211P111111111110111111111a11121120022122b2022002120222110011111011001111101111111
01a2102111210212122121022102111111111111111111101122221201221111212111221210210211P111111111111110111010a11112221111222a2112111121001022021110111111011111110010
20b1110021102021010020112120222111111111111111111201022010222122122021221220121011P111111111111111001111a11200002021012b2022200101012201220111111101011111111110
21b2221210021112101121211221222110011111111101010211212112212100211110112012222100P101010110111010111111a01201211121122b2121010111112102000111111011111111111001
02b2221111111212111121010122122011111111111011101222020120011211012222221101110211P111111111111111101111a11212111022110b0200012222221212221111110111111111111011
01b1220122211111212220121122211111101111111011111212201102122212112000211200121010P101111101101111111011a10202110021101b1011110122211121200101110011111000111001
11a1111111101111011101110111101110111011111111111111201011112200221212211112101110P111111001110110111111a10011221121212a1221212121112212111101111111111111000110
10a1111111010111111111111111111111111110011010101012102222222100221211211010202110P001111111101101111011a11222211212211b2221100122120011220011111111111111111111
11a1100111010110110111101111101111111111111111101201200222112110222120111121022011P101111101111111101011a01221011212220a0100201121111202111111111111111011001111
10a0111011111111111111101110011010111111110011111111121000010012001120222122011111P111111011111101110111a11112121101100a2011102021101201001111111111001011111010
10a0010011111110111111101111101111110011001111011012122110022120012012112202111211P111111111110111110100a11111122011201a2202211110110212201110100111111111111111
11a1111111111111111111011111111111111111111101111112111112121211212112100211221111P101100011111111111001a11122021111221a0021110101222221011011100111000110111100
11a1001011111111011101111011011111100011101111111202201210202221202021212222110111P101011111110101111111a01111011110011a1111100111111010101111111111111101111111
11a0111111111111001101111010110111011001111111011101122200202200100102011120210210P101101111101101111111a01010111111110a1010011010101110011111101110101111111111
11a1101111111111101011011011111111101111110111111210202122112021210012121111222201P111111111101011111111a11111101101111a1011111010111010111111111100011101111101
11a1111011111011010111110111101011110111101111110011111100122110211110211121221111P111111111111110110111a11111011110111a0101111111111111101101111111111011011111
11a1111101110111110110111111111111111011111110100210210212121120110112012102211010P111111010110111011101a11101111100101a0111111111101101011101101111111111111111
11a1011011011011111110111111111111101111101111101122220212111121122120110120211011P111101110111111111011a11110111010110a1001110001010111111011000111101101101111
11a1111011111111111111111101110011111111111111011012011201212112201110210012202111P111111010111111111111a11011010011010a1101101111111111001111011111111111011111
11a1010111111111111011110011111111011111111110111112111221111220121021212211202011P101111111101111111000a11111101111111a1110101111111101110111111111111111111011
11a0111111101111110110111101111111111110101111101121120101101112112210121222022111P111111110011110111011a01111111010111a0110111111111110111111111101101111101111
11a1111111111111111111101001111111111111010111001212212211121111102001200222112201P001111111111101111111a11111110111111a1011111110111110110001101101111001110111
11a1111010011111111111111110110111011111110101101122221222122220110122022212111210P111111111110011011111a01111101111101a1111011110011110101111111111110111111111
11a1011110111101101111111011111111111111111101111210222112102201111121101221111210P111110011111111010101a11110101010011a1111100111011110110111111101011011101111
11a1111111011111111111111011111011110011111101011211201121212211212111122222210211P101011111111111111111a10001111010011a1110111111110011111110111011111011100111
11a1101100111101111001011111011111110001110110111111112210100120002122122112120101P011110110101110111111a11111111111111a1110111111111111011010111111111011100111
aaa1aaaaaaaaaaaaaaaaaaaaaaaaaaaaaaaaaaaaaaaaa1111122211201210000112020211111011211P111101101110111011110a10111111110111a1111111101111110101111111001111111111011
0111a011111111111011111111101110101111011110a1011122101101201202111101202001200111P111001010110111101101a11110011111110a1111111011110111111101101111111110111010
0101a011111011101111111001100010011111011111a1111122112122102200221121200202201211P011111111111111101101a111101101111PPPPPPPPPPPPPPPPPPPPPPPPPPPPPPPPPPPPPPPaaaa
0110a101101011111111110101111111111011101110a1101002112122112022022112102101221111P111110111110110000110aPPPPPPPPPPPP001101111111111111111111110111111111101P110
0111a011110011110111111111101111110101111111a1010101110111111111111111111001111101P111111110101110111111P110011111111111111001111111011110111111101111111111P111
1111a111011111100111111011111111111111100011a0001010111111011010111111111101110011P111111111111110111101P110111111011111011111111110111111111110111101110111P011
0011a111101101111111111101110011011111101011a1111011111111110111111101101101111111P111111110111111111111P110111111010101111111111101111111111010101111111111P111
1101a111111110111111110011111111110111111011a1111011111011111111111010111111111011P111111011111111111111P110110100211111101211222122121222211211111111110111P111
1110a110110111111011110111111110111011111111a0011011101111010011010010111111101101P100111110011111111111P111101012002110021222120110202110012111011101100111P101
1101a101100011110101011111101111111011111111a0111111100111111110111111111110011011P100111011111111111111P111111121121112212112121201210121012201100110111101P011
1011a011111110111111100111010111111100011111a1101011111111111111110110110111111011P111101111101121101221P012012222121220012202112212112212221211111101011101P011
1111a111111101110111100101111110111011101221b0220201200010112102212000211111101111P011010011110122220210P221101221221211121222112122111111221211111111111111P111
1110a100110110111110111110111111111110011121b1102112212021211102201202121111101110P111010011101121021221P111001202102211222221102011111101110111011111111110P111
1111a011110111010101111111101110111110111211b0012121111202200210111201211111111111P010001111101122120121P212102222222012222202121110121210110111101111111111P111
1110a111101100111111011011101001101111111010b1111202021122210121222222111111110111P111111111110112101112P120220222222120021001212111212102121200100011111111P111
1100a111111100110011111111111111110111111111b2220122212211101221210121221110110110P110111111111121100221P111012210220212212102122210212121220111111111011011P111
1101a111111111011111011011111110011111111221b2112011221112002120210222121111101111P111110001110122112201P120121222222222122021222201002111121111111110111011P101
1111a111101110110111100100111110111111110122a2022122021001121202220120111001010111P001101101111121012221P022012222222022122222010110221112210201111111110111P111
1111a110001111100110110011111111111111111100a2111121121122220200210102110011110101P011001101111112121111P210212200112011020221220101222222210110111111001111P111
1111a111111111111110101011011111010110111011b1111022121211110022121202211111111111P11110101111101110102Pb011201202220122002102111220122011122100101111101101P111
1001a111011111100111111111111101111111101211a1002112110012020002211110121111110111aPPPPPPPPPPPPPPPPPPPP2b1122001210222200021222122022120100112110111111111100P11
1101a110111111111111111111101111111011101121a110101221212212011212121202111111111100111110110111112111b0b22212011112100222222021220122110120211110001111111110P1
1011a111101101111111111111111110111001111212b110212221221120111101112101011111111110111110001011021110a1a02222220222222222221220210111212101210111110111011100P1
0011a110111111111100110100111011011100111121b110210220122110112211220111011111011111111111111110111101b1a22020022122202002122222202120110212220011111101111111P1
1101a111110001111101101111111111111011011200a212212112211222122222220110110111111111110111110011221111b2b12120102222011222221121211111120100101011011111111111P0
1111a110011111111111011110111111100101110111b000121221221221111101120211011111111111111111011111012221b2a110210122112210222222210122122221101010111101110111100P
1011a110010111011101111111101111111011111020a212021221121220220221000100111111101110011111111010122121a1b210122122022122222212212120111222002111101111111111000P
1101a101111011111111111111111111111000111212b110212221120110111111222211011110111011101100010011211021b0a21211202210222222100202112110221210121111011110100011P0
1111a111111111111011010111000111111111011111a212010211221210022021100112100111111000111111111101120222a0a21022010021022002221221220002211212211011011101101111P1
0111a111111111011111111101111111011111101221a011111012021222222122121211111110011111011011111101111020b0b10120122200122110222111202211222222211111001101111001P1
0111a111111111111111111111110111111111111211b220210010121102211020122222111111011111111111011011110211b1a2222022222022222222022100201212202222011111010111011111
1110a111111111111110011111111101101111111102a121011112111212121111221101011111111001111111111111202220a2a1202102120221222221212201222221011101111110100110111111
1111a110111111111111111110111111101011111022a222112222111021020211121000111111110011111110111011020112a1a0211002222212200222102022022202121210011111101000111111
1111a110111111111111111111011111111000111121a101111121101122221102112122111111111110111111011111222221a0a1110121221022122222202022122222120220101011011111110001
1110a110111101110011011111111111111111000222b122212100202011021222012211111111100111101111111101221210a2b2120212221211210022122210211211121201111111101110101111
1111a111111100111100110110111111110111101212b200021220202211222111111111110011111101101101111111211100a1a1122111022012112202222120220212122122111111111110010111
1111a111111111110111111111011111100111100121a221220101122112222112211022111111101111011110111010100122a0b1112211222212110221212110210212012202111111111111111110
1110a011110111111111110000111110111111111122b212212222221022210210012220111100111111111111110101002122b1b1101012011022021202210002110002010112110111111001111111
1110a011111111101111111101111110110011111020b021102212221100001102201012100111111101111011111111110120b0a1022012112211011112122110111111001101110101111111111011
0111a111101101110111111111111111011001111222b112112122120221101221122020111110111110111111111101112212a2b1002022110110120212202111111101110011101111011010101111
1111a111111111011111111011111111111111110212b022122110022012220202221201110111110111010111110011121111a2a2111212211012120222112111101101111110011111111111111111
