155 90
17 116
122 49
126 101
64 67
119 18
56 105
111 104
8 43
26 34

111101111111011111110100011111011111111101011111101110011111001111111111111110a0101011111110111111101111101111110111111110111101101111a1111111111111110111111011
011110110111111111111011111111110011111111111101111111101111111111110111101010a1110111111111111111110110110110010100111101101011111011a1110111101101110110111110
111101111111110001101011111111111001101011110111011011011111110111111110101111a1101111111101111001111111111111111111111011111011111011a1111011101011110111100111
111111101111111111101110111111111111111111110111111111010111111010111110101111a1111111111011111101111111021221210121200212111002211121b0111111111011010101111101
111110011110111111011100111111110011111111110001111111111101110111111111010010a1111010111100101111110111112122121201101222221101211121b1011111100111111111111101
011111111001110110111111001111101110111111111111110111111111111111110110011101a0111011111110111111111111111112212101222202221112122022b1101111111101111001101011
011010111111010111011110111111111101111111010101110101111101111111110011011111a1101110100011110110111111212212212221222112211111122212a1111111010110111111011111
111111011111111111111110111101111000110111001101111100111011111011111101111011a1111111101111011101011111102112210020122111122101101221b1111001011111101101111111
111111011101111101111010111110111101111111111011111111111111011101111111111011a1111111100111101011111111112111201222222112221222120101a1111111111111111101011111
011111110011111111111000111111111111110110101111110111000101111101101111110111a0111111101100110111101111211211010022101012122202022102b1111110111001011111011111
111111101011101111110111111101111101111011111111111001111101011101110111110101a1111001111110111111111011220210112010112010122110010110a0011111001111111111101011
110111111111111001111101000001111111111101111110101110111110111111111101101111a1110110111110011110111111021102120210220002221222212202a1011111111111111111011111
111111111111111111111111111111010101111111110111111001111110111101011111111111a1111111111111111110100111011211221121120212222221201022b1111111111111111011101111
001111111111111101101111101100011111110110011111111111110111111111110111101111a1110101111101110110111111111110101220221121101121122111b1111111110111011111110111
aaaaaaaaaaaaaaaaaaaaaaaaaaaaaaaaaaaaaaaaaaaaaaaaaaaaaaaaaaaaa11111011111111101a1110111011110111011011010222022201112120122221121012202b1101011111111111111111100
111110111101110110101111111111111110111111111101101110100110a11111111111111110a1111111111010011011111111201201222121121222202212112112a1111001111111111101111111
111100111111111100110110111011111111111011111101111111111111a11111111111110111a1110111101011110010111111102112022112201111122010110201a1101111011011111111101110
110110101100011111111101011110111011111111111100110110110101a11111111111101011a0110110110011101110000010212101221112112100211112011210a1011110110111011111010111
111101101011111111011011110111111111101100111111101111011101a01111010111100101a1111011010101111111111111120112211201222221222211222122b0011100111110111101011101
111111111111211101111112110212212121211121111001110100110111a01110101001011100a1110111101011011111111111211122211202122020202111210212aaaaaaaaaaaaaaaaaaaaa11111
111111111111112022202212211012120002110212011111101111111110a10111011011111110a011111111111111111010111100110122202101111011220001100111111111110111111101a01111
100111100111011201222122122211222120101202111011100111111111a00111101111111011a011011110111110011111111121212021002101202110012122201101001101111111011101a11111
111001111110112201212012201211102002000102101011111111111011a10111110001111111a111100111111110011111111102221021220101102210102122222221101111111111111110a10111
111111111012112112221010221021121011201122111111110111111111a11111111111111111a111011111111110101111111112012111112022022221201112222001111110111110111100a10111
111011101111121212021222222121122211212220110011110110111101a11111101111111010a011111111100101111100111120122210202112211021201000221201110001110111001100a10111
110011111012111222221112222011121220102011111011111110111111a01111011111011111a111110111011101111101111122122221211122222121212111222101101111110111111111a11111
100111111010121211101011202221111001202210111110011101111111a10101111110101101a101111111111111010111011002211002001121010221111112221221110111100101000101a11111
011101111111122012012112122212221120122112000111111011100111a11011111111111011a011111100100111111011111100212011021121222222222122220121111001101011110101a11011
102011222102022122022100002220222011111011111011101101111111a11111011011110100a111111111011111111101111111101102101211101222102010111111101001111111111111a10100
122102120222220202022012222202210020012121111111011111111001a11011111111100011a011011111101011011010111111112201211020100022112012121111100110111111111111a11101
222121211222220012122212022022222211111211011110111011111110a11111111101011111a110111111110101000100111111211112112121102210110222022210101111111110111011a10111
121012021220122112211220222221022012122021111111111111110111a01110111111111111a111111101000111101111111022020212010102021210212010222111011111111111111110a10110
112220112202222212200122222122211022021112111111111111011011a01111111111111111a111001111011101101111011012121221020220112001222220010221111111111011111110a11111
baaabbbaaabbbbbbbbbba212222202022022221122001101111101010011a01001110001111100a111111010101101111111111021012221012121122112202122222001001101110110111101a11111
22112210020222211222b122122211012212202221101111100000011111a11111110111111111a100111111111101011100111111110121002102122212220222121211211111110111110111a11101
22122111110221222122b220122020200101011221101110011111110111a11011111111111110a010110111111101011110111111012111220101112120022212112102111101111110110111a11111
12222212121112202202b200202000221202211221111011111101111111a01110111101111101a110111011111111101011011111121211212022021012200201211102121111111110111110a11111
20021222021122112222b211100012011010111202111111111101111111a01111111111111111a100111111111110111011010111121121211111211120120120111002111110111111100111a11111
12211111122002012222b222220112221121221120011101011010111100a11011111111111111a001111111111101111101010111122211222021111210212120212111020111111111111111a01101
22121112121022022202a212222212222222212202111111101111101111a11010111111111111a11111111111111111101111111101222201bbbabaaaaaabaabbbbbbb1111111110111111111a10110
12122100101222022100a122012201222121122212111111111111110111a01111111111111101a00011111111111100101011111102212012a0112201122121011122a1211001111100111111a11111
10102012220122022221b220212222211022211112111010110111111001a11111101111111011a11111111111110011101101110111202211b1112120200120121210a0211110101111011011a10111
12120221022222222012a211222001122212122120111111111110001111a01101111111111101a11111111111111011111111111111111111a2221220112012220022a0011011011101111011a11001
11000202121221222122a221121202221112210220110011100111101111a10011111111110001a10111101101111111111111110112112100b2202012200222112222b0021111011111111111a10101
20212102100002022222a112210222011212220201101111100101111111a11111110111111110a11101010011111101101011110011200221a2011222122012222121a0211111011110111111a10111
22222102212202222020b112222222211112201211111111111110111101a01101111110101111a01101111111011111111100111110221012a2111122112222111221a2221111010111111101a11111
22211111202222222022a100122222201121211002110111010111011111a11110010110101001a01011111110111011111111111110110101a2122022222012121120b2021111110111110010a11111
22122220220212222120b222212122200220111111111000110111111111a11110111100111111a11110111101111110111111110100102222a1222112102112011201b2110111111100111111a11111
11220101111220202212a220210220202220120020111101101111111010a01110011110111111a11111101011011111011110111110121011b0022222110220212222a1121111110011111111a10001
22222212001221021222a200200222212012122012110111011111111111a11110111001111111a11111111111101111101111110111011011b2102021020202120122a2111111111111111111a11111
01211211210211222201b022111112211111111111101111010111010011a11111111110111111a11111111110111111111001111010012222a1201112210201022112b2021110110010111111a10111
21222211120112211112a121102012211111111111110111110101111111a11111111111111111a10111111111111111101001011102222011b2121111020222110201a2121110001111111111a11100
21120010022201221122a111211202211111110011010111122112100221a10121221111111211b01111111011111111101110011112110221a1100111102120212212a1211011111111010101a11111
12212000112221102222b211111222201111001111100111120121121212b21120201211212121b11010010111110100110111110112222101b2220222120202122101a0111110111111111111a11011
21022210212222201010b2210210122111111111aaaaaaaaabbbabaaabaaa10011021222210122b01111110100101111111001111012012211b0210222121111121101a2121111111111111011a11111
10122212110110220221a2002012212111111111a0111011111212011211022021210210212200b20011011111111101011111111112121211a2202201100001211122b2121011111100111011a11111
12211010211121121122b2120221222011111111a1111111111012210012021111222222220210a01101111111011111110011110111102212b0221222020110220001a2111111001111111101a11101
11220211111101101101a0102020121111100111a1101111101211002121112011212202120211b20110111011101111101111000110102211a1201021110222221111b0011110100110001111a11110
02210102100111112212a2011122212111111111a1111111111212222201002120021111212220b11111111111011011111111101110222011b0111002222122221211a2200111110010111111a01111
11111111111101111011a1111111101111111110a1111101122121211212102212211222222220a11110110011111111011101101111211211a1222112121122022211b0220111111111010111a11111
01111111101111111110a1111011110101111111a1111101111022111112010112222101121110b21101011001111101101111110112202212b1220212010211222012a1111010111011111111a01011
10011111110110111111a1111111111110010111a0111111112122101122222221200220121122a21111111110011101111111111112211222b1210122220212201220b0221111101100101101a00101
11011111111011110111a1111111110111000111a1111111112111111220122211221220112101a01110111111110111111111110111100020a0011122212221222201a0111111110111110011a11111
11000111011101001011a1111110111111001111a1111101012200101222121112110201012222b11111110101011110100110011112201022b2212222012211200111b1101101101111111111a11011
10101111111111101001a1001101111101111111a1111110102112202010011211012100212210a10111011011111111111101111112221211b1201211122120202012b2021011011111011111a11111
11101011110110110111a0101111111101111101a1111011110212111121222101001022201122b20011111111111100111011110011011111a0111101111110111111a1111111110111111111a00111
11111111111011011111a1111101011010101111a1111001112210211121120012221122022101a11111110111111101111101011111111101a1111101111010110111a0111101111011111111a11111
11101111111011000100a1111101111111111110a1011111122012220121221201202221201202b11010111011101111011110111111110010a1111011101010010111a1111101111111111111a01110
11111111111110111111a1110111111111111111a0111111102200010101112022200111202202b20111011011111110111111111001101011a1111111111111011111a1111110111111111111a11111
11101110110111111000a1111110111010110101a1111101112121122100101111012212011121a11111110110001001010111110101111111a1111011111110011101a0101101111110111110a11111
11001111110111110011a1111111111010110011a1011111110212111021011212112200201201b21111001111110110111111111110111000a0111111111111011111a1011111100111111111a10111
11111111101110110011a1111010111101110001a1111101012202111201222211022222121120b01101101111111011111111110111110110a1111111010011111101a0110111111111111111a11101
11001101111111011111a0111011110111011111a1110111112111202222211111111202122021b01110101111011011011111101011111111a0011101111111111011a1100101111111111100a11111
11010010111011110101a1000010101111101000a1111011012222122122121221121211012222a11101111111110011101111010101110111a1111111111111111011a0101011111101111011a10011
10110101110111111011a1110111111010101111a1101111011221112022220202102122221122b21110111110101110111110010011101110a1111111111101111111a1100111111111111001a11101
01111111101111111111a1101111111110111111a1111011101111212021211120020201200221a21110111101111111111111111111111110a1110111011111110111a1111111111111111101a11011
11011111101111111111a1111110111101111111a0011111112102222111121122221002021121b11011111100111111111010101111101111a1101111101111111111a1110111111111111011a10110
11111111110110111111a1101111111110111101a1111111021010111222221111002022211200b11111111111111011011111100111110111a1111111011011111101a1101110111101010111a11110
11111111111111111111a1111111101111011101a1111011010211112121020102222221012220a21111000111110110101111011101011011a1111011110111110111a1110111111100111101a11111
11101111101111111111a0111111111100101111a1111101101210120111121021212110122112a11111111010101111110101111111110011a1111111101101111111aaaaaaaaaaaaaaaaaaaaa11111
11111111110111111111a1111111011111010110a1110111102212022012122022200111011222a21100111001001111111111101111111001a111110101111011110111101101101111101111111101
11111011010111111101a1111110111100111110a1110000020102112222101221222112101211b21111111011011111111111111011100010a101111111111010111110111111111101111111111111
11011100111111111111a1111110111111111010a1111101122022112202200222110222110120a01110111010111110111011111111011101a111010001111111111011011101111010111111111111
11111111011011111101a0101101111111000111a1101110111111111010111010111101101011a10111101111111110110100111111111111a101111111010101010101111101111111101111111111
11111110011111110101a1111111101111111111a1110111011111101111011111111111111101a11111111111001101111111111111111011a101110111011111011111111110111011111101101111
11001111111011011011a1101011110111101110a0011011111111011111111110011111111110a10011110011110111111110111111010111a101101111111101111111000111111111111101110110
11101111111111111111a1110111100111111111a0110111110110111011110101111111111111a01111111101111111111111011101111111b210111021101021120222112021100011001111101101
11111110111111101111a1111111111111110110a1101100011011001111111010111111110110a11111110011111111001111100111111210a211100111110112112121111210011011100101111000
11111110110010111111a1110011111111111111a0111110011011011111001010111111111111a11111110111111111111011111111111220a120220222201212102112022122111110111111111011
01111101111111111101a1111101111111110111a1111111110011111101110111011111110011a11011010111111111002221020211222222b120222102122012110222222111011111110100111011
11111111111101111110a1010111101110111101a0210122012210212111220011121020110011a01011111010111011101111210120220202a122001022221222211121001201111101111001111011
11001111111111001101a1111111111011100011a2202101121200202120022210020222001111a10010011011111010212211112021120221b222012021212212120121212010111001111110101111
11111101101111110110a1111111111101111111a2002221122020201122122011222220111111a11111111101101111101111110001221222b201222122211121021101021201101101110110111111
11110110101111101111a1001111011111111111a0220112201111112222212000121222110000a10011010110111111221021110122221212b202222221011210022111022212111111111111011001
11111111011110001111a1111111001111111111a2121020222202202221211212100222011111a11111111011111011202011210122101122b222212222002011221111121011111111111100011111
01111110111011010110a1010111001010111111a2112122211211210122220222110101111111a11011111110111011112221110222112202b212222221222210202212211110111111011111011111
10110111101111111111a1101111111111011111a2112200212201120200121222021202101111a11111111111011111211200122112121202b222221102000220212021110102111100110101101100
11111101110111111111a1011111001111001011a1212222020212212011121122120011111111a11101111111110011220221121012221221b022122110020220220101212122011111110111111111
10111111011111011111a1111101111110001101a0110212222211221202011022100212111111a11111101101101111022212210122111202b022220120222121221021220212111100111111001111
11111111111111111110a1111111111111111111a2101112202221201111210202222202111111a11010001010111111012211212122111202a222220012212102202201221222111111010111111111
11111110111110001011a1111010110110111100a2211012211112122022100211210202111111a11111111111111111210021121122112000a121112012212210122122212222010111110111101111
10111011001111101111a0111111111111110111a0211002222022021222101022111221101011a11111110100111101210221211121210020a120122222222122202222201221100010111101111011
01110101111111101110a1111011111111011101a2120111220112211222112122102011001110a11111101111001111111220121121122022a222121211220011120111222222101111110111111011
11111101101110101111a1000101111111111010a2101111120121121000122212121101111101a01101111111110111021210022210222222b102122221001221120211120121101110111111111111
11110001111111011101a1011111110111101000a2121212212012121211222212102222101111a11110011111111101211111111221211222a221220220022121101111202210011111111010111011
10111111111110100111a1011101110101110001a1121220222101211000211001101221110001a11111000111111111022122011211212222b022222202022121222011002212111111101111011001
11111111111111011011a1101011101101111111a1011221202011210112211021221100010011a11111100111111101110102222010122100b222222222220001112212222002111111101111010110
11110011111111111111a0111111111011110111a2211202112012111112012211011121111111a11011101111111111110221221222001121a220122202011002212211011112101011111110111111
11111111011101101010a1111111111111111111a1012101211111112020122101120122000111a11101111110111101101000220100212201b201202222012222210221110222011101011111010111
11111001011011111011a1111111111111101110a0022112022111201211000120102220111111a11110111111101011222211121222111222b200221221121120222111112111010110111111101010
11111111101111111111a1111110111111111111a1111122210111121011211020212112010110a11111111011110111212202122212121222b122212211221111121121120112111101111010111111
11111010101111111111a1101111111111011001a1112122122012222201110212222220111100a10101001111111111122120122022121022b221122012222121101212201102010111111101111101
11100010101101111111a1111111110011111011a1101112122121100111011121202001110110a10101111111111100101020111101212122b200212122220222001121121122111111111110101111
aaaaaaaaaaaaaaaaaaaaa1111111100110010101a1002000211210120212212121222121101011a11011111111101101211222000212021122b222112212222202202111210111011101011110001111
0111101011111111111101011111011111111111a1211211201011012121121002002221110111a11011111111011110211211012210212020b212220201222201211221112212110100111111011110
1111101000101111111011101111111001111101a0011222122122220101211121212211111111a10111111111111101012211111211102022b110022120201121121221211221111110011111111010
1111111111110111010111111111101110010101a1211220111221221211211212200211100111a11011011001101100202101101120211222b120212221211021212201100111111011111111111111
1011111111111101110101110010110111101111a1201101211011122111121121111220111110a11111111111111111202201221021111012a121111121122111111011101101111000111101111110
1111101011111110011011111111111111101111a2122022120222102001222211211102111001a01111111111111111220122122112121101a122112220212110011111111111100111110100011111
1101101110011101111111111111111111111111a2101211111001112220111120102211111111a11101101110110001201212112111012110b001121120022101111111101111111111100011111111
