155 90
17 116
122 49
126 101
64 67
119 18
56 105
111 104
8 43
26 34

1111111100011101a0100111111011100100011001111011110a1110111111101110111011111101111111110111101110aa111101111010111110111101001111001011011011111110101100110101
1101101111111110a1111001111111111111111111111001100a0111101010000101111111111110111111111111111111aa111001110111101111011111111001101111110111111011111111111111
0110010111011011a1110101011110101110111011111111011a1101011111111101111111101110101111111110111111aa101110111011101111111101101001111111110101111111100111111111
1110111010111111a1111110010101111111111111111110111a1110111010111101111101111011101110111111110111aa001021211210212012122102122212012121110111010111010011111110
1101011111111111a1011011101100101111111111101100011a0111111010111111111111011111111001111111111001aaaaaaabaaaabbababbaab1201012202122111101111101111111111111101
0111111111011111a1010101111101111111001111111100111a1110110100101111101111101111111111111111101111a11111110120201202101a2122220000221111000111101111011110111111
1111111001101111a1010111111111100011111111111111111a1011111111011011111101111110101111101011110011a10111212122222202020a2120101022101211011011111111111011110010
1100011111011111a1111111110111111111111111110110111a1111011111101101100101111111011111111111111111a11011211211112212122b1212211212111121111111111111101111111111
1001111101111111a1001011111111011011111111011111101a1111101101111111111110111111110111111011111110a11111110201110220111b0202211100220021111111111101110111111111
0101101001011111a1111101111101111111110101111111111a1111111111110111111111100111011111110111111110a10110202202121221102b1101211122211221110111111111101111111110
1111111111101111a1111011110111111011111111001110111a1101111001011101111101111111101111011111111111a00111011202221212220a2021212111020011111111111101101111111010
1100111110001101a1111111111111011111110111111101111a1111111111111111110101011101011101110111101101a10111022122021122012a2220222112112211110111011111011111110111
1111011111110111a1111111011111111100111101101110111a1110010011111101111111001111010111111111111111a11111010221221202021a0201211210021001110111111011101111101111
1111111110111101a0101111111111111111101111111100111a0111010101111101110111111110110111010110111111a11110211101210122110a0221211110101011111101101111110000111111
1111111011110101a1111011011101111011111101101111111a1010111110011101111111110100111111111111111011a10111122222220211222b2222212021201211101111111101101011111111
1101111101011110a1010111101110111111111101111101111a1111111110110011111111111110111101111011100110a01010122122121211121a1212111210112110111111110110110101011111
1111101011111111a0111110111111111111011001111111110a1011101101111101111100111101111111010111101111a01111111011221022222b2111012110011110111110111111011011011111
1111111111111110a1010111111110111110111111111111011a0001011111110110111011101101111111111110110110a11110021221201120111b2112122011222220111011111111110100001110
1111111111111111a1111111111110110000111101010111111a1111111111011010111011110011011111100111011011a00111121221121111221b2120202200122021011111110011011111110011
1111111111110121a2112000010210112110222021011111101a1001111011111101111111111011110110111000011111a10100110110212020121a1222001202112211101110111110101110111101
1111111111120111b0011221212121111211220021011111011a1111110111011111111100111101111101101110111100a00111110210102202011a1221122111121221101000111101111100111111
1101010111011112b1110221000222111020022111011111011a1111111111111111101110111111101101101111111110a11111022222102022112b2102012202212101110111111110111101110101
1111100011122202a2211222111010121021001102101101111a1111110110111111111111101101111111111111001111a00011211221101012221a1222201121112021111111011111010111111101
0011111111122121a1111122121202221022121121111110111a0011111111111110111111111111111111111001111111a01111221202112221221a1211112120112011111111111111111111110111
1111111111012222a1102202211102112022202111101101000a1111111111110111101101011111101111111111111110a11100220212120211220a2012112120122011111010111001101100100001
1101111101122211b2212111120110221201112102100111111a1011111111111111110111111101110110101111110111a11111201101221211222b2111122021001211111011111111011011101110
1111110111120112a0222222100210220112200112111111111a1001010111011111101010111000111101111111011111a11011220111012021102a2212101221212201101100111111010111101111
1111111111121222b0112012121222200220221112101111110a1110111111111110111111011011111111111111110111a01101220102112122111a2111121122112201111111111111111011101111
2122021121212222b1102222110220211122112211000111011a1111111111110111111111010111011111011011110111a11111202221022212121b1021201222010221111111111110111100111111
0100210112201122b0021211222022001111202110111111111a1011111111110111101111111111101110101110111011a00101111201220221112b2111201201210121111101111111111111111011
2200120210112022a2022122002122212012121211001111111a1111111111111110111101101110111111111011111110a11011011221221221111b1201222111221201111110111111110111101111
1012221222222202b2211200102222102120211222111111110a1111100110011110111111100010111111111111111111a11110122112122012121b2222210212021211111111111111110111011111
2112102201111222b0012122222122201210211111101111111a0110001111001011111111111111110110111111110101a11111121222221220100b1202222000221110110111110010110110101100
2022222212221222b1211222020112211221211112111011011a1111111101101111111011111011110110111111011111a11111111121212121010a1112111221211220100111111110011111001111
1221112200200212a2211120212112112111210120111111111a0111111011111101111011110101111110111111011011a11111101011121121222a1212222021221210121111111110010111011011
1020220221220211b2212222222220220112022021111100111a1111110101111111001001111101111111111111111100a01011111222210210221b1012001111221121211011111110101111111111
1011211112122120a2212220122222201021221120111111101a0011111111111111111101101111111011111101111001a11010111012101220221b1001011222112012211111101110110111110111
0222120222212212b0120222210202211111221001110111100a1111011101011111101101101111011111111011111111a11101111222121212101b1221102200222221121101101011111111111110
0111222011010222b2022222221222222222221022111111010a1011110111101111111111110111111110111110011111a11100111212220112002b1120200012222102111111111101011011011111
2110111112110210ababbbbbbbbbbbbabbbba10011011110110a1010110001010111111110101110111111111011001111a11111110100111221022b1012022112012222121101111011111111111011
222021201122202200211221222222122112a22012111110011a1011101110111111111111011101111100111011101011a11110111021022212101a2212112222000012121101110111101011111101
122122210120122222222222022022211012b11022111111011a1010111011111101111111111111111111101101101101a01111110122221022122a1102010212120121210110110111111111111111
112102222222212221122221221221100202b22220111111111a0111110111110111101111011111011100110110101111a11011111022012112111a2202122121202222210011111101011111111111
221020112022222022202222212002211002b21220110110111a1110111111111101110011111110111110111111111111a01110011122121202010a2111112121211011021111101111111111011111
111222120021121212210022212221222101a22000011110101a1111111011110111110111111011111111111111111110aaaaaaaaabbbbbbabbbaba2011221122102111211111111011011111110111
220101012211221221222022221212210221a21201110011111a1111000111111110010101111111111111101110011111aa101111122111112111120201020020102210201111111111010101101111
201112111111202200110222222202220020a01221110001001a1111111111110110111010011111111111111111111111aa011110112002122121222220211010102211121111111111111101101111
120212101010122111202120220202102112a12111111111101a1111111111111111111111110110111011010111111110aa011111101111212100121002022120022222121111100111110111111101
011221210100220211220220022122012221a21010110101111a1010111110110111001111111111111011111111111111aa111011020122111211121211121221212221121110111110111111010011
121201102202221111201222220222221112b22122111011110a1011111101001111111111111110111111111111111111aa101101111022121001212112212221111102021101111111111011110110
100120122222022122121122122211111111a11010111101101a1111011111111111111111111011111011111100110110aa110111101020021020122211112011121212021110111111101101111111
201110201110222122212011120211011111a10011111011110a1111011111111111110111111011110101111111110111aa101101101122000111111221221111012120210101110111111111100011
211100220021012222202112110100011111a11110011110121a2212111120012220221111211122011011111111111011aa110011111012211121221112021212120202121111110111110110011011
212202001212112122022120011112111111a01111111001122b2201222210212121111212022212011111111101110111aa111111112210110111110101010201011102201011111111001011110111
211102012222222012022112210111011101a01111011111122a1020110120121210112120201111111111011111111011aa011100112202221210211122212220101101210111011111111111110111
122122212122122201022001220221211101a11011111111121b1112212121220212211102120102101111111111100011aa111011101122221012212221212000011112111110111101011101111101
022200112100211212201200221201111011a10111101111011a202222112211222121021012P210101011111111111111aa101111112202112222101011202211110221121001100011111111111101
112221011022002211221112102122110111a01110011110111a10110102211211011100111P2PPP111100100111101010aa111111111202122100012220012220221212211111111111111110111111
111221111012120112222111122212111111a00PPPPPPPPPPPPb1221102122121012211201P00222PP0111011110111111aa011010121212102112112111011212010110221111111110111011111111
0111111101111111aPPPPPPPPPPPPPPPPPPPPPP111111101122P111121122212212120022P01112010PPPPPPPPPPP01111aa110111111120210122011011212221102110211111101101011111111110
0111111001111111P1111111111111101111111110111100101aPPPPPPPPPPPPPPPPPPPbP10022221111111001110PPPPPaa111111021212021110202110012221112001221111111111111111101110
1110111111111111P011111101011011001001110011111112221112212102112211220P10012111111111011101101111Pa011101012211210111201210110111202110201111111110110111010111
1111101111011011P101111111111110101111111010111010020220122211112022000b22021122111110111101101111aP011111111212211202121211212112211102101011011110110001111111
1110110011111011P111111111010101111110110101111012212112211121112100111a01022111111111101111001111aP101111021120201112210221202121201222100101101111111111011101
1100101111101011P111111011111110101111011111111111112111111221111000121b00101022111111010011001011aP111110002021001221222221012212111101101100110110111101111110
1111010111111111P111011101111110110111111010011100111200112112212112222b12021110111101111110111101aP111111101111111110111101111111110100111101111111111101111110
0111111111101110P110011110111111111111111100110102221102110021212211122b22212212011111111101101110aP011101101111111111111111011101111111110110111101101111111011
1101111111110111P110111110111100011111111111110112110211222220211221111b10212111101110100101111111aP111110110111101111011111010111011111101111000110001111110000
1111011100111111P100010111111110110110011000111111211120110111021120111a20220122011010101111011011aP011111110101101111111111111111111111110110011110011011111111
1011110101111111P111011011101111111010111011011112212102211011220212112b11121012111101011111111111aP101111011111111011000010111010011011010110111111111111111110
0111111110111111P110001111101111101111011101010111021211122221222111211b10221221101101111100011111aP111111011111011111011111111011101111101011111111010111110111
1111111111111111P110111010101110001101111111010112110202111111022012111b12211220011101111111110111aP010111111011111111011111110110111111101111111010111011111010
1111111111111010P110111111110111101111111111100011021022122122221002022a10102020111111011111000010aP110101111100111001101101101111111011111011111100111111101001
1101111111101111P111011011111111111110111111111101112211021111112100022b12112022101111111111111101aP011111011111001101110111111001010110110111111111111111111111
1111110010111101P101111111010011111111111101011012111221001101211111221b21122212001111111111101011aP011111111110011011011111101011111011111111111111110111110101
0111110111110111P101110111111011111101101111111012111022112121121101102b12111112001111111011011111aP110111111111110111111100101101101110111111001100100111111101
1101111010011011P111010011111111111011111111100110122121221211221222111a11122202111011111111111111aP110111010001111011111011111010100101101111111101111101111111
1111101101111111P101111111011101010101110011111111211202202100112220222a22020022111000101111111111aP111101011011111111110111111111101100111111111111011111011110
1110111111110110P111101110111111111010111101111112211101202020121221121a22220121110111011111101111aP011011011111111111111101111110100111111111111111111111111111
1111111111110111P111101101110011110011101111111011112102012022022112211b21022000011011110111111111aP101011111111111111110011110111111111111111110101111100111111
1111111101101100P111111111011110110111110111111100212221102121112012120a20220012101110111011001111aP101101111011111111111110111111011111011111111101111111111111
1111101111101101P101101111011111101110110111111112221202110121011121110a12211121101111110110001111aP111111011111111111101101111111011111110111010111101100111111
1111100101011110P111111111110101111111110110111010212222101121120112222b12000022111111111101111111aP101110011111111111001011111111111011010110111111101111111011
1101001111111111P101110111110010111110111011111111101111111111101111111a11110010111101101011110011aP111111111101111100010011111101111111111101111110011111011110
1111011101111111P110111111111110111111110111111011110111111111011011111a01101011101110111100101111aaPPPPPPPPPPPPPPPPPPPPPPPPPPPPPPPPPPPPPPPPPPPPPPPPPPPPPPPaaaaa
1101111110111100P011111011011111111010111111101111011101011111100011111a10111111111111110011111111a00101111100001111111010100111111101111011101111111101111P1111
1011111111100101P111101111111111110111101111101101010110011100101111111a11111111010111110111101111a11111111111111221121121112121112122211012101111111111111P1111
1111100101111111P111101011110011100110011111011111111111101101111101110a01111101111111111111011111a11101110110110221101221120201120122201111111111111111110P0010
0111100111111111P111100001111110011101111111111111101111011101011101110a11111101101101110011111111a10101011111101221221112121210202021222221101011101111111P1101
0111111111010111P100101011111011010111111111111111111100111011111101111a11111011011011110111111111b20202120211122222102222222221110122212211221111101101110P1010
0101111011111111P100111111011111111111111121222212211222020011121022020a01111101111111110111111010a12212022012221222222222222222121010011120111110001011111P1111
1110111111001110P111011111111101101111111111101112110112211221212212122b11110101111110111110011012b0211221121222222222222202222010221212200122111111011111111111
0011111111111111P111111111111111011110111200120102212021122202220122121a10111111001101111111111111b2111211211221222220222122222112201110110100111111011111111111
1011001111111111P011111111110101111101011012101101212121111222211221012b10110111101011111010111112b1122120222211222122121112020100221012211122111111011111111001
1011111001111111P110111110111111111111111121221211111121121210202222222b11111011101111101101111120b0122211121112201212221222220120120111111121111111110111110011
1111101101110111P111011000111111111110011121122221221012121212101122221b01111101111111111111100121b0112001110102000222222221121121012121122110111011101010111110
0100111111111001P111111111101011110101010110102100101200001112001221122a10100011011111001000110111b0122202200122012220120022222211211202122001111101111111111011
0100110111101101P111111110111111111111011201021222112211211202201010012a11111111101111111111110112b2112112101221222112200212222011221221111020111011111110110111
1111111111111010P111111111110011101111101212211112012222202201121211012b11111011011111111111101121b2202002221101002021001012020212112212212110101110111011111111
1100110101110111P111111111101111011110101101112220121221222110122222202a11001101111010111111101122b1212212212002212122021122221112122220212212111111111111111111
1111111100010111P011110111001111110101011121222201110110111220222221101b10111110011101111101011111a1021011210121122222211221222220212001221200111101111110110110
1111111111111110P101011101111101101111100221122100210210221110222021212a01111111000101100110101111b1211121110020022020222221121212121212212211101111111011111101
1110111111011001P111111101110010111100101011220011222001220202122022222a11011000111111110111111110b0221111010122202221221211222102201112221122111111111111110010
0101011011111111P111111000110110101011011212120211012120221112212011211a11011101011001011110110101b2120022102002121212021022220011220222200211111111101111111111
1111111101101111P010111110111011011111110221121212001012121202212221210b11110000111001111111011121b1210222222022021121222121022111012221201212111011101101111111
1101110001111110P101111101110111111011111122111101211101200020200021202b11100110111011111110111122a2102100222120220022222202220121211112100212111010111011001111
1100101111111011P011111110101011110111101220211111120102221220222222012a01011111111111110111111112a1000122222020222222022022212012221001211012111111111111111111
1111111111011111P110111111111111111110101212022221220112111010222222102a01001010111111001101111120a0221202202121222211221222222100121021112122100101011111011011
0111111111010011P111111111011000011011110111222212122111121220111122111a11001101110111111111111011a2111121111012221121210200222112121202111102111011111111111111
1111001111111110P011111111011011111001111112002011110001222012022212110a11011111111110110000111012b1210121121202021221222022220021110112222020110111111001111111
1111011111111110P111110111100111110110111112112021122211212210121210110b10100101110111111111001111b0222000120011220012102222200201022102122112111111111111101111
0011111111111100P111100011111001111110111201212012212100200122112110122b10011101111111111111110110b1111121122102000212110222122201120112120212110111111111111011
1111110010100111P101111100111011111101111122211202021110121111012102101b11000111101111100010010100b1211010121121221221212222220012111122121101011111111111110101
1111111111111111P111111101111111010111010222201211011120101021021021221b11111111111111111011111111a1222212221110222022002002122122120212112110111010001111111110
1111011111111101P101111111111111011011110102202210011210110112110220101b00110111111100100101111122a1122121112211011222220121221111121211212202111111111100111111
1011111111001101P011111110101111011101101111011212021111101222111221221b11111011111011011101111110a2221211201212020120022022222112221112112210101011110111111111
0011111011101101aP11110111101111111011111211110110111112120111122111221a11111111111000111011111111b1002221002222222222022222101211211201210222111111001111110111
1111111111101001a111011111111101111100111212210101212212211001022221210b11011111100111111110100112b1221211111122011110111101010111111111111101101111101101101110
1101001011111011a111111111111010111011110212010110220212211211222111221b11011111110111011111110100a1100211112211012122112122121011111111110111111111111110111011
1110111111110101a111110111110111111001111112112222111121222111222220111a11111111101011111111011011a2220112110112221012212201222111011111111111111101011011111111
