5 70
150 79
122 49
126 101
64 67
119 18
56 105
111 104
8 43
26 34

1111111011111111101111111101101011011111110101110110111111111000101111111110101110110111111111111011a11101111011111111011111111111010111111011011111111011111010
1110110111111100111010111011111111011110111011110111111111100101011100111111111111111110111101001111a11111111101101101010111001111110110110011011100100111011111
1110010110111110111011101111111011011111101011101110111111111111111111111110111111111111011111111101a11101111101101111111111111111111111111101011101111111111111
1111010111111110101110000110110111111101001111100111110111011111111001110101111111101111010011111111a11111112122222002122121012101220210111110011101111111010110
aaaaaaaaaaaaaaaaaaaaaaaaaaaaaaaaaaaaaaaaaaaaaaaaaaaaaaaaaaaaaaaaaaaaaaaaaaaaaaaaaaaaaaaaaaaaaaaaaaaaa11121202111122211102211221102112100110111111111111110110111
1110110111111101111011111101111111101110101111001101110111111011111111110101011111011111011101111111111012222020211121201101121221000201011111101101111011111111
1100111110111110101011111111111011111111101101110111111111111101111111110011011111101011110110111011111021111122121221121110210110120121111111111101111011110100
1100011111111111111011110111111101011111011111110011111111111110111111111111111101101101111110111111110122212011021212211022212121111111111010111110111110011111
aaaaaaaaaaaaaaaaaaaaaaaaaaaaaaaaaaaaaaaaaaaaaaaaaaaaaaaaaaaaa101101110111111010011111111111110111101100022110101220122200210201121122201111111111111111011010110
111111111111111111111111001111110011111111111111110111111101a110111111111111101111110011111111111111111121210202221111121121011220121110111101101010111101011011
110111011101111111110111101011111111111101011001110111011111a111011111111111111011111101110111111101111020211120122020111122001122102101111111001110101111110111
110111110111111011111111111111111111111111111111011010110111a101111011111111111111101110101111110111111121121211121211122121022020011121111101011111111111101111
111111111101101110110111111011010111111111111111111011111101a111111110111110111111101111100111111110011122121212212022012212010101111210011100111011111101111111
111111111110111100111110110111111101110011111111111100101101a111011101011111111111011111111101110011101021212122211222112210220210122120111101111011011100111111
101001110110111101101101011011111101101111111110001111111111a111111101111101011101110111101111111111110110121202102111022122211221112101111011111011010111111011
111010001011111111011111110111110111111111111111111010101011a111101011111111111110111111111110111111011111200010012222111021221120022101111011011111111100111111
111111110111101110011110111111111111111110111111111111110111a101111010100110011010111011001111111111101101112010222200111101222102111221011101111111111100111111
110111011111111111001111111111111111111111011101111111110011a101111111100111111011110110111111111101111120221112021111111122121221222100111110111111001111001000
111101111011101101111111111001111111110101111111111111011110a011111010111011111110111111111101111101111111210221111220121102121120122120110111110111111111110101
111111111012221022121021221211212120011121111111101110111001a111010111111101111111111110111111110111011111002222111121111112102112101101110111110111011111111101
100111111112022111100021121220221112222111111110111111111101a111111111111011100010011111111111101111111120212011202002112120211121020110010100111001101111101111
111010101110212202022212122112211122100212110111111101100111a111110111111111111111011111111011111111011122102111222002022222110210211211111101001011101011111111
111111111101111212211202011111122122122012111111111111111001a101111111111111111101010010101101011111111111221111201200222210210121101101110110111111101111111110
010110111011102212112121021112202111012211100011111101101101a111100111111111010111111111010111111111111112212111122221202110112112222101101111110111011011110001
111001111112220122121122101111112012211022110101111111111001a101101111010011101110111111011101101111101112102012110222021111221111122121101011111111111111010110
100011110110120121122110101212210001120012011011111111111111a111000111011110111011100110111101011111111121120221011111102022110011221220111111110111001110111111
111111100012112111110201221122212012102021011101111111011111a111011101111110111111111111111111111101001101202112221210012212202201122011000111111111101011011111
101100111112221022112200211111201111101122111011011111111111a101111011110111111010111001011111111101110100211110022201112120122111122211011011111101111111111011
102122021112222022221002221222212220201211111111111111111111a111101110111111111111111111101111111111111012210122101212211120111011211121111111111110111111111110
012212021011110002121222010220212100212111111111111110101110a111111111111110111111101111111110110111111000121212201222221112121122222101110111101111111111111101
202012212212021121122222221212112100202221011111110110110111a011110011111111000111110110101101111111101101220011211211121211121010120221111111111001111111111011
012022121110222222212122021122201111122121111111111111111111a110100101111111010111111011111111010111011112211121112012121121101011202011111111111111110011111101
111211111211112212022122221120201002221200101111001111111110a101111100100111111110111111111111111111110112212121202221110211121120201121011011011101111010111011
020012001002221220222222002222202220110022111111111111111101a111100101111101110111111111111111111111110101211211200112012021022122110210111111110111001011111110
101112221222212222002221222212211210211110011110111111011111a111101111111110101010111111111110111111100111112111022211122100122221120201120111110111111111111011
122101002112112121221221222222212220112101111101011111110011a111111111110111111100011110111111111111111110122022001011222212211221121210211100111111101111111101
21020212121222211202bbabbbababbaaabbbbabb0011001110111111011a110111111110111111011110110111110111110111110122201210011212112001000111101021010111111111111011010
12221001020022010222b0210221212210222112a2011111011101111111a111111111110111011111001111111111101101111101110011222221122020020110101122121110111111101011111011
22220111011010222222b2020222222110202022b1111111111111111110a100110111101111111101101011011111111111011111021102121101220112110212120202211101111111111011111111
02220112210212022222b2201022122101221220b1011111011111111010a1111111011111111111111111111111111110aaaaaaaaaaaabaaaabababbbaababbaaaabaabbba101101100111111101101
20112122021220222222b0221222221201211121b2111111111111111011a1110111111111101011101110011110110011a111111011112220211220011112210022122102a110111111110111101111
22011211121221212221b2222020222200220120a1111101011110101111a1001100111111111101111111101001111101a111110110111121121210221122212012221120a111111110101101010111
22101112221202102122a1222122222211121010b2111011011111011101a0111111110110100111111111111111111011a101111112221221212021211220202022010212a111111011111111100111
00101110220110210022b2221220221221221222b2110111111111101110a1100111101011011110111010110110111101a111111112010110021101202220221222012110a111111011101111110111
22122222110220202121b0112222212101111221a2110100111111011011a1011011101011101111111111111111111110a111110112211112111110020101211221011110a111110001101101011111
22020211012212212212a1220000202000111122a2111011011011111111a0011111101111111111111101010111111111a111110110112101211122012121111121021222a110110110111111111101
20111022012010221221a2212122101222102112a2111111110101111111a0111101000011111001100011111101111011a110111112200001120222221122211112122112a111110111010111101110
12022112011112122122b2202222020212111010a1001111111110111110a0101110111110111111111111101111010111a111111111221002210110012211100211212001a111111111111111110111
12220011120222220000b2222021022122020200a0111111111101110111a1111111111001011111101001111111011101a111111112210212200210002111210212010221a011111101111111100111
21222112202212201121b1212221222220211221a0111111011111111001a0111110110110101111111111111101111011a111111111121202222202212122121101120210a111001111111111110110
21110211102201022202a2222010202111111111a1011111110110101111a0111101110011111111111111111111011111a100010100111201111210221011112212102120a101111111010101111100
12202221100221111112a1022202111100111010a1101111110111111111a1111011111010101111110101100111111101a111110101220001221010101002122121020202a110111111111111111111
21202111212120122200a2122110202110101101a1101111111211011122b2102012212111101011111111111110111110a110110101222122022222020202221121222110a111101011110111111111
21221111101210201201a2120111212101110111a1011111022110200211a2102002021122011020111111111111111111a101111110220222122221220221122212121102a111101011111111111011
01222222220122222111b2022211121010111111a1111111012222211120a2111102222121122201101111111111111111a010111101112102201122201221211021122012a111011111001101111111
10211120202011121110b1211121122111111011a1110111122222200111a1222120122220222112111111101111011111a111101101000211201201112221122110001201a000111011111111101111
aaabbabbabbabbabaabba2102122102111010110a1111111112000010021b2121110211220120200111111011111101111a111111112121002212022212020102122000221a111111110111110111110
2202012220212221221211122020022111011111a0101111102022220122a2212220222121222101111111011111011111a111111112221222011222212200012201102111a011111111001010101011
1020222211212212121212211101112111111111a0111111112212011221b1202112012122211112110111110101101110a110110112202222020111121111102121022020a111111111110111111111
1110111111100011101101111001111110001111a1011111011112212112b21002211121111210bbaaaaaaaaaaaaaaaaaaa111111112211011110211222010112212221001a010111101011110101001
1101011110111101101111111111110111111001a1011101101122012221b20220011210211211b11111101001111110111111011111101021112111222220022112022212a111100111111110011111
1110111111101111111111111101110110101110a1111010101111010012b12220221222112212b11011111111111111111001111111111112221221001022022110110112a101111111101111001111
1111111110111101111111011111111110111101a1111101022112012211b01220022121011222b11111100111101101111001110100111212012221222211222111211110a001110011111111111100
1111111111111111111111111110110010101110a0111110012110002112b21211020202120112a21111111101110101111111101112201202220100200011222121211101a010111011101111110001
1010111111111111111011011111111101111111a1010111122212122211a10120120212012211a20001111111111011111111111110011121222121202220202002201211a110101100111110111011
1110001111010111111011011110111110111101a1001110111111211210b01210110210110121b11111111101101111110011101111111111111111111111111111001111a110101111011111011011
0011001111101101111011111110111001111111a1111111122112212022b01111212201012022b11101111111111100111101111011111011111011101110111100111111a111011111111111111100
1111111101011111111111011011101111101111a1111110120112011211b12110011101221112b01111111111101111011111111101010011111110111111111101110111a010111111111111111111
1110111111001001011101111110011111101111a1111110020002222121b22222202122002101b01111111110001111111111111111111111011111001110011101110101a111101111111100011111
1111101011011111110111111011110111111011a1100010120211122111a12012022122110122b11111100111110111111111111011011110111110011111111011001111a111111101111110111111
1010111111101101110110111101011010111101a1111011111001101221a12122121210201111b21111111111011011111111101101001111011111111011111111111111a011110101111111111111
1011111111110111111101111111111011111111a1111111112021220211b00021211222112222a21111111110111111101110111111111010111111111010101111111111a011100110110111101111
1010101111011011111110111111111101110001a1110101122111012111a22110100002112221a11111111011111111111011101010111101111011110101111111111111a110111111111111111100
0101110111111111111110111111110111011111a1010110111220022121b22212101202112212a11111111111101111001111110111101111110111110111001111011101a111101011110111111111
1110111110101101101111111011111111110010a1111111122122220221b21210112112110111a11111011010111110100110110111110111110111111111111101011111a111010110111111111111
1011111011010101010111111011101100111101a1111110121002121122a10220122211211110a10110111110101111111111111001111111111111111111111111110101a011111001011011111111
1100010111011110011111111111111111001011a1110111120112101112a12011202122201121b01111011111111111111111111110110110110111111111011101101011a111111001110101111111
1011111011101110111111111110111110110101a0111111021202101212a12222111222100111b11011101111101110101101111101010111111111111011001110101111a111111111010110111110
0111010111111111011101111111101111101111a1111101101220012122b12211201211112210b11111100101111111111110111101101111111111111111001101101111a110011111101111011111
0000110101111111111111111111111111011011a1001111110122111111a02012102222220222b21111101111111111111111111111011111111100100100111111110001a111111111101111110110
1111111101101111111111110101110011111111a0111111021022211121b22001220110111221a21111111111111111111001101111111111111111011011011110101011a100110111111110111111
1110111111111110111011110111111111110111a1011111110122022011a02011222212122121b01101011010010110110100110111111111110111111111111111101110a011111110111111100110
1111111111111111111111011011111111110110a1111111120112212021a01212212011212211a20110111111111001111111111111111111011111101101110111001111a110101001101001110111
1001101111110101111111111100101111111111a1101111111111111011a11111100110111111a11110111111101111000111111111000111111011111101111011111111a111111100101110111111
1110101111011110111001101111110111100111a1111101111000111011a01011111111111010a10111011111100111111111111111010111011111111111101101101011a111011111101001111111
0111100111110111111111110111111111101111a1111101010111111101a11101010111110111a11111011111011110111100110111111101001101011111010111011111a110111011010111100111
1111010111111101111111111111101111111101a1011111111111110110a11111111010111111a01110111111110011111111111111111212212112111210212211202122b221111011100111111101
1101111111011111110111111110011011110111a1110110100111110101a11111101111111111a11101011011100111110011111111111111221211211221210211021001b211110001101111011111
1110111101111010111110110110101101011011a1100101101111101111a11101100111011110a00111111111110110111111111111101110120200011011110122121110a120101111001111111111
0010111110111011101111110011101101101111a1011111111111110111a11111011010111111a01110111001111001011121120112112222202201010222201110121122b201111101011111111011
1101111111101110111111110001110101011110a0121212202122212211a20121011212101111a10011111111101011222001101211222022222122222221210221121010a202011000111100111111
1111010111111111011110011111111111101111a1120120221002211211a20111112010111011a11101111111110111201201222101211202222222122221221212221122a120111111111101111101
1111011010000111111111111111111110111110a2212120112122222011b22101110212011111a00011111110111111100021222120222222211222202212221112110212a212111101111111110111
1111111111110111001110111110111111111010a2211211201202011220a00211121220011111a11110101111100111121001221222222222222212112202220122211100b201111111010111111101
1110101111111111111110111111110010101001a1111121102221220222a11022220211101111a00111110111111110020222211211222022212222222222212200012011b112111010111111111110
0110001111111011111010111111101111001111a1112112100121012002a22121121112110111a11111011111111001110201210200221022122002202122102222011202b202111110111101111100
1111010111111101110111101011111110111111a1211200111211212001a11022211202110101a11111111111001110011202211212121220200221221210210011112120a220111111001111110111
1111111111011111101110111111111101111111a2202102112112211122a22112211210110111a11001111111111111212212012121212221202022201122121210111102a212111010111101110110
1110101010111111011111111111100011111101a1200012001211211120a21021110212011011a10111111111111011022102220212101222002011222110210122112212b011110111110111111111
0111111111111111110111011111111111111111a1212201011120122211a11012221110110011a01111111111010011122100211022200011212202210222212122200122a102111111111111111101
1011111110111011111111111011101111001100a0210211001101222102a00221111220111111a00110011111101110110212110212122222122012220122021002111121b120011011101111111101
1111011001111100101110110101111101111111a0112120011112222201a02202100112110010a10111111110111100122222121121021220220120222211210102212102b010101111011101110111
1111111111101111110101111110111111011111a1210222222222122202b21212200111101111a00100111001111111102021022212200022022021222220012221220222a002111011101011011110
1111101011011111101110011011101111111111a2220111101211111111a01121012221111101a11111111111110110111121122022120002222222022222002122121222b111110010111011111010
1101011101111111111111111111101011111110a2222112121210122121b12111102112111111a11110110110101011212200111200201012012222221222121122110121a021111111111111111011
1111111111111111111111111011111111111111a2121121112100210022a20212111111111110a01011110111111111202210111020201220221102001222200112212212a122110111011011110111
1111111011101011110111011101111011110111a2222110122110010121a22012221121111111a10111010110101110111201102112222222122012100022201111121202b111010111111111111001
1101111111110111111111111111111111111111a2021212122201012011b20222101112101111a11110111111111111221221221201220111021221122100211222102121b012101101111011111111
1101011011110111111111111011111101101111a2210121012002011120a21201110210101111a11011110110111111011200200022222112222211202021221212100111b212111111111001111010
1111011101111111111111111101111101011111a2112111220211100202b21201110121111101a01111111011111100121100101212121222202020222222022102101222a120111111011111101111
1111011001111111101111101011111111111111a1212212101000122111a02221212021111101a11101100101010011000112211120112222122212222202221202212211b221010111111011101111
1011110111110101010011111110111111101111a2022121211111010000b11111122001111111a11110101110111111220111012101101221211222220002002020212102b012111111111111011011
1111101011110011111111101111110111111101a2221220221220102101b00212021010110111a11001011111111101211121112012212222202222212200212222101111b120111111111001110111
1111111111011001111111111101111111111011a1112021212100220012a10210202112111111a01111101101111110020102001212102200220221001201222101022012a122111101101110111111
1111111111111011111101111101011111010111a2021010221201212112a21210112111111101a11110010101111001211022012102122222020021122202221010110210b101111111101101111011
0111111111111111111111111011111111110111a2121212122112222212a01220202022111101a11011111111111011101122112122212121020121222111202222111110b101100011110110111111
1111101110111111111001111110010011111011a0111212001121211012b12002211122011111a11110010011111111121212111221101220112020221202121002022211b121010101101111110111
1101101101111011111101011111111110111101a1220210010012202111b22111012122111010a01010111100110111010102122002122102112120011112111111111110a111110111110111111111
1110111101111100111111110111101111100011a2021011112222101221a22102122112111111a11111011111111111220020122221210001101110222212111101111111a111111111111111111011
0111111110001101100111011111110101101110a1122120210211122111b22110111212101011a00111111111111111122101221020002021220122220211111111111110a111100111110010111111
