153 13
130 109
122 49
126 101
64 67
119 18
56 105
111 104
8 43
26 34

011a0111110111100111111100111111011101111111110a111101110011110111111111110111111001111a1110111110111101111110100111111a1001110111111101110111111111110110101111
111a1111111010110111101001111101111111101101010a111110111110111111111111111111111111111a1100111110000111011011011111111a1111111110101000011110111110011111011111
110a1111110011011111111111111100111111010101111a011001110011111110010111011111111111110a1001110111011111100011111011111a0111111011101111011111011110000011110001
111a1011101110111110111011111101111110111101011a011011110010111111000110111001111111111a0110111111111111111220222122221a2122121121111021011011111011110011110111
011a0111111111111110101101100111101011111111111a110111111101111111011101111111110101111a1111111111010111211122220211011a2212212211102111111110111111011111111101
111a0111111110101111111011111011011101111111001a011111111111111101111110111101111111111a1111111111111111221020202101012b2220120221222220111110111101111101111101
111a1111111111101011001011101111111110110111001a011101010101111111100111111110011111111a1101111111111011121021212210111a2121011221102111011011111111011101101101
101a1111111111111100111010111111111111111110111a011011110111111111010111111011111001111a1111100111001111011212211121121b2102021011121210110101111011111001111010
111a1111101111100111101111101110011110111111110a111110111110101101111110101110111111111a1011111111010111001011112220221b2212202221202121111111110110001111111111
111a1110111111111111111011111011111011101111111a111111011111111101011111110110111111111a1111111111011011022112022111012b2112121112211221101010111110111111011011
100a1111111110011111111111011110110111111111111a100111110111011110010111110111111011111a1110111111111110221111121200100a2122021122121120111111111111101111011111
100a1010111111011110111111111111111111011110101a111111101110111110111101111111110111111a1111111011111101101120120212012a2122122212202201011111111101111111111111
011a1101011100101100011111111110110110110111111a101111111010110110111111110111111111111a1101111111111011201100120120101b1122012101211111111111110010111110011110
101a1111101111111111111110101111101010111001111a101011111111110010101111001111011111111a0111001111110111102120211021012a2211110122111121110111111111101111110111
101a0111111111110110101111111001011111111111011a111011011111111011110111011001111101011a1111110110111110120122111111112b1122211122122211101111001111111101111011
111a1111111111110111111110101101110111111111111a111111111111111100111111111111111111011a1111110111111011122221112212111a2021220222110020111101010101111110111001
111a1111011111110111110111110111111111111111101a111111111001011011110111011011010111111a1011111110010011121222122001120a2012020122221201111111111111111101100111
111a0111101111111110111111101101111111110011101a101011110110110111111110110000111111100a1111111110101101001121221212212a0112222120011201111111111111111011111101
111a1111100111111111011011100111111001111111111a111111111111110111111011111111011110111a1111111101011110211222112121010a1221221002120210111101010110010010100110
101a1101111201202212110021212111020201222210111a111111111111111100111111111111010111111a1111111101111111222221112121111a1221212102212121101111111111111010111111
111a1101111002112120020111011211111212111211111a111111111011111011101101010111111111110a1111100101110110112010111221201b0111111121111001110111101111111110100111
111a1110011111112122211111202200212120221200111a011100001101111111011110111111101111011a1111111111101111222120210210010b2112101021112121111111110011111111110111
111a0111011201202122022110111212210222102211111a100011111110110011111111111111001101110a1101111101011111112102011221221a1201212121110221011111101111111111111111
111a1111111211220121001111021222110122122111111a010111001111111111110111111111101101110a1111011011110110122010220121221a1211112211122221110111111111111110111011
110a1011001101122010002112211100201112202210110a110011111111111111111010111111101111101a1111111101111110120122220111121a1201111212100111111011011101111110110011
111a1110001211112201101021000101001012102201111a111111101111111111011011111011111111111a1111111011111111121200101222211a1200211112111211111111111011011111010111
111a1011011021211222222012112101211122210011010a011111110111111101111111110011011111111a1001111111111111212122200221112b1122111220211021001111111111111111111110
011a0111100212022221202122211110112221122101111a110111011101111101111111110110110110111a1111011100111001212021222121212b2212202110201220110111001111111110111010
122b1211110212222222021222120222221000211101111a111111111111110111110111111111111101111a0111111111111010112202202222110b1101221121221121111101111110111110111011
222a2111200220222222222002022202022120121211111a111011101111111011111110111010110111111a1011110111101011012121012022211a1221120212121011011111011001111001101111
220b0121122002221212222222222011122121220011111a110001101111111100111111111010111000111a1111111111101111211222101011021a2102100011011210110011111101111011001111
211b2100221122212222012022022021222202112211011a111111101111111110101111111111101111111a0111011010111111101120001222202b1022022011111211111110111111111111111111
020a1202110022222200120222212021011222102001111a111110011111111011111101111011111110101a1111010111111110110221022212222b0110120121110121110101111110101101111001
122b1210000022000020221121220221022121012011010a011111111111111101111110011110111111111a0111001111101101222221200210210b1111221101121221011111111011111110111110
110a2111212202221221122222021022212120202111111a101011111111111110011111111111110111001a0111110110110110111221011102201a1020111112020211011101111011111111111111
122a0022121222222201200001222001212112221011111a101011011110110111111111111110111011010a1111101111111111001121202111102a1202111120212022210101111111111101000111
112b2122221222222112212122022001211110102210101a111010111111111111011011001011100111111a0111111010111110011202021010121b2112122211221222101111110110111111110101
202b2110212021210112202102221121101001111211111a101111100111111100111110111001110111111a1111111111100010111110220201121a0211212102112001201110111011111011111011
120b1101012212110222221222220222212222202211111a111111110101011111111110111111010111111a1111111111011110111102221010222b0222210111201111121101110111111110111111
112b1201011022220222102110022202001221110111111a010111111111011111111101111111111111111a1111101101110111110222021210122b2112022112100210121110111111111110111110
111a2212222222222022220202101201022111122011110a001111101010000111110111011010110011011a0010111111101111101102211111210b0111201201121101101101110111111111111111
012b1102122221022212021212202221121012102210111a111111111111111111111111111011111100111a1111111111111011001012122112221b2211120002022211111111111010111111111111
212a2221121120022022222222022200122122122000111a111111111110011111111111111110110111111a1011111010010100111120022112110b2222022010012101021111101111111110111111
122b2202212210212222012222222222112011121101111a010101101011111111111111111111111010111a1111011111111111111221211012121b1110002221011122211011111011111110110000
121a1222111222211222210002220021110120210011111a111101111101111111100100111011101111111a1010111011110111110221111111111a0222110210212010211111111111111111101010
202b1021112222221122022222210210210222212201101a101111111011111111111111101111100001111a0111111111110011011101112012001a2210121111022000111111101111110111101101
221b2220112212222122012222201220201111012211110a011111101111001100101100011111111110001a0111101111111101011221202122100b0200121211212221111111011111111001111111
112b1112220222221102120211222200221120021111111a111111111111111101111011111111111111110a1101101010100111111121122122111a0020222212020122110111011110111111111011
121a2022212222222212222211221222111022101211111a110111101111111111111111111111111111010a0111111111110111111112212222101a2202201211201112211011001110111101111111
212a2102012212222222122221112122121211021210111a111001101111011111011011111011110110101a1111111110111111111200011212121b1201121221011221221111111111111111011110
211a1110012022201121202012101211101110111111111a111111111111011110101110110111111011111a1011110110101011111112102221022a2110101210121122021111111101111000111111
220a2022111200000112200200022201110111110101111a111111011111111110111011111111111111111a1111111111111111101102111211222a2121202121211122121110011111111111101111
010b2212121211202121102001110121111101111101101a122220101211202222121122122112021110101a0111101011010111111001202111002a2020100221211120221110101111001111111111
222a0210000111121220212000221111010111111111111a102021012022111012201012122102021110111a1111110111111001001112120022221b2021101221001101220101111111011110110011
022b0212202220211112110111222021111010101111111a012222211222220221112121100220121111011a1111111111111101110210211010210a2101022022122222201011110011111100110111
201b2012222111022101122120201201111111111011111a101011221012112222221122110022221111001a1111111101111111011101121212211a0220220211210212121011111111111001111100
210b1121102210211221122212011110111011111100111a110212001122221212012220201222121111111a1110100111111111111212101120211b1112211021011122020111011110010001111111
121b2101222012211102012002211221101011111001110a122121111022121222122222212212011111011a1110101011111011111002111222121a1200121212202001211101011101111111011111
122b1211020202021101211100112111101111110111110a112020211001211110212021111220120111111a1111101111100111111211022212221a2012121222212202120011111111101110101111
110a1110111111110111101010111111001111111111111a102022121221221222122210121211201101110a1111111111000111111001122122202b2211111211112202220111110011111111101100
110a1011011111111111111110101001111111111111101a102212021210221112212201211221021101110a1111011110111011001111022110112a1211222111021202221111111111011111111110
111a1111111101111110011110111101010101110110001a120122011112121201221200221012221010011a1111011010111111111220222002222b1010121201212212211110111111001110101011
111a1101110111111111101110111111011111011111010a010210212202112112111022201222111011111a1111100111010111111211222022111a1210112122221012211111011101111111111111
110a1111111111111111111001011011111111111111111a111100110021011120010212212202221111111a1011111101110011110000012010222b2022102202111111021111111001111110110111
111a1110011101101111111101011101101111011101111a111121211201221222122122221122120111110a0010111111010111100211122000110b2121221112121102121011110110001111110111
111a0111111111110101011111110011111101100101011a120212201012200101201111222222121011010a1110111111111001001111011111111a1111111111111110111111011111111111100111
111a1101111011111011111111111101100011101111111a101121221122221200222222122110221111011a1111011111111111111100011011101a1101101110111100111001111111110011111101
111a1111111011111111111111110111001111010011111a101221212021222202200122112200011100111a1111111111011101111011111101110a0111110101101010010111111011111111110111
101a1110111101111011111111111111101111101001111a111220122011020210100112121020001111110a1101110111111111111100111110101a1111111101001111010100111111111111111111
101a1101111111011101110001111111111111110111111a022112112221122122212101220001211001111a1110111111011111111101011101111a1111111110110011110011110111111101011010
001a1111111111111011111110110111111101110111010a120110211112222212211110020221201110111a1101011011010110111111001101110a1011011111101100110101110001111011111101
011a0111011010111111111111101111111111111111101a110112220222222121222112111111221111111a1111100111101101111101111111011a1111100001101101011011011111111111111111
111a0110111111111111111111111101111101110110011a122212200221120201111111011202210111111a1111111111110111111111111111111a1101110111111111011101101111111100111110
101a1101111111111111110101111111101011010111111a111222111112021222022222222012221111110a1111011110101111101011101110111a1111111111111111111111111111101101111011
111a1010011110111110100110111111111111111111111a101222121110021201221222201011110101111a0011111111111011111011011011101a0001111111111110111111110111111011111101
111a1111111101011011111011111101111111101110111a012202111222210020011022122202010111111a1110111110011111111110111111110a1001111111000110101111101100111111111111
111a0010111111110101011111111011111101111101001a011222211101201202122012112212101010111a1011101011011111111111001111111a1011111100001101101111111111111010111111
111a1111111110110111011111111111100011111101111a120002202122211100222201220211010111111a1110111111101011011111111111111a1111111110111101111111011111111111100110
111a1101111111111101111110111111111111011111010a111022222120111212122212202110111011111a0011011011011011111111111111111a1111111111111001111101111111111111111111
111a1111111111111111111111111111110111101111101a121212010001111112101202020202221011111a0011111111111000111111101111001a1111111111111111111011111110111111100111
010a1001101111111001111111001010010011111111101a010111002022110222112202201212001011010a1111011111110111111111111111111a1111100111111011110011111111111111111111
110a1011111111111111111111110101011110111011111a112010122112211212022222020100121111111a1111111111011111111111111111101a1110111111101111111111111011111110111110
110a1010111111101111111011011111111101110011111a022212120112122010221122202212120111101a1111111110011111101101110110111a1111111110111110011111111011111111111101
111a1111111110111101110111101111011111011110111a111111111110111111111111111010110011101a1111111111111111111111111111111a1011111111111111110111110110111111010100
111a1010101111111111101111111011110101111011101a101111111111101111111101101111111011111a0111011110111011101101010111111a1011111111111101111111111111011101111111
111a1011111110010011111111111111111111111101111a111011011111101111111111111010100100111a1111010111111111100110110101111a1101111111111011111101011111111111111011
110a1101111111101111111101010010110110110111101a111111110111111111111111001100111111011a1011111111111111101101122202111b1222210112112122211121111100111011001111
111a1111110111001111110101101110111111111101111a111111011111111011111111111001111111111a1011010101101110011011110222221a2020101022221011222121110111110110000111
101a1111011101111001111111011011111111111111100a101100111111111111111111011101011111101a1110011111011111110111122112222a1021102111212212212212110110111101011001
011a1101111111101111111111110111101111011011111a110101111110101011011110111111011111001a1101111112111112021121112222212b1220122102222011202122101111011111110011
111a0111001111110011111111011111101011111120211b120200210221210222021001111011011111111a1111011121112111112022211002222a0021221212212110010111011111101010111101
111a1111110110110100111111101111011111101200121a102012120210220112002010010110111111100a1111111122111120222122220022102b0222220211012122200212011001111101110110
111a1111010111110111111111111111011111110010012a200112222101220211011210111101101100001a1111111112220000212211222111221b2222211122212111220100111110101111101110
111a1111101011101011001111101111110111111220122a200122121121020101120211101111111111111a1111111112101121120202222222221b2112221210222122221211011101101111101110
011a1011111111011111111100100111101111101001122b221222011111222120202120111111101111011a1011101111201212111021222222221b2222220202220121101102111001111011101000
111a1111111111011111110101111111110111110012101b122221222112122022222100111111111111110a1101101102211012100122202212212b1222210210211120120111101111110111111011
111a1111111111111111110011111110111110111112220a022211111220201101212221011111101111110a1101111111020111221222222202222b1201002002212111100112110111011101111101
101a1110011011111111111011111110111101100122111a011201111010021122212010111100010111011a1111101111012221121221010021122b2002122012221211011121111100111111111101
111a1111110111111011111111101010001111011101021b212202201211222201012122110011101110111a1111111122221200101121110220222b1220102102122211011001101111111111111111
011a1111111111101011111111111111011101111022220b112222021202022210110222111010111111111aaaaaaaaaabaabbaaabbb11102220222b2222221011212022122122110111011111111011
111a1111101111111011110111011110111110111022121b10222220112222001212201211111011110111111111011111221212102b12100001120a2220112121112222021222111101110111111110
110a1111101111110111010111110111101101111122120a12201121100212211202001211010010111011111100011111021022112b11011112210b2220221002120121002002110111111111101101
110a0111101011111001011111110101111111110122011a21120112222102220122022111011111101111111111101102212221201b21122201110b2202211120221222221122111111111101111110
100a1111101110110001111111111111001111110222022a11120210001220122111011011001111101000110111111122211102201b00220122222b0212220012122112122212111111111011111111
101a1111111111101101111111111111111111111120121a12121120210100202222121000111111110101011111111110010001212a02221012020abbabbbbaabbababbbaaabbaaaaaaaaaaaaaaaaaa
011a1100111111111111111110111111111110111021110a00211022221011022011212211111111111001101101001110211122012a1212222102212221112112121120222220011110111101110111
111a1111010101101111111010111011010111111210112b10201011001012012111222111111111101111101101101011211001022a1220222020122120211002110221111022011111111111110111
111a0111110111111001111111110111011011111010122b12211021000111222212011201111110111111111011101122011221211b1102221220222211101111022022221110111011110111110111
110a1111111101111111001111100110001111111121120b02001121121222122212122211111101100111000110111122111020112a1000021221202202112221201002120212010111110111011111
111a1111101111101111111111001111111110111201211b11222202111002121000211011101011101010111010111111221122221b1121122222202222222221122102211222111011111111011111
111a1111011111111110111001011001110111111212102a21221100212102221101112210111110101111011111101112122201201b2122122220122022121221210122222110100111111111101011
011a1101011011111111011001111111111111111101221a00111111111221112120201111111001111111011111001120022020212b1222122022212221122102122020221102001111110110111111
101a0111111011110111111101111111111111111120201b12211121122011201221202211011011111111110111011012111212021a0011222210222100022111211210021120111111000111111111
111a1111111111011111011111111111010111101111001b20210201221202111212112111110101011001101010110102201112212b0222022122122201010210212020121112111011111111111101
111a0111111111111111111111100111011111111211121a22110210011112111211221211100111111111011011111112112110212b2012221021002200221222110111121210110110111111101111
111a1100111111111001101101011111111111110211211a22200011202221220112222100111111111111111011111121101120212a2102221211022221222122112211122112111001101111011101
010a1110101111011110100011010110101100110222210a01202122002021122212111100110011111111011011101111202211211a2222120020112021202212102210011211111001011111111111
111a1101110111111110111111011111111111111021121b00021110221202121011111111100110100111111101110111222200111b1011011122220110120111111110111111101100101011011101
011a0100011111010111110111101111111101101221022b22212221121121220020000010111101110111111111111121121221112a1120202111121121100110100011111111111011010111101110
111a1110010001111011101111111111111101111122110a10200011111112210121102011011011111110011111100121112100212a0210112112221121120111111110001111111110101111110111
