1 21
158 108
122 49
126 101
64 67
119 18
56 105
111 104
8 43
26 34

1111111111111101111011110111111111100111a11101011011111010111011111011111011011011101101111111101111011011101011101011110111011100110110111111001111101110011011
1111111111110110111010111110110111011010a01111011111111111011110111111111111011111111111111111111111111111100111111111111111111110111110010101111111011100111101
1110111111101111110111100111111111011111a11111111011110100010111011111101011011101111111111111111111110111011111111011110110111101101111111011011101110111011111
1111001111111111111001111011111101100101a10111101111101101101111110111101001111111111010110111110110111120112210112201211212200022101101000110010111011111111111
1011111010111101111010111111101111111100a10101010110000111101101111010011110010101101111101101100011111110012111120212221112021111212211111111110101111011111110
1101111110101101100011001011011111011101a01101111111111010111101111011111110111111011011101111011111101111012111111122022002221220202201111111111001111111011111
1111001111111111111001111001100111000111a01101111101011111011111111111111001101111011111111001111111110111210212222022111122111122212210111111111111111101111011
1110111111111111011101111111111111110011a11111111111011111110111111110111101101110110100001100001111101122222011012221200222201212211020001111111011011110011011
0111111011111111111111100111111110111111a11110111101011111111111101111111110111111111111100111011111101112111221112021101220121002110121111110111111111101111111
1111101101101111011111011100011111111111a11111011111111111111111111101110111011111111001111101010111111121210202011222220111201211122221111100111010111100111111
1111111111111100111011111011101111011101a11110111011111100101111111111111111011110110111111011111111111002122120201110222210120112022200011111111111110010110111
1011110111110101111111011001111111111111aaaaaaaaaaaaaaaaaaaaa111111111100011110111101111011010111011010121011221110211022121221112201221111111111111111111111100
111111111111111111111111111111111111101111111011111111110110a111111111011011011011111011111111111110101121221011201122221222000101112121010111111111111011111111
111111111110111111111011111111011101001011111111101111011010a100101111110111101101111110111111111111101121112112211221221202221211121101111111101111111011011111
111111011101110110111111101111100110000111111011111111111111a111111111111011110110101101111111110111011100121101020122100122020121120121111111010111111101101111
100110111110101011010101111111111111111011111111110011111111a101011111111101111111110011111111111111111110222211221222112212221121122201111110111101111010111011
101110101111111111111011111101001111011111111111111111101110a101100011101011011011111101111111111111111120221122111212112220011212211221111101111111001111011111
111111111111111011001011110101101111110111101111011111101110a110111111110111011110011101111111111111011102121121210001210211222101210121011111110111001100111101
111111111101110011110101011000101011111111111011011101111010a111101110001011111111011111110011001110111101110222120211211112112121111011111100110011110100110111
111111111111201221221221110222020211220012011111111110011110a111111111111101111111011011111101110110111112021222222022011101122012012211111110111111111111101111
111111111110222111110011212121112022101110111110111110011110a111011011110111011011010101101101101101011101211122222211112200212111120211011111111111001111111101
111000110102010112120021111020220021021200111010111101101111a111111011110111110111111101010100111101111122001110222112021212102122210120111101011101011110111101
110111111111112122001122202122111110121102011111011111011011a011111011111111011111111111111010001110111122112202101122102002222212110101111111111011001111110100
111111111011112221211220121011122220122120111111011111111111a011110111111011111111101110111111111111110122022101112111011112201122121120110011111101110101101110
111111001111111112012221021011102112122221111111101111010111a111011111111001110011111111011101111111111121000212212120012222211212222220111111111101010111110110
011111111111201110112012102222111112120121011100111111111110a110111110111101100111111111111111111011110111011220122112122112122012011221110111011110010111101111
011111111112112222110112122022102102201121110011111111101111a111011100111110111111111111111100111111111101002112221110102222221121212101111111111111101011111101
111011101111102212212211220222111012002121001110111111101111a110111011011111011111111111111111101111111121111102012121121012212110212111111111111110111111011010
022111121112202222122222122221211211201222111111111111101101a011111110101101111011110111100111111101111102220122121122221211222112111010111111100111111111111111
200222220022210220222010002222212211121221111111111111111101a111101111011101010101111111111111111110101102112221102120112112222111102021101111010011111111111111
221002112112222021222220222022102111211211001001111111111111a101011111110111001111110111101101011111101101101122110121020112121112222111010111101111111111111111
202211211222010212222222002022222122111220011011111110111010a111011111111101111111111011011111011100111112211121102102222211112222210111101111110110011111111101
201100202120112222212221221011222112220211101111111110111011a111111110101111111010111111101110111101010112022121222012101102210221200221111110001011101111111111
211022112202210222222110022200211212221222111111111111101011a011110011111101011100111111110111000111111122021122212111011212211000111111011111111110110111110111
210111112211022112220202122221111211100002111101111011111111a111111111111111111111111111111111111111111110111202120221110110122121122021121111111110110011111110
222112222222211122022202210222221111102120101110111111111111a111111111011110111111110111110110101001111111121100212021221121022010122100100111101101111101110011
201110121012222222212102222121202212121122111010011110111111a111111011111011111111111111111111111111111011122212222122222110211111222112220000111011011011111111
210012211002221021122221122222222122112112111111111101111111a101111110111111011101111011111111011111111110101222112011112211112111010110210111101111111111011001
220222200222202222220112201002002111110120011111111011011101a111101111111001111011111111011001111110011011122001022012111212202122111221221010111011111110111111
020022100010222211022211201022210101000111111111101110100111a111111111111110111110111001110001110111111111010101021121212221112210222221211111011101101110111011
020011222121221220211211122222220202111211111111101011111111a101101111111111111011111011111111111011100111122112201112011021212202002112211100110011111111111111
121211112021212221012222212110022101100210101101101111100000a111111111001111011011111111101110101111110011111011200212011001010222121122111111111110101111111111
112010012212212122022220202221112011221211111111101111111111a110110110111111111110101111110111011101111111002211122110001221011112221210100111111110011110111110
221120112012022012121222222102200110111222010111101111111111a000111110111111111101110111111011101010010001122211122222220122121121212110111110111111111001111011
110202212120202122222111222100211112222121101101111011111111a111010111111111110111111011101001111111111101111201112012210212211201221011221001111111011110001110
021220012121222221221202101022222122221112111111111100100111a101111111111010111110111011111110110111111111122212022222202121212012201001220011111111011111100110
221121222202212222011122200222222112202222111111101111011111a101101110111111101101111100111111010011111111111110102122102112220102121222201111111010011011111101
002122112222221212222222200211221102001221110110111101111010a111111111101110011111111010111111101101110101122202110212111221222011211021121110011111111011001111
222020212110122220122001221021221001201110111110111101101111a111011010111111000010111111010111111111111010102202120121211211012101121011121111111011111111111111
112222122210201221222222222222211221001120011011110011111111a011111111101110111111111111111111111111000111112200101222221110021212120012121111100111110010111111
121001221212110112022120022010111101111111111101110111111111a111110011111111011111011111110110111011111111111211201101111101210112000112220111110110111111110100
aaaaababbaaaaaabaaababaaaabaaaaaaaaaaaaaaaaaaaaaaaaaaaaaaaaaa111111110111111111111111101110101100111010111102022211111201012111221122010111111111111101110111010
2201211200121222112121121000221001111101101111110112202111012222220112120201211211111111011111011100111111111211112220201121220021222111211001100111101111111111
2120202212211211022122101201112111110011011101101222100122211001111121121022202011111110111110110001101011011121212221111212201112221212010111101111111111111100
0122021110210112201200120212221101101110111111111211202222112102212210102202122211110111011011111111111110121211112021202112100022211110211111111101111011001000
2222012102121220220012221111221110111101110001110222222221112122102101122200212211111010011101101111111111011100101022102020222102221002221101010111111111110111
2212221121222110220111112120111111011111111011111200210100110110110211112120012211111001111111110011111011111022211221211121211011121020221111101111110010111110
2112202201001011200220222100202101101111111001011100110222122002110111122110102201011011011010111100101111121120021121212202022211100220101111101110101011101111
2112112021101002211111111211211110101111111111101211121120210201121211012110012100111000111111111111111111102112002022010221222221222102010011111011111101111111
11011111111010010111111111110111011111011111111002221012201012222112222222211212111111101111111aaaaaaaaaaaaaaaaaababaabbbbabaabbbaabbaabbbaaaaaaaaaaaaaaaaaaaaaa
11111111111111101111010111011111011110110111010112221120011012112211212112201111001110111111111a0100001101111112001101212122121211211212111111110110111111011101
11111111110111101111111111111101111111111111111111221011021122111202222000122212101011101110011a1101111111121222121020022012021112200101101101111111111110111101
01111101111011111111111011101101110111111100110111111222111222211221202211121212011101111111111a1110101101111212212112210111221211122111211111101111111011111111
11110111111110111110110101101111111101111111111011221110212011120112101211012110110111011011111a1110111101102110022012122021012212102012121011111111111101111111
10111101001011111111101101111110111101101111111110122201211211121110220100122012101011111111110a1111111111111011221100010002101200220112221111111111111101111111
10111111110010111111111111101111111101111111111112121111212120112210102212211112111111111101111a1111111111111111111011111111100111111010111101100101111111011011
01110111111100111111111111011111110111111111111102212221112101110201021110102202111101111111111a1111011111111011110111110111111111110111011101101111110101100101
11110111100101111111111111111011111111111111111111222212222211022201102211222201111100101111111a1111111111111111111111111111111111110010111111111001110111000011
11111111111010100101101110111010111011111111111112122111211122211011121122121121111011100101101a1111111001111111111110111101011110001111110100111111110010111111
01001111111111111111110010110111111001101111101010221220212102220211221112120211111011111111111a0111111111001111011111111101111110110101001111111111111111001111
01111100111111111100111101101111111111111000111111210122220022011222021011112122101111110001111a1111101111110111111110111111011101101111111101111111111110111111
01001111111111111111111111100111111111111111111102200121222201211021211112211202111011110111111a1111101111001110111111101111111111111101111111011111111011011110
01111110111111111101111111111100101111101111100112102120010210122122210112212212111110101100011a0110111110111010011111111111111011111111111001101111011110111111
10111011001111111111011111011111110111011011001111001221211122101022222102202201101110000101101a1111111111111001111111111010111111111110101101111111111111010101
11111111111011101100111001111011111110111111111111020211122222221012212212202102111111111110111a1111111111110111101011111101111011010111111100111101011111111111
11111111011111100011010101000011111111111111100112202012121012121212112111120022101111111101101a1101111100111111010111111011111101101111110111010111101101111101
00110111111110001111110111010111111110111110111110022212022011121021122220022210111101011111111a1111111011101111011111111111110111110101111111111111111000111111
11000111011011111111101111101101011111111111101000221112212121221221120011202221111101111111010a1111101111111111111110111001111111111111111111110111111111111100
01001111111010111110110111111111100111111111001111120120002210221121101211221221111111111111101a1011011111101111111111011110101110101111111111111111111011111111
0111111100111111111aaaaaaaaaaaaaaaaaaaaaaaaaaaaaaabaabbaaababbbababababbbaaababb111111111101101a1111010111101111111111111111100101111111110111101011101110110111
1110101011111011111a11010111111110111111111110101022202111202211212100020211212a111111111011111a1110111111110010101101111110111110111111111001101111110111111111
0111110111111111111a10110011001111111111111111111212211111102111122221222220220b111111111001101a1011110111110011111111101111111110100111101111111111111111111111
1011010111011111111a00111101111010111101111011011021112012020102222100221220211a001111111111111a1110011111110111111011110110111101111110110111110110110100001111
1111111111111111110a11111111111111111011011111111111101111101111101111111111001a110111101111111a1111011110100100110111011101111111001111111111111101110100111111
1110011111111110101a11011111111011111010111011111111111101111010111111011110101a111111111111100a1010101011111011111011101111111111101111111011111110111111111110
1101011110111101111a01011100111111101111011111111110000111111111111101001011111a011110011111011a1111111100111111111111111011110111111111110111111111111101111110
1111110011110110110a10101111111110111110111111111111001111110110111111111111111a111111111101111a1111110101111110211121121112020111121012010202001111101101110101
1110011011110111010a11111111111111111110111101110111111001111101111110011100101a111111011111011a1111110111111112212000211212101112111100011102111011111111110111
1101111110111101111a11110101111111111110110111111111111110010111111111101111111a111111111111111a111aaaaaaaaaaaaabaabbabaabbbaaababaabbbbbaabbaaaaaaaaaaaaaaaaaaa
1101111111111101101a01111111111111011101111110011111010011011110000111011111111a111111111111111a101b010101212212111202220202121210022211112011111111111111111111
1111110101011011111a10011001110111011111021111022111001021211001212021121100010a111111100111111a111a000211011100222221121220222201102201210111101111111111111111
1111110110111101110a01110111011111111111112112220011101201010201211210101110011a111111111111111a102b111012112222012021222202021211001202102222001100111111100111
1110101101111111110a11111111111011110111100211220110121211220120212220101111111a111100111111111a222a111112010002022222212212222111221220010212111101111011111101
1011111101101001011a10001111011111101111111021122212002202222122121121221001001a101110100111111a120a102221110211220200121222222110011011220112111111110111111111
0111011110110111101a11111111100111111111111201001222121011121120210122210111111a111011111101011a122b011112122222121022222120222021222220122221011001111011111011
1111100111110111101a11111111111011110011002122012112000111011221121021121111111a111001110110011a121a220122002122212222222221211122002212212211110101101011011111
0111011011111111111a00101011100111111111112212211221111022002120201210111111111a101111111101111a221b212110122222021222021212222212210202102011011111010111111001
1111111111101011011a01010011111111111111101221022121202102220212102021211111111a111001101011111a222a112121222212212221112011112212122210010111011111111111110111
1111111110101110111a11110111111101111110121211001010212012211120112101021111011a111111111011111a001a110101122202020010202221002222211102111201101111111111111111
1011101111101111011a11001110101111111110121001101120111112111222121100101110011a111101111111011a210b222202111022202102102220221112112221201210101111101110111111
1111111010110011111a00111011011111111111122222011022111211100210220201120111111a111011111111111a200b111222012222022122102002222202102110112111111110111101111111
1111110101111011100a11110110101101011110112101221212201012010222002002220111111a011110011111110a212b022211211220200112221200021211201102001200111101011110011111
1100100011111101110a01110111101111111101111100111112022210111102021101221001111a111111001011110a012b222210211221102202221022120022222011021211111100111111101101
1111110001111110111a11111111111111001110111212021122120112221212220111100111111a111111111111111a001b102111122012222122002100200122221121211211111111111110111011
1101110111110111110a11111110101111011110012121121212111000210101022220211011111a111111111111111a012a222210021222121221220020222202222110120212011001011101110111
1111101010010110111a11111111100111011111000201112111120200121220212120211111110a111110111101110a021b112222112221122122201111112101221220122122100011111010011101
1011111001111111111a10011111111101011111110020122012222102122101112122211101111a111111011111111a122b012210120012200122201202122112121220111212111110111111011111
0001111101001111111a11110110111100111110111220002112112021210212222212010111111a110111111011111a121a222202210111222021220222120112011202112111111011110010111110
1010111111111111111a11001110111010010101100012011101001000122212112211000110011a111110011111111a210abbaabbabbbbbbbbbabbb2222221202101122222101110010111011111011
0111111111110100111a10111111111110101111111000211121211222211222022122121111011a111111111111110a21201101201111220202220b1220221211101121111222111101110110111001
1111001110111011111a11010111101111110111122211102022202121111212021211221111111a111010110111111a01011211112121202222222b2220221001021222221221111111111100111111
0110111011011111111a11011011111111111111120112212002102022002120110200110111111a101101111111111a01012112210121222021222b2101011120010001101111111110111111111101
1100111111001111101a11111111111111111111121120110111101112121102212002111110011a111111111111111a21021210221100221220122b2202221002210112121111101111111010111111
1110111111101111010a11111111111111110001121211220212201212102012222101221111111a111100011111011a01211212111221122212222b1220112211222222102101111111110110111111
0111111110111011111a00011100111101110111101211212011211112222212112211101111111a011111101111111a02120121201101002211212b2012122201222021102011111011110010011111
1101011111011111110a01111111110011001111122210210110121020221120211202121111111a010111111000011a02110100221122010222020b2220022212110111121020110111111010111110
0011010100111110110a01111110001111111111121021122221121020200111011110201111111a011111111101110a21111122121012222011222b0222121110100021121021111101101111111011
1011010111111110111a11110101101110111111111012121101121120111102222112011111111a111111101011011a12111022121122011222222b0000011110011011110111111010111110111111
1110111111010111111a11000110011101110011022212101211122111012122211222120011101a111110111110110a02122212012022122011101b0221221011111111110101111111101111111011
1111111111011110001a01010010111111111101122212121011120021212121211111201111110a011011111100100a11111111222010021221101a1022221111111011001111111101010111111101
