1 21
158 108
122 49
126 101
64 67
119 18
56 105
111 104
8 43
26 34

1111111101111111101101011111011111111110111111111110a11001011101111111100010111a11111111110111110111111111100110111111101111111101101110101111111011101101001110
0001111111110110111110101101101111111111111111111111a11101111101110111101101111a11011111000111110011011111111011111110011111111111111111111111111111111110010111
1110111101111101111110111110111111111111111111110101a11111011111111010011111011a11111111110011111111111111111110110101011101111111111100111011111110111010111111
1111101111111111011111111101111100111111110101101111a11111111111111001111110111a11111111111011110111111112111122021221120202121210011211111111101110010111111110
1111110111101110110110111111111111111101011111111111a11111111110110001111110111a11111111101110110111110010222212210102122111222121022101011111011011110110111111
aaaaaaaaaaaaaaaaaaaaaaaaaaaaaaaaaaaaaaaaa11101011111a01111011111111111111111111a10101111111111111111111112011222011120121010201021110210111001111111111111011111
1110111111111011111111111111111111111110a11111011111a11111111110111110111011111a11111011111111011110111121110000221212220222122120200221111111101001101111111111
1111111111111111011111110101011111111011a00110111111a11111111111111001111111101a11111011111100101011111121211121211221201112221101022110111101111110110011001110
1111110111011111001111101111111111001111a10110111101a11111111110111111111111110a11110011111111011110101112202121112212112022221021011121111101111111111101101111
1101011111111100111111111111111010111111a11111111110a01011111111110111101101111a11111011111111111111011112211211202112221200111221112021011111101011001011100111
1011011111101101011110111011110111011011a11111011111a11111111111111011011111110a10111111010111011111101110220021100020000221212121222221111001011111111110110101
1111101111111111111111110111011111101111a11111111111a00101100111111101111011110a11111111011101101111111102101021121021112022220111221111111111111111111011111011
1111111001011010111111111011101111110111a01110110111a11111111111101100111111011a11011100111011111111111120221211212101112110111101212211110111111110011111011011
1111010111111011011111111011010011011010a11111110100a11101110111011110110101011a10101111001111011111000122110022101122212221001121102001111111111111101111011111
1110011101111110101011111111101111111100a01110111111a11001011111110101101011111a11101100111111111011100122201201001222112121011111210211111101111010111011111011
1111111111101110110100010111111111100111a11001010111a11110111110111111111111111a11111110011111101111111111212212122011110201201211122121100111111011110110011111
1010101011011011101111011111111110111111a11111110111a01111010101111011111101111a11101101111101111001111121110212122201212122102202201101111110001011111111011101
1111110111110101111111011011111101010111a00011011111a01111111111001110110111111a10111111111111111110101022111022122221221012122210001101111111011111101111010010
1111011101111111111111111111111011110011a11111101111a01111110101111110101111111a11111110111111111110111101221211001202121112021210212101111111111101110101111101
0111101011122221002121212202211222112112a01011111111a11111111110111111111101111a11100111011001111111111011022021211022212021221111220211111111111111101110011111
1010100110121011102111021101211101101111b01111111111a01011110011110011111111111a11111111111110111111101110110211220120122212121212010011110111111011111111100100
0111001111112101112211211120012012200100a11111111011a11011011110000011110101111a11001111111011110111101122222120221221212022012120211200111111011111111111111111
1111110100120122102211110211020122121221a01111110011a11101111100111110001011111a01111001111111111111111122222112122021112011111121011200111111111011110111111111
1111111011112211220212222011122210111212a01010111111a11110101011011010111111101a11110111101110111100111111011221112211221201122202021121111001111111111111111110
1100111010111112111101212211112202012221a01110111111a11111110011111101100111101a11100110111110110111111121201101211201112112122111211211101111111111111001111111
aaaaaaaaaaabababaaaba2102221211221200111a21101100111a11111101111101111110111111a11111011110111111111111102221121110112001222122002011211111111110111101011101001
11111111111012112201b1212022110211112221b20101111111a11101101111111101011011100a10111111111001101101111120021011110112112211212122021211111110110111110111110110
11101111111202201022b1121112022122222110a11101111111a11111110111111111111111111a01101111011011111011111122121022110111221002101211011211111101101011101111101111
12221221120202022102b2022112221101211120b21110111111a11010111101010111101111010a11110011110010011011111011102112112101221002121110111221111111111111111111111011
20011221210002102212b2012111220211202211b21111111111a01111110111010111101111111a10110011011111111011101121122021221121020102002021202111111011011110111111000111
12211202022211211020a2222212202101122010b20111011011a10111110111011111101111111a11110110111111111111111121121101220111121211220111201100111110111111111011111110
11222011020221220220b2212221212102210011b11111111111a10111110111110110111101111a10111111111111111110111111222111011111212112012212101221111111110111111111000111
11210110102121022021a1222112211120022121b11111111111a11101011111001011011111001a11111111010111110101110111222222120222210100100211210111111111100111110001111111
21221012221222111221a1210212222111112121b21111001111a10111111111111111111100101a11100010111101111111111111022112202112112212101221211220011111111111110011111011
22101222221120122220b0122002021012222220a00111011111a11111110111010111100111110aaaaaaaaaaaaaaaaaaaaaaaaaaaababaaaaaaabaaaabbaaababbabbbabaaaaaaaaaaaaaaaaaaaaaaa
11212212101222122221b0210210212202211221a01101101101a11111001111111111111111111111110111111101111011011111120222121202102122210002201201211111111111111110111101
12011111012122112220a0121210121200102122b21111011110a11011111110111111111111111110111111111111111111111111112021211202111211110110111220121011111110011101001010
21121200021222202220b2222011012121001212a00111100110a11111011111110011111001111100111111011011011100111111112102111012211122122221210221120111111111111111011111
21212110200222220122b2220212022112210122a11011110111a11111101111010111110111111111111001011101111111110101122210110111222120200022101210121101111111100101111101
20021121112022022020b2211222202221112121a20111111101a10110111111011100001111111100111111111010111111110111112202010022221021101112112022210111101011011110111111
21211111202222101112b1222222220112111111a11111111101aaaaaaaaaaaaaaaaaaaaa101111001111111111111011111010011120112121122111212220100122210100101011101111111011111
02112112020002222121a1012221102002120111b1101111111100101111111111111001a111111111111111111111111000111111011221222012022000121211222212211111110011110111101101
20112111122022002102b0222222002122111200b1100110001111111111011111101111a111110110111111011111011100111110120111202222222111101102112112211110111111110111101001
21222112220222221220b2212012112120221210b0011111011111111111111111101110a101110111101011110011111100111101111111111221112112102012121222200001011111111111111110
10112212222112020220b2220210212221221202a2111111100101111111110110111001a101111111111000111101011101100011100222100202112211121021110112021111111111111011011111
11211101021221121120bbabbbabbbaabaabaabaa2011110111110111110111111011101a011111111111111111101111111111011110200121221101121221211221102201101111111101111111101
010111111012002222212012101212201101110102111111111001101111110101111111a111011111111111111111101111110111100011121110222121212001211221021101111101101110011111
121121021220222222220000212200021121121122110101101111100010111111111110a110111101111111011010011111111111120201211220021112111012221121111111101111011111111111
002112210221202212100011212202021111221111111111111110110111111101111011a101011010111101111111101110111111121011101112022112111220211111221111101011111111010111
020211102222222222020222222210202022122111111100111011111110100101110111a111110111001111110011101110111111010201121201201121122022202222111111111011111111111011
122020121022210221201112121222111111111001111011111111110111111111111111a101011111111111111111101001111111012122122122111021211221202222020110001011111110110111
120202001202021112012121102222110110110001010011111111011101100011111111a111111111111111111110111110111111112221220111112102121201210111010111111111110110011110
220101101121222110100212022022111101111101111101121021210011222121211021b220111111111111111111101011111110120002201212212221110211110211021110111111111111001110
122101101201122022112012221021111011110111111111102200212010111112221112a011111101010110011111111101001111111201112210112222112110021122201011111101101110111110
212111212212212112112002102122211011011010111101100212201122212121122111b112112211101111111110111011111111021102222210101011022121110112111111111101100011010111
111021022101201211222220211211111111111111011111121120021122220122120021a121011211111111110111011111010110121001011121211111112202210201021111111111110111011111
012122110102021100212211022120111110111111111111121111202112112111120102b120121111111111111110010101011111012111112110221212110111212111021111111111111001111110
121210120112022021012012121120011111101111011110100211101021012012111020a120121111111111010111101111111110001022200021210212222120111011121011110011111011110111
221122222102110111121202120222211111110111101111101210102122201002212001a222122211111110110111111110011111111112121212120101212100122122211111011110100111111100
011101111111101111110101100110011111110111110111121121212121211011122211a21120220111101111111011011011aaaaaabbbababbabaabaa2112102102110211111011111101111111111
111111110111010110111111111011101101101110101111122012221220002202221201b22211221101010011111111111111a1111222110101212102b0111222121210221111111111111111110111
111000111111111111111111111100011111111110111111121212022111221120212020a21201111111111110111111111011a1101121110221211211a1222220121112211111111100111111101111
111010101111101101111101011110111111111011111111111212021122111221210220b22211001111011111111100111111a1100222021121111120b2021102122011111011101111011011101111
101011111111011110101101010011101111111111111111100210110121011011011112b02212021110011110111111110111a0110120121111012211b2022011122202221111111100101101111011
011111100010111111111111100001011011110111111101021011201220120200112020b11022010101010101101111111011a1101222022121112211a2011012120222011111110111111110111101
001101111001001111100111111011111111111111111101102101212100122121212100b22221211111101111111111111111a0111111111111111011a0101111111111010110101011111111111111
110011111111111010011110100111110101110011111111121121021211211220122211a10221201111111111111011111111a1101100110100101111a1110101011111111100111111111010111111
111011111111100011111111100110011111111101111101102212121201020221122012a01022221101111011111111011011a1011111011111111111a1111111001111110111111001111111101011
111001100101111011110111111101111100110111111101121211221102211202022121b11110221010111111111011101100a1011111011101011111a1110011111111111101111001111001111110
111111101011111111111101111111111100111111110110122220222201210211012212a22210211101110110101011111011a1110111110011100111a1111111111111001111111111010111101111
110111101111111111110101111101111101101111101111120121112121121202110100a11221101111111100110111111101a0111111101111001101a1011111111111111111110011111111101101
100111111100111110111111111111101110101111101101111202021211212012101122b12111011111110011111111111110a1111011111111110111a1101110101101111111111110111101111011
010111110111111111011011111111111111111111111111012011210121010222222121b22202111011101110111110110111a1001110111110110111a1101001111111101111111111111111110110
111111111111111111001101111101111111011111111111121120120102121122110212a21220121111111111111011101110a1111010011111111111a1011111111111100111011111111011010111
111111101111111011111111110011001111111111011011102111210121222112120212b11111011111001111111011111111a1110011111110111011a1111111111110110101111111111111011101
111001111111111111111111011111111111110111111111120101221112111221011011b12122011110111111001111110101a0011110111011111111a1110111111110101110111111101011111111
101111001111101111100001111011111110111011111101111220220120221212121210a11102111111101100011111011111a1101011110111110001a1111111110111111010011011111111110111
111101111110111110111111110111101111111111111101022221201221012211112012b12012201111101111100111011111a1100111111111111110a1111111011111111111100111101101111011
011111010111111110101011011101111111111011111010121201111212222122201221b11221011101110010101111011111a1111111011111111111a1111011111111111111011001111011111011
111011011111111111011111111111111011111011011111112012110122112221111122b01020111101011111111111110111a1111111101110010111a1110111011110011111111111101111111111
011111111111111110101011110111011101111110010001122210202022011112010111b22220111111011111111011111111a1111110111111011111a1010011111111101011101111111111011111
111011111011001111011111111111111001100111111111101201221122220210211011a02011201110111111101111101011a1111111011111111111a1110111101111001011101011111011110111
111111111101111111110111101011101111111111111111111122110211212212112200b01101221111101111111111111101a1111100101011111011a0111111111011010111111000111111111111
111111111111101111101111111111111111111111011011111111101111101011111111a10011001111011011111111111111a1111111111100111111a1010011010111111111111111111111111111
011111111011101111111111011110101011111111011010010011111111101111101111a11011101100110011101011111111a1101111111001111101a1111110111111011011101111101110111111
011011111111111111111111110111101111111111110111001011111111111111000101a01111111111011001111110011111a1011111111110111101a1110101110111111110111111101111111101
111011110111101001111001010111111101011111111001111111101111101111111110a11111111110111110111111111010a1111110111122120110a2111121021112102111111111101111111010
101111111101110101111111011001101111111101101010111111111111111011101111a11101110111010111111101111101a1111111101222111202a2111220202211212201111111111111111101
111111010011111111111101111010111011111110111110101110111011111101011111a10111101111101111011011110111a1111011111211210212a0022201112022212122100101111111100111
011111111111111110011011101011001100110011010011111110111101110111011111a11011111111110111111111001122a2022121122221112112b2012212111122201120011111101111111111
111101110101111101110111111111111010111011201122112202102211121121022121a11011101110111011110111101112b2212122012012021101b1000002122221112002110011011111111111
111100111111101101111110111111110011111112012201110011011101211112100012a11101111010111111001111111122b1122211222122022121b0201122222112111122001111011011101110
101111110101111111100111111110111111111011021220222021112020100122121101a10001101111101011111111021022b2012221122212222012b1222202121221012210111110110111011111
000100111011111111111110111111110111110112210112100121101121210212012120a11101111111110111011101122101a0212121222222110222b2212201112201021111101110111111111111
111101111101111011011011011110010101111011220101001220122111112112012112a11011111111111111011111110012b0210112122222202121b1120211011121211212111100111101111111
110111101010011111111111011100001010111010112201122020012211112201121102a11110111111011101011011221112b2122210221222102212b2022022220211002220111111110010111111
111111111011101101111101010111000011111111201212110222222022111221112221a11111111111101111111011211211b0212121101020222221a2220122111011211221111111011111001011
111111111101101101111011110111111010011011002121212022211112011221012221a01111100001101101111111220221a0112212020221202222b2222111111112122221111101101111011111
111110101110110101111111111011111101011112220102110120101111221020221122a11110111011111111111011222212a2012120111002112221b2201212211222200020011111111011010111
101111111010111111110110110011111011111111010010212211111211111201111210a111111011aaaaaaaaaaaaaabbbabbb2102221121202211000b2022221210002120112101111110111111110
111111011101111110111101111010011110111111212211101222001122122111020022a111111111a111111111001122012112222121122202222221b2111022120121102221111110111111111001
111010111111111111110111101010111111111112120120211222211222122200120212a011111101a011111111110111222210021212220021221222a0212001122221221021110011111111111111
110011111110111011011110111111101111101111200022101212202012111221002010a111111100a010110001011122101111112122212200002122b2222012211122222121111110101100110111
111001111111011011011011010010111011111011112220221102112211210122211000a111111101a111110111111122212111212212222210202220b1222211200112121111001111111111110111
111110111111111110111110110110111001110102222011220121210102211102222112a111001110a110101110111112122102102221112012202022b0022112122121022112011110111111111111
010111010010010111101111101111110011111002112211220221010101222101222222a111111111a111100101011111221120211121122212100022b1201012021001112120111111111111011111
110010111111111101011111111101010111111010022222021102111121211220122221a111101100a111111111111122122212102122122002220221a2202110212101012222111101110010111111
110111100011111111111111111111111111111011212212221122112112112120220022a111010101a011111111111020010221102221002221212221b1100201212201121110110111010111100000
111110111111111111101011111110011111101102212210111102221211112112222000a011111111a111101111111121122220221221220222221121b2222001110102122121111101011111011001
111001111111110111111101011110111110011112210011012121001121121212200222a111111111a110110101110101212002122220200020222121b1121022122021011002111101111111111111
111011011111011111111110111011111011111111211112102112121100021012020210a111111001a101111010111110112221121112222120112120a2022211122211220201001111101111111100
111111111011101100111110110111111111111112221212221110110212110221111220a111101111a101101101011121011111000112222221222100b1122122211221211101000110111111111111
111011111111011110111011111111111110111112121111112111011100011011211102a011111101a111111111000112022121122111122212120121a1112111020121220121111110110111111110
001010111111111111100101101111011111101111121221100221200200221220001221a011011111a111011111101100100211200222102222202202a0120111211102101211000110001111001111
111111111011101111110111101001110111011111122212201000102212010121202220a101111011a011111111111012221100111111102222111012a1221112212121022221111111111111110111
011111111011011111111011011111100111001112122210210121022221001121022211a111111111a111001010111120221021111112222220211022b1221212111211222200101111111111101010
111111100101111111111011011111001111011112210101022221101012112220121111a110111001a110101111111111022112211222222020122021b2212021100222202222111111110111110111
000101110111111101110110111100010111111012112102011222210222122212012122a111111111a111111101111122211111111222221012211121a2212111111111011110111111101111101111
111101111111101101111101111111101001111110211000122121111112111011120100a111111111a001011111111122021202211212100212012122a1222111011111111001011111110101111111
111110011110111000011111111111111111111112010101012101201021221121022111a110010111a111111011111101211222112201211122020102a2121010111111111111110111111100110111
