3 5
135 107
122 49
126 101
64 67
119 18
56 105
111 104
8 43
26 34
110111111101001011101001001101111011010a11111110110011111111a011111111011111110111101111111101110011a10111111111111111011111110110111111011111111111111111011111
101111111111111111111111110101111011111a10111111101011100111a111111101010101111111110011111111111101a01110111110011111110110111101101110010111111110111110011111
111111101111111111111101111111011110110a10111110111011111001a111110011101111111111111001011111111111a11011101011111010111111110101001111110111111111101111111111
111011010011111111111101110101111001011a11011111110111111111a000111111011010111111001110111110110111a10110222211112011121222101112002011010111110111111111110010
111001011111110111111110011000111110100a11111000101111111110a111111110101111111101010011110101110001a11110120112121212221211001211011001111111111111011111111111
110111110111111111111111111111111111111a11100111111011101111a110111111111011101101110101001111111111a10122102111121100212210220200111101111101001101110110001110
111101101111110110111111010101110111111a11010111111110110111a101111101110010101011111110111101111101a11021201100102111110202222221202021111111011110111011111111
111110111111011111111111111111111111111a11011111111011111011a110010111111110111110001110111111111111a01111120222220201110211212122112211011010111101011011111110
111100111101110110111011111101111111111a11101111010111111111a111101111111111111111101111011110111110a00100121121101210100002122211201211111111111111111111111111
011101110111111111111100111101111101101a11110111010111110111a111010101111111110011001111111111010111a11111211011100212021222221222210201111011101111110101111111
011110111111111111010010110111111111010a11011011101010111100a111101011111111001111110110101110001111a11120121022120101022002112111111111011101111111011111001111
011100111101110110111111101010111111111a11111111111111011011a011111111111111101101110111111111111101a11121112020001101202022220121211110110101011111110011111111
101100101111011101101111011111111111111a10110011111111111010a111110010111111110111111111101111111111a11122211111112221211111021212211220111101111111111111111110
111111111111111111111001011111011101011a01101111011111110111a100101110000010111111101111111111110101a11112120210202220222012121122122201110111111111111111111111
101111111111111101111110110111111111110a11101110111110111111a111111110011111111011110101110111110111a11111000122012122222210011222020221110110011111101111101111
001101011111110011111111111111111110111a01111111001111111111a111111100011111111000111111111111111111a11122102022201211021211122102122201111011011111110111011001
111110110111111111011111001111101111111a11011011111101101001a011111111110111111111011010111111110110a11011011011212011212011202111201221111111101011111111110111
111101111111011110101111111111101111111a11111111111010111111a111111111110111111111101111110111111011a11111111111111021122112110122211101111111111011111101111011
101000111111111101111111111011101011111a11011010111111101011a111011110011011101111111111111111101110a11102100211002222212120211211100211111011010101001111111110
111001110112012222121110101220111211100b12101101111111111111a111111111111111011010111111111111010011a10110202120202220120221222122110210111110111111101111011111
011101111111212022020222222212211022101b11101111111111101111a1111010100110111110aaaaaaaaaaaaaaaaaaaaa11122111222212221201212211221122111111111011111011111110110
111111111102110201012210221122112211120b02111011111110101011a0111111111110111111a1101101111100111101111110211111112001221222101102110021111100011111111101111111
110100111111222122112211221120022120211a22011111011001011111a1111001111111111111a0111111111111111111111121021012222121122222212020122111011111111111111111111111
111111111110212202111012211021220012100a21110111110111111111a0010011111110110101a0011111110111110111011011112000001011221211212111121021111011111111100110111010
111111101111022122011221222112212221112a11111111111111110110a1111011100111111111a0011100111111111100110120110201221211122120012121112111111101101100111110110111
111111100112222111211212022121111211120b11111111101011111111a1101011110111111111a0010111111011011011111021112212201012121122002212110221111111111000011001111111
111111101001211112121011012201110021221a01111111111111111110a1111010101111111010a1111011010101111111111111220021112211222122202120112221111111111100101111111110
001111011112212220012002112222211222011a21111101101101101011a1111011111111101111a0101101111111101111010120212221111112011111201102110121111101111110111111111010
222212111212022222120022221022202121102b10110111111111111111a0011111111111111111a1111110111111110110111111222021121111210201112001122121111110111111111111100011
201222110122202220002002022220111222220a00110111100111111111a1010111111111111101a1111011110111101101111110101220101211012101221121020110111111111111111111000111
120122222211220220202220001112201212012a21110111111111111111a1011100111111111101a0101111101011111111101121220100122222010201102201211001101111111111111111111011
011221020111002122220212202221121202222b21111111111100111110a1111110111110111111a1110101010111111101110121200111111212212222221211012220110111010111011111011011
101220210111220222011202201022012101201a21101111111111011110a1011101111110111011a1111111110011101111110101112210221202112222210112111221111111110111111111111111
111120120212220102000222121002121220102b21110011111011111110a1101111011111101111a1011011100111110111111120211222120120001010011020200020000010111111101011111010
112212112211022222212222022222202222222a20111111111011111111a1111101011111101011a0111111110111011101010111012011102222202011122222112010111111111111111101111111
110211021222212102210022222212201211221b00111111101001110111a1011111011110101111a1111110011011111110101111120011211121221221012111121221220111110110111110101110
111001220002112222202022212212211021201a11101111111110101101a1110110111111001111a1111111111111110111010110021022101220022120221102222010111101010010011101101001
002002121111000222001102222221010111211a12011111001010111011a1101111111111111111a1010110101110111111111111102121220210201110221112222111121011111111110011010101
201222110122200220220001120102212122201b22111011110101111111a0100111111111010111a1110111111111110111101111120122221112112211211012122021121111111111111101111111
112012112222122202222112022221100221021a21111011001111111011a1101111111111011111a1111111111111101111111111121120221212122112222211122021011111011111100111111111
110012101122220201000212222222210002212a01111111111100111111aaaaaaaaaaaaaaaaaaaaa1111101110111111111111101021012212121010122112111101020001101111111111111101111
011120220110020221221022222122221111112a011111111111111111111111110110111101101101111110000110111001111111121102102111100121121012121120221111001111111111110111
122221221012211022220222202120012121200b01011111111111101011111111111011111111101101111111110111111aaaaaaaabbaabababbbbbaaaababbbbbababbbaaaaaaaaaaaaaaaaaaaaaaa
111100111112121221122211112022212210122a21100101111110101111111100111111111111111110101101110111111a111110122201120211022002111101222120120111001110111111110101
211201110022211111202202222202221200222b02101110001110111111110111111111111111010111110111111110111a111111121200111111111210122211001221020101101111111100110101
112102002112220222012222112111011012020b00111111111011111111111010111111011110111011110100101101101a111111122120220011012120022120220122011111110111101011100001
212012210222022210220211200022101101221b21111111101111100111101011111010011110111111111101101101111a111111020020012121020200211202001012221111111111111101111110
122122121220221121222222211212202110121b11001110110111100110110011111111111010111111111101110111111a101011010121221221102201222101222221201111111011111111000111
102111110212211212120120222201012222021b21111010111111111111111111111110101111101011111110011111100a111110101122201202101221111122212200221111111111110111110111
112222102202210122212112202222221221221a21110111111011111100111111011111111111011111100011110110111a001111120110012222112221112112202100211001001010101111110110
201201020010210222000222221022110111011a11011111111111111110111111111110111111111010111101011011111a001101122212200122211020121111221201211001111111111111111111
202112212120210211021112011211111010011a11010111110100111011011111110110111111100100111110111011101a011111112210112111102102101111211102121011101111111010011001
112122211221022112212101112200211111011a11101010111221012111212212121021111121221111101111111101101a100011122020222110111222012122211211121111111110111111110111
120211211122210212211000210012211111111a11111111112112201101120212211010211112220011100111011011101a111111112022222020110212221121120112201110101111011011011001
022111120121101112111102111121011110111a11111110001101102120112110021222112012221111111111111110101a110110021012221211210212222110221201221110011011111101111111
021121211202111121211222211122011111111a00111111121102012121000012211100121021201111111111110001010a011110111111010120111021102222120201201111011111111001111111
121001122221211111101222112001011101011a11111011010102201102212022111221211110010111111111110110111a011011001022110221212010200211211122121110111011101110111111
011210121112122212212220111110200101111a11111111112111102221122201022111112001211101111111110011011a110111121201112002111101210211200222220110011111011101011110
002001101111102121102020222111110110011a11111001121121120202120101201110012221121111111111111111111a110111100122202222011011201022101121011111111111111110111111
110111111111111111011110111111111101111a01011011122021212101122121212221212222221110110111111011101a111011112221120122021102221012120002211101011111101011011101
111111111111101111110111111110111110011a11111111101112220122222112110120212100021111111011011000111a011111122201210110222010111101122220201111111101111101100100
111101011111001101111111111110011111111a11111110111200011011112121112111221112021111101110111111110a011011110122221222221101200111222102211011110001111101100101
010111100111111111110111111111111111111a11110101110110211202222211022111212212111111111111111111111aaaaaaaabbbababaaaaaababaaabbabbbaabbbaaaaaaaaaaaaaaaaaaaaaaa
110111011111111101111101101111111111111a111011111111211102110021002021110122112200011111110101111110011110120122122210121012110111211112110111111110000111111111
111011111011011110111100111011101101111a010111111222111222111111111122211211001001111111100001011110111111111222110211212112210112212121121111111111111111111111
101111101010111111011111101010111100111a011110111212211221011111210111112221100111111111111111101111101101111111111110111111111000110111111110011101111111111001
111111111101011111111111011111111111111a110111001220102202100222212201202212202210111111111101011111111011110111111110011101111110111011101110111011111110111111
011101001111111110111111111110111110111a110111110112011112002211011221221122122011011101111111011111011111111001011101110111011100111111110111110111101110111110
111111111111011111010110110111110111111a111011011100210001000211012211122011111111111010110111111111110011111111111101011001011111011011010111011101111111111011
111110111111101111111101100111101111111a111111111212110111101110211221112210110200111111111111111111011111111011011010111111111101010110111111111111111011100101
011111110110011101101011111011111111111a111111111201002122112101222200112201101211111111111111011111111111011011111011000011111111010111101111110111011111011111
110111111111101111111101111111111111100a110110110111112212222000221221022022212111111010111111011010101011111111111101111111111111101111111111111101110110101111
101111110111001011110111111101111111111a111111111100201021210021011001220122202111111101111011111101111111111111111101111110111111010111100111111111101011111111
011010011100110011011011111011111111111a111111101102010120221110112110202122111010111110111111101111110101011101111111111001101101001111101111011010101111101111
111111011101011111111111000111011111111a111111111110211121221211011101211212110201011111111011111101000100111101010010111111111101111111100111001111101111111111
111111111100111111101111110111111110111a111000111212221122222112221021221120211211011111110111111101110011011111111111001111111011111011110111111111111101111111
111111111111101111111111111101111100011a111110110111111020100110101211020111022201101111011110111011111111111101011000011111101111111111111110110111111011111101
111111000111011110111111111111101010110a111101111222021110120111222212202211221110111111111101001110011111111110110110001111011101011110111001111111111101111010
111111111111111011111101111110110111111a111111111210012112200020121222112201221110011111111111101111110110111101011001111011111111111111111111111101110101111111
111000011111101111101110111111101111101a011111110202021211211201122212211012112211111111111011101010101111111111110111010011111100111101010101011111100111111101
101100110111011111111011111011111001011a110111111122122201112010011111200011011101100011000110111111110111110011001111111111011001111111101101111111101110111011
111111011010111101111111111111101111011a111101111021221212210211101222020222222111111111111111111111101101111101111111001110001111110101110111111100111101111111
111111111111011111101111111101111011000a111111111112221202211101221222001102110111111010111001111111111111111111101111111111110011010011101000111111111101111011
111011111111111011101011101111111001101a111110011101111111111110011111111110111111111011110111001111111111101110101011111101101111111111111110101111011111111111
101111110111101011101101111111001101010a101111111111110011111011011101111111101111011100101111000111111111111001111110001111010110110111111111101011101010001111
111111100111101011111011111111111111010a111001101111110111111110111110111011101111111111011111011011111101111111010111010111001101111110100111111101111111111110
111111110110110111111110011111110011111a111011111111111011111101111111011111110111111111011011111111111100111112110112211222111212121111001121011101011011011111
111111110110101100111111001111111111010a101111111110111011111111111111011111111110100111001101111110111110111111121201111200011212200111120211101110000011111111
111011101111111110011111111110111010111a110110101100110100111110111111111111101111111110011100111111111111111112221100021212011002221222121112111111011111111111
111111111001110111011101111101011111110a111111111111101111111111101111011111111001111111111111112110022112201200002222221222222121222101222112110111110111111111
111101111111111010111111111111101110001a120000122101022121000112221210221111111110101101101111110222102101101102021222212222222112121120121112111011011011111111
111111110111101111111111001111110111111a122101111121121102211210011222101101111110110101111111111221201112212122002222222220222112122020112200111111111111010111
111111111001111101110011111101001100110a121120012212222111012211200212121111011011111010111111010111222102110212221100202102022010212210111222111111001101110111
010101011110110101110101110111111111111a112121112211101001111121112222110111110110010110111111012020021202011201222022222221212112222121111101101111111101111111
101111010111111110000101101111111111111a102012221121201211120221010210010111110011110111110111012121010111212111222222221011222121021012122121111111111111101111
001011100111111100001111110101111101110a121211222100220111102211112211211111111110110111111010101212101121112111002022202222022120120000012011111110110111111111
110101011111111111111111111101001101110a122212212202111112112222101011210111111110101111101111111211101221221202120022222220202022121111222221101111111111111111
111111111011101111111110111000001111111a112202111112101112012021011122201111111111010110001111110102121000102001022220221220212220222222122220111111111111010101
111111111111011111101101111110110101111a121211212222112112212021121222221111000011111011111111112210011112222122221222221021222211121220212210111111111110110111
111111111111111111111111111111111110011a101201220210111112120121122120221011011111111110110110111022122221112210202222221220022202011002110112111111101111100111
101111110110111110111011110111101010111a111012212211012001211222210101121011111111011111110111100212120201012122112120112111021122212211101021111110011111111010
011110101111111011101011101111111111110a122122011122221111122212001010220101011111101010111100112211010122122210212022012222002212121221222110111111111101111111
100110101001111101110001111011101100111a022200120221121112001112122202220011111110111111111111012112122121212011122022212111222002120101211201011111101000111011
110111010111010111111111111101111101111a110111112120112212201221012220210101111011111111111111111212221121211211112002201222002012022112211212011111111110111011
011111111001110111111101111111011111111a020221212112221221222112101111221111011111011111000111110100210112221112212020212220012221122102222111111010111011111111
111101111110110111111111001111010111011a102122212121012102221112010010220101110111111111111111111120122222120112022212122222012101221011200222111001111111001110
111111111111111111111111101011011111111a101211120221011112112202121102211010111101111111111011011022111221121120202222222212222121211022010010111100111111011110
111111111111111101110111110111111111101aababaabbaababbbaababbaabaabbaabaaaaaaaaaaaaaaaaaaaaaaaaaababbbabaababbaabbbbbbbbbababbbbbbbaaaaaaabbbbaaaaaaaaaaaaaaaaaa
1011110011111111011101111111011001101111111221111021110020211202201122111101101001101111111101111121122221112212222122222102212112211222121122111110011111101111
1111101111111110110101100100111111111110021222111010212120212020012212121101111111111111111011111121101200212221122022211222222222112211120202111101111110111010
1111111111111111101010101101111001111111021102222212221221111112110121110101111111001011110011112021012111012112002222222222222120021212202102111111110101111111
1111110011111011110111111011111111111111102101020101211210112121221112211011111111111111111111002100012020221112012212222022222222221202212101111111010011101111
aaaaaaaaaaaaaaaaaaaaaaaaaaaaaaaaaaaaaaaaabbbaababaabaabaabbbbbabbaabbaabaaaaaaaaaaaaaaaaaaaaaaaabbbbb11112211210222212220002220120121122220221101111111111010011
1111101111111111111111011111110111111100102112221212100010211021001121221101011011111110111110112110a22212021110222212021222122020111202012121111100111111111011
1111111111111111110011111110111110111110122122121011022111210222112121011110111101101111111111112222a12210100200120122102210222112121202222200011111110011111111
1111110111110111111111111111011011111111110212221220122120100212211002221111101111111111101111110212b00112012122212011222222011121112220122122111111111011011111
1111101000110111011101011111101000111111110211101021212200121222212121111111101111111110110011112012b10100102221222222121212220012121211212112111111010001111111
1101111001111111111111101011110111111110122222110212112212211000011201121111101110100011100111012111b22122222222022112110212210111111011111100111111011111001111
1010011111111111111100111111001111111111121122212021012201200101111222221111110111011101001110111221b21110211122201221011102111111011110111111011010110111101111
0111011011001011011111011111111111110111112211122211122102102220121021211111101011111111011110112120a11111110121100110111002211101111111101110111010110111111111
