84 2
70 104
122 49
126 101
64 67
119 18
56 105
111 104
8 43
26 34

1011011a11001111111101111111110110110111111111111111111111111101111111111011111111111111111110011110111111110110100111111001111111001001110011011000111111111101
1111111a01111111111111110100110001111011100111110000111111011111111111111111101111011111111111111110011111101101111111111111111010110111111111111101111001111111
1110111a0111111011111111111101111110111101010101111110010111101111111111111111111111P111101111111111011101011001111111110101110101111111011010001110111011111111
1011111a100111110111111111111111011000001011110111111101111111101111111101111111111P0110111101100100111101021021122122112101212201122021111111011111011111010110
1010110a111011101110000111111101011111111111011111110111101011111111111011111111111P1011011101111011111002221110211220102120212212220120011101111110111111111101
1001101a1111011111111111111111111111111aaaaaaaaaaaaaaaaaaaaaaaaaaaaaaaaaaaaPPPPPPPPaaaaaaaaaaaaaaaaaaaaaaaaabbbabbbababbaaaababbbaababbaaaaaaaaaaaaaaaaaaaaaaaaa
1101111a1110111111111111110111110111111a1011111111100111111111111110111101P1111111111111110110011111011122112110000122122210210110221121110100111111111111111111
1111111a1101111110111011111011101110111a0101111111111110101111111111011010P1111111110111111001011011111122202022101212222201212111011101111111111111101111111111
0101011a1011110111111111111001101101111a1110111111111000111110111101111101P1110111111111111011111110110112101212112221211120212111211011111100111111111001101111
1011111a1111110111011111111111111110100a1111101111101110111011111100011111P1111001110011011111000111110122222222021122100220201211111021101111100110111111110100
1110101a1110111011111110011101111101011a1111111011111100111111101111111110P1110111111010110011011111111121221200112211212111100211101111111111101001111111111001
1101111a1111111011101111111111011111011a1111111110110111011110011101111111P1111111111111110111111111111111021120120212021121112212111101101011011111011111010111
1110111a1111110111111110100111111111111a1110111110110111110101111111111111P1111111111110111101111110111122212001121212121222212111222010111111011111111111111011
1111101a1111111101011111011111111111110a0111111111011110101011111111111101P1110011011110011111111111111101201011011112210121122221210121111011011011111101111111
1111110a0111110111011111111111111111011a1011101111111111110101111111110111P1101010110111100111111110111011212112112210201121120102010111111111010100110110111111
1011000a1110111111101110111101111101111a0111111011101111101111111010011111P1111110111011111101110011111112121211112011221112012022122101111111101111111111111111
1111111a0011110111111110010010101111111a1101111111111110111111111101111111P1111111101111111110111111111121101212210021201110121020122201111101000011011110011110
1111101a0111111011101101101101101101111a110111000111011101111111110111111P11011100111111101111101111110101011121122201021021110222110121111111111111001111111111
0111011a1111110111100101111011100111011a111101100101111111111111111111110P01100100111011110111111111111122201212211022122111221202221121011111010110110001110100
1111111a1012220122222112211222111221221a201011111011111101111111101010010P10111111101111011111011111110110210211111222112221220112121010111111111001111101111001
1111011a1110212201012012210120111221121b020011101111000111011111111000111P11101111110110110111100111111121122222122122122222122211222121111111111111111011111110
1111111a1102100120010212212122112111211b111111011111101111111011100101101P10111011111011011001010111110022221220022221122100022201212210111111111110011111110110
1111111a1101211222110111110222021222101a02011111011101111111110101111111P011110101111110101101101110100102212112021020210120112222111100111011111110111011111111
0111111a1111222001120211010110011202120b22111110101011110111111110111011P111101111111100111111111111111122112111011021000121202220202010010111101111111111111111
1111111a1110120012211211001121001011210b21101111111111101111111001011111P110111111011011111110111111011100200202211210111200112212211221111111111111011111110111
1110111a1111111211021112212120201020111b12111111111111111100111110111011P111111111001100101111111101111112200122002221111222211212211120100110111011111111101011
1111110a1112111111212021021110022200120a21011111110111110001111110111111P111110101111111011011111111011101012011020222111221222220120220110111000111111101110111
1111111a1111111121211212102110111111211b11111010111111101111110111010010P100111011111101110111101111111121212121221221121120121111111211011110101111111101111101
0221201b2021112110222210021210212020002a00111101110111111111000111101111P111111111011011111100111011111002121211022121211211102020221201111111111011111111111111
0221200a2010112022212222122212221102022a12011101101111111011111011111110P100011111101111110110011111111122201112112010112022001202221211111001101110110111111111
1211111a1102002002222112210212101212211a20111110110110111011101111011110P111010111111111111111111011101122120121121011112221100121111011111111111111110111111111
1111112b1110022122022222120122220121110b02010111111101111101010111111110P101111110101001101101011110101121222111222121101020101221222211111111110011111111110101
2122212a1022002112221022212121122112100b12111011110011110111111101111011P111111111111011111010111111111020200121122121001110020221110120101111011101111111110110
1101122a2122220222202202022220021020121a01101001111011111111110011111100P001101111111101111011111010111012222121022220121122121220102021111101111111110101111010
2111111b1012221022101210222122222021201b22101111111101111111011111111011P110111111111111100111111111111111120112022211212121221222022021210011011111001111111111
0011210b2022121222022212222222211221212b1101101111111011111aPPPPPPPPPPPPaaaaaaaaaaaaaaaaaaaaaaaaaaaaaaaaaaaabaaababbbabbbaaaabbbbbbabaaaaaaa11111010111101110111
2011102b1122201022212022002221211101111b2111110001111111111P0110111101101111110111111110111111111111111111111111112221021102021022101222220a11110011101111111111
2022012a2202111222212222220122122121210a1111011011111111100P1000010111111110111111101100111110011111111110101212121211100021112102122010221a01111111011111110111
0000011b0012221122220020221202222102002b1011011010101110101P1101011011100111110100011100111111111111110101111001222212212221000101111121110a11111111111111111111
0022210a2002222221110012122222211122211a0211001111111101111P0011011111111111011101111010111111011111110101121102221122200222121222222212100a10111111111101111100
1121121a1200022220220211022122211210110a2001011011110111111P1111011110110010111110111101111101110101110101112122111110111220212212222121211a11101111110111110111
1121101b2112022222120222120222212110101b1011110111111111110P1111111111111110011010011110101111111001110010102111211111222212211212111121201a01101111011011111011
2122101a0102212202220121221100111121120a2101111011110111011P1100110111011111111001111110111111111100111111121211022020122022221102112212011a11111011010011110011
1200121a0102211012212222002101221102102a2010111111111111111P1111111111110111111111101111011010111111101111110122201202122220111102211211111a10011101001100111110
2210121a1102022122122112002222221221220b1011101111111111011P0010111101111111101111010001111111111011111111121222020112222121212121221201001a10100111010011111000
0220221b2221002012121221022122221211010a2011110111011010111P1101110111110011011111111111101111111111100101011220202120122012210212111111220a11011111111011111110
0221211b1112221011220120220122220122121a1111010101111111101P1111111011111101111111111111111111111111111011120222202012110222101221101212010a11101111110111111111
1211111b0100222022202110122112222111212b2111001011111111111P0111111011111110101111110111100111111111111111122212210212122222111221212101211a11111011111111111111
1121001a2122212221222222220201221211121a0111111110111111111P1110111111111111110100100110011111111111011110110111221110211211211200111122021a11111101110111101101
2121101a2111222222022012211221102112112a2111110011111101110P1110101101111101001111011111111011011111010011120211112212211221201022020221201a11111111111111111101
1122022a2221201201110002220011211111111a1111111111111011101P1111011111111111111101111111011111111111111111111102022222122021212022212222121a01010110101111111110
1212110b1201221210012112221021111111111a0111010011111101001P1111100110011111111111111111110100001111111111111222201111020012012211122211211a01111111111101110111
1002122b1212211102120211221020211111011a0111001102212121210P1220222011022021121111110101011111111111111111121111121211221112121211112111111a01111101111001111110
0221220a0020122121201022101220211111111a1010111010011121212P1012212012212222120211111111101111111011111001121121210201201222211210221110201a11110111111001101101
2121120b1102120102212122020012211101111a1100111111122112110P2221102100012011121110111111111111110111111001122111222210021112100211122111210a11111111110110111111
1021012b2112022120210101011201210111101a1111111102202012020P1122122201212222121211111111111111111011101111121222222121121221000121121110011a01101111101011011111
1022221a0011222221111010120202010111111a1111111111210211210P1122212121222221202201101111111111010110111101122220112010021012212221011112211a11111110111111011111
0122121b2221111100122222101012111101100a1111111110121101120P2012211110110021012211111110111111011101110111112101121100112212101211012101220a11101111110111110011
1101110a0110102211211211122211200111111a1111111102120111111P2221121120011202121211111111111111111111111111002011121121212111112121222022121a10111101111111011111
1001111a1111111010111111111111111111101a0111011110120112010P2212222011120222222111111010110011111001110011002221121111221111111022100201211a11110111011111101111
1111111a1111111111111111110111111101101a1011011111221210202P2011120112011212122210110111010011110111111111102222202221211211201112120112121a11111101110101111010
0111001a1111111111111111101111110111111a1111001101111012101P1112220212111112112001111010111110111111111001121112112022021111221012201212220a11111011111011011011
0111111a1011111111111101101111111111011a1111111110212212111P2111102011021001121111111101011110110111101101012120122110101100111211212120101a11011111111111111011
1111011a0101111111111010011111111111111a1101101110112021202P2111202211010101211211110110111011011111111110121101122111201021121022111011121a01101001111111011111
1111111a1111111011110111111001101111011a1111110111201120121P1200221222221111112011111101111111011111000111101212001102111121110002212112211a11110110111111111111
0111011a1000111101111111111111111011110a1111111111221110001P0000012221012121212111101011111111111010111111111110111110111011011111001010101a01111111111011111111
1111111a1101111111111110011011011110111a1001110110211000110P0111212110220020112011111011101001111111101111111011111010001100101111101111111a11111111111110111111
1111110a1111101110111111111111111011110a1011111101222101221P1211210112211221211211111111111111111111111111111111111101101011111110111111111a11111110111001101111
1111111a1110111101111111111111111011110a1111100112110121220P2112202111111212110001111110101110111111011101111111011111111111111111101101100a11111110111111111011
0111011a1101111011111111110101111001111a0110110110211111122P0120111102111002020011111111111111111011110111001111101101011111101111111110111a11111010110111101110
1101110a1111111011011110010011110111111a1111111001112221212P1022122212001122121201111101111011111011011011111111111101111001101110101111111a10011011111111110111
1111111a1111111011111011110010111111111a1110101111220012221P2022202122111222221111011011111111011111111010101111101111111111101110111110111a01001111011111111111
1111100a1111101100111111111101010101011a1011100111022211211P2111210102221221100001110111111111111111110111111111111111111111111011101110101a11101111111101111101
1100111a1011111011111110001000101111101a1101111102101102212P0212120011210210221100110111001110011111111101001110111111111101011111111111111a11111111111111111110
0111110a1100111111111111110001101100111a1110111111111111212P0211010011211100202201111111101101111111110111111011111111111111111011100100111a11111110101111111111
1011101a1111110011111111111010111101111a1111111112221211122P2021011221112022010000111110101011000101110111111011111000011110111111111111111a11111101111110111110
1111010a1111111111111111111111110111111a1110110111222111222P2112101111211222112211111100111101111110111010111111011111111101110111111111001a11111100011111101110
1111111a1111111111111111111111111111111a1011111011001212122P1211101112001212211201111111111011111111111111111011101111111111111101110011011a11110110111111111111
0111111a1110011111110111111010111111011a0101111101121122011P1121022211112122202210100110011001111111011101111111011110111110111111111011101a11111100101111010101
1111001a1001111111010111101111011110110a1111100112211212202P1122111211122212011201101101111011111001111111111111100111110101110101010110111a11110011110111111111
1101101a1101111111111111111101111111001a1111111112012002121P0210021002222122011111111110101111001011101111001111100101011101111110111111101a11111111111100011111
1110011a1110110111111101101101011010010a0111111112202012221P2201220120012220210200001111111011110111001011110101111011010110111111111010111a11110111111111111111
1011111a1111000101101100010110101101111a1010110112201120202P1100110212210101200011111111110101111011110111101111111111110111111101011111111a11111100101011111111
1111101a0011111111010101110101011100111a0111111111011111011P1011111110111111111101011111111101100111111011111111011101111011101011111111100a11111011011110111110
1111111a1111111111111011111111111111101a1111111111110101111P0101111011111111111101110110111111111111010111011110100111111101110111111011111a10111011110011111111
1111111a11011101101aaaaaaaaaaaaaaaaaaaaa1011011111110101101P1001011111011011111101011111111101111111011111010101011101011111010110110101101a01111111111111111110
1111111a11111111111a101111111110011011111111101111000110101P1111111110111111111011011110110101001111110010111012012222011222202212200211220a21111011110100111111
0111110a11111111111a010100001111111101111111111111111111111P1111111111111111110110011111111101111011101011001112022212101001202122200101211b21010101111001111111
1111111a11111111011a101111111101110110001001011111111111101P1010011100101111111111111111111110011110111111111110012110120122221112121222212a11111110111111111011
1111111a11111101111a111100111111111111111111111111111011111P1011111011111101111110111110111111111220112121122220200212222211212212120122221b11111101111111011111
1111111a01011110111a111010011111101111111021111110220221112P1121222010121111111111011110001110012112122012110001222222001222222122020220011a01011111011011101011
1111110a10111111101a111111111111101011100221220210112101222P1212122000210111110101111111111111101022100212111102022222112221022010211202211b02111111001111111111
0111010a01111001111a110110111111100111111212100100211111112P1200022002221011001110111100110111112212022111212112212222002222202021111122121b22010110110111111111
1111111a11101101111a111111111111111011111122201212112002101P2122112110220111111110101111111111111012121200021102002222222202211122121212121b01011111111111111111
1110011a11111111111a111101011111111101111200202120221100010P1222102201121111111001101011001101010122112121111221202021222112022122202210121b00001010111111101011
1111001a11111111111a111101111111111111011122222212002221101P2122121121111111111101011111111111111112211222010122021022222002202002111212211baaaaaaaaaaaaaaaaaaaa
1111101a10011111111a111101111111101111111212120122111211222P1101111122111111011011111111111111111222202121121212112120122112220102212110211111011110011110001011
1011111a11110111101a001111111101011111111111202101222101121P0120121112011111111111001000100110011201220022012212001122021021222222220020001021111111111011011111
1111111a11101111111a001111111010111101010201001211111122212P1110100021201111101111001101111110111121021021122112222122212222202202210022111122111100111110111111
1011011a11101110111a101000111110101011101112221211212002120P221212110bbaaaaaaaaaaaaaaaaaaaaaaaaabbbbbbbabbbabaababbbbabbababbbaabaabbaabbbbbaaaaaaaaaa1110111110
1001111a11111111111a111111111101111111001212100220121222102P121220121a0101011111111100000111011000110002220121222222222222102212120200201212101011110a1111111111
1111111a11111011101a110101011111110011111110122102020122112PPP0212112a1100111111111011111111110122012111100112122021212110221122121110122021201101111a1111111111
0110111a11111111111a111110110011111000011110112111221120121a10P212201b1211111101110101111001111111111121102221102112222122222202121101221112111011111a1111100011
1111111a11011110111a110111011011110110111011221212200010100a220PPPP21a0010111100111110011111000101120011111010221222021200100211200022211212101111111a1011110011
1111111a11111011111a101101110111111111111122221211010121202b0121201PPPP201100101111111111111111110112202201000102122120020202022212220010102121110011a0101111111
1111111a11111100101a111011111111111111111111121101121202202b101222210a1001111111110111011111101121212210121221000122222220111122122211222200210001111a0110011111
1111111a11111111111a111111011110110111101200022202110110222a211020212b2211101110111011111111111112122210221211202212112220201221011101111110221011110a1011111111
1111111a11111011101a111111111111010111110121222100211201221b012210211b2211011111001111111011111011202112211211202011022220110111201102121220110111111a1111000111
1110111a11011111101a011111111111011111110111222222122022210a122201200a2010110111011100111111111122111212222110210220202002022212112111221222221111111a1111101111
1111101a11110111111a001110111001111110111102101221210212112b212220110b2011101101111100111110100110122211001111120222122222221220222200222121210101011a1111111110
0011111a11001011110a111111101110110110111221222220221211100a102201111a2111111111111111111111111101120021112122222012212222212120012112012221111111101a1110110011
1110111a11011101011a110101111111011011110020111102102111121b122221121a1011111010011111111111111010222011201222202110212002100212212210012101010111111a1101111100
0111111a11111110101a111111111101010111110221110120002202221a122121122b0211011111001111001111011102221121122102012022222220022022212100101220201101111a1001111111
1010111a11111101111a011111110110111111011012021012201121210a122111202a1111111111111111111001101121000002120201112021222122220021221201221002110101111a1110001111
0100011a11111000111a011001101101101111110212210022112211221a111112111a2211110111101101111110111111221211101111122102201201202221112221211120221111111a0101011101
1111100a01111111110a110111110101011111111110022102211111111a210012111b1211011011111011101111111101101122101211221002220102220210122201101222001100011a1101111111
1111111a11110011011a111111111111111111111122102102020111111a121210000b0111110101111101111110111101021212012112221221202022122211222212102121211111111a0111100101
1111101a11101101101a001111110111111111111210010202002212111b210210122b2211110011100111111001011121201112010222222212111112221001111111111111111111101a1111001111
1111111a11101111111a111111110011111111011101121011020001022b002112111a0210111101111101110111111110220111221102110020021212110111111011011101111111101a1011101111
0101111a11101011111a111110011111111110011111211101011210102a122022212b0211111111111111101111111112122111011111001212001111211211011111110111011111011a1111111110
