155 90
17 116
122 49
126 101
64 67
119 18
56 105
111 104
8 43
26 34

111111011101101000111011110111110111111110a010111010101011111111111011011111111001111110011111111111110010101111110111111110011101111111101110111010111111111111
110111111111011001111011001111101111001111a110111111111111110110111111011111110111011101011111111111111011111111111110111111011111111111011111011111011100100111
111011011111011111011111111011011110101111a1110011011111101111101111011110101010111111100001111101110011111010100111111aaaaaaaaaaaaaaaaaaaaaaaaaaaaaaaaaaaaaaaaa
101010011111111011010100111111111111111101a1110111110011111111111111111111001111111111111110111111101100212200002122100a1221212110111221110111111111010111011010
101111111111011110111111111111001011111101a1111101101101111111111110111111111111111111001110101111111001102222220202111a2200212111212211110111111111110101100111
111011011011110110101111010011101111111101a1111110110101011110111111100111111101110011111111111111111111122211201020212a1222211212201101111111111111111111111111
111011011111101110010011011110111111101001a1101111111010011111101111110101101111111111111101101011110111120212012211020b1212112012010110111aaaaaaaaaaaaaaaaaaaaa
111011101111111111101111111101110111111111a1111110010011111111111110110011111101011111011101011111011111121122001222001a2122211212201211110a01111111011111111110
011111111111011110111111011111111111111111a1111100101111101010011111111101111111111111101010111011111111201101210111212b2001202102111021111a11111111101110111111
111111010111011111111111011111111111110111a1111111111110111011111111111111111111111110111011111111111111221121012201110b0010121102001221101a11110111111111111111
100111111110011111101111011011011110110111a1111010111110110011111011111111111110111111111111111111111111111112010112111b0202222212012221111a11111100110011111111
111110101101111111110111111110101111111001a1111111101111011111011110111010010101111101111111011101101111101012102101222b2211112122211111011a11111111011111100111
110101011011111111111011101110001110111111a1111011111111011110101101111100111111011111111011111111101011112220220012020a2210102121021111111a10111110111111110111
011101001111100111111011111111100111111110a1001101111011111111111111101001111111111111100111101011101011212222012211222b2211102111101221101a11101111111110110110
110111111111111000111111011111110111111111a1110111100111101101110001001100111111111101111111000111111111110111101210000a0101111221212121111a10111111011111111011
111101010110101101110111111110111111111101a1111011110111101111111110010111011101111111000111111111111110121102112012101b0210112221222111111a11111110101011111111
111101011111001111111010101111111111111111a1011010111111111101111111111101011011111110111101111100111111010201221211221b2210122122021100111a11101111011111101111
110111111110111101110011001111111111111111a1111010111111111000111101111111110101011101111111101101111111012011012022121b1201122111102111111a00010101111001111111
111111110101101101111111111111111101011111a1111111011111101111111111111111111111101110101111111111111111121221101020212b2211212220121221011a11011111111111101110
11aaaaaaaaabbbbaababaaababaabbbabbababbabba0100111111111111101111101110111111101100011111110111101111011212112122112121a0121211121112210110a1111111aaaaaaaaaaaaa
11a11110011112220011220111221121210110101210111111111110111111111111100111101101110110101111111111111101112012121010002a0110112112212111111a1111111a100111110011
11a11101111022012221211121111111002012222210000111111011111101111111111111110111111111111111100111110101222202201221012a2110102022120211111a0111011a101101101111
11a11111101021112201201211102210102222022111111111100111111111110100001101111111100111101111101010111111221022101212201a2221211201111020110a1111011a111011111001
11a01110111110112101202101112222010222222211001010110111011111111100111111101111111111111111101111011111111112102122201b1120222202021111011a1011111a101111111011
11a01011101000211222220221221011211121201211111011011111111111111111010111101011100011111111111110101111012221121111010a1121122211202211111a1110101a000111111011
11a11110011211002122111120211212012201202011101110100001111111111111111110111101111111000111110111101111221122220111012a1212110202211200010a1111111a111110110111
11a11111111212212210211122201222020102220211110111111110011111111111111110110111011111111011111010111111210212012201122b1222222212101001111a1110111a111111111101
11a11110111100000212121011101101211112222211111011111111101111010101011111111111100111111111111111111111211120100021121b1211020112110110111a1011011a011011111001
01b20202022221221022212221222222021120122111111101111111101101111111111111001111110011101110101111111011221111120212221a1221202222222101011a0001011a011111111111
22b21222112020100112002202022122201220112211111001111111011111111111111111111000111011111111110111101111112012201221110b0222111002012220111a1111111a010101001011
21a12111111122022222222222102022102120220011110110011111011101111111010011011110110011111100111111111111122012102222121b2121201122212221110a1111011a111110111111
10a11101011222021211212222022122112122112111100011001110111111111111100111100111011111111101111100111100212112022122222a0100202222111221111a0101111a111111111110
12b01212110210222002222222222111202202111200000111110011111111011111101011011101111101101010111111111111112002200111111b1101010022022021111a1110111a111111111111
12b20212222022212010022221222022110020122201111110101111101011111111011010111111111111110111111011111111200121121111012a2121222121122220110a1111011a011111111011
11b11121122101221121021022202221101212212211011111101111110111110011111111111111011111101111111111110010111220100110122b2001111021202220211a1111111a111101111100
21a21201102022122020000002222220202220112211111111111111111111111111111111011111011011111101111011100111110222022212221b1212201100212110001a1101001a111101111111
10a10101012222222222202012220221222022111011101111110111111001111011011111111011111111101111111011001011111210212021220a1021221112112200200a1111011a111111111111
10a22112122022201222200211211221201201212211111111111101011111111111111111111000111101101011101001101111111221112002111a1012011202211010101a1110111a111111111101
22a22101212222222021201221210012211202120100110111111111111100111101110111110111111011011110101111111111110111102221121b1111200001220201111a1111101a111011101011
22a21012111012201202222221212221122212002011111110011101111110111100010111110111001101011011111101101101101221021111020b2122022220202210121a1111111a111111111111
10a11211201202212222222222222011221022120011100111011111111010101011101011111101111111111110111111111110111012211022200b1121222112102222111a0111101a110101111110
22a12101112221021020022212011122111122220101111101111001101111011111111101111111001111111001110111111110111200102212022a2120222210012111201a1111001a111111111111
00a20112101121112122021022212222222211122101001101111111101111111111011001011111101101101111011111110111111012211211101a0222022212222222021a1111011a011111110111
20b21122211222020222220122220220121220201211110111111011111110111111111111101100110101101101101111111111111221020122111b2022212111221222210a1111111a101111011110
21a21212122220222222220222122210101201122211011111111001111111101110111110110111111110111111100011101111111112122220221a2222111222121120101a1111001a101111110110
10b21122221122111202220120222212212221201101111110101111111111111101001110111111101101111111111110100101111112210001112a1202110021222121221a1111001a101110111111
02a12111121202202200022222022122221121220011011111011111011101111111011101101100011111011111111101111100100011220200110a1011110102020122020a1111111a101100111111
10a12221211220020222022001012222111012211211101111111111111111110110110101101111001111111111111111001001111112110210221b0211021200022102121a1110011a011111100111
21b11212122222102212221122222211122220120210101111101111111110111111111101110111111111111111111111111111111022121212111b1111011022222220201a0011110a101010111110
02a01211211201012211220222112011100012212111111101011111111111111001010111111101010101110001011110011011111011120121010a2202221111210110211a1111111a111011111111
22a20112012012222012111012212111111111101110011011111101111111011111101111111011110111101011011110011101010122212220120b2011101001011101220a1111111a101101011110
11b02012212200210220211221211121100011111111110111111111111111110011111110111011111011111111110011111101111012111120220a1222110122111210101a1111111a100111011111
21a02012001120210222111112200121101011111111111112222111211211221211100212010222011111111101111111100111111011220121212a2211121212101221011a1111110a111111111111
12a21012022121222200121212221211110101110111011000212122110112021222221201111102101111111111111011011111101011121211212b0211210220200122011a1011111a111111110101
11a01221002121021011112222202211111111000101111012222010112121021220120121112221111111111011011110111111111000101112222a1101112122211111111a1010111a101111111111
22a21111211112122102101001201200101011001101111111011020111201202202122221121222111101110001011101110111010112112201102b1211212112212221021a1111111a110111111001
02a10112121010122212111211211121111111110110101111112122021222101021112121111221011111111111101111111111101111221122011b1211210110212110211a1110111a011011111111
11a02011012222002211121120221001011110111111111112211200021120202122211011012000110111111110110111111101011022112112212a1020220200121010211a0111011a111111111111
22b00110220101121221122100112111111111111101111012022121112102102221102211120012111011111110111111111101111012010111120b2121102102221211211a1010011a111110011111
11a11111111111000111101111101111111101011011110112122111122122220221201112211111111111111011101010011111110212211212211a2122011110012101121a0111011a111101111101
11a11111011111111111111101011001111111111011101112120221220021220001211122210111011111110111101110011111100002120012220a0101022220221012121a1111111a011110111111
01a11111111111111100111101111010011111111111111112012022022010122011111101102010110101111100110111110011111121121100112b0101201020100002201a0111111a011111100011
11a11111111111111011101111111111101111111111111112122221011222122102111201102221010111111111111111110111111001102020102b0221001120220200111a1111111a111001111111
11a11010111110111111110111111001111110111110111000022112020022222120121202022222111111011111111100111101110010100122211a1111201110110202010a1010001a101110101111
11a11110011110101111011111101001111000111111111012202210110210021221122102101010111110111111111111011111111212121221002a1212022221121220211a1111101a111111101111
11a11101011111111001111111110111111111111110110110112002021022221122202102220200111101010111101111111001111101101111111a1111011011111111110a0111110a001011110101
11a00101111110111111111110111101101110111101101102101010122220222012212212222222111011111101011111111111011001011111111a1111111001011111110a1101111a111111111011
01a01111110111110011111111111111111111111111111102212120222200212120210101122122001111110100111010001111101101111111111a1111111111111111111a1111011a110111111111
11a01011100111110111111110110110011111110111111102010221110111210022122102211021111111111111001111111111111010101111111a1101101111111111111a1001001a111011111011
01a11111111111011101110111111111111111111111110112222210002201112212222021212122011011111111111110111011011111011111110a1111111111101011111a1111111a111110111111
00a10100111110011111111111111111111111011110001112202221012102212221112012212122110110110111111111111011100101111010111a1110111111101111100a0101111a011110111111
10a11101101111111111100111110110110111111110111011212222221110222202212211222221101100111111101011111011001111111111110a1111111111111111101a1110111a111101110111
11a11111111001110101101101111111111011111100100011002122112212220021111111111111101111110111011111011111101101111110110a1011101111111001101a1011111a011111101111
11a10111101011011111111111111011110111111110110111112111021112122210222112211202111011111001111111101110110111101111101a1111110111011111111a1100111a011111110111
01a11011011011111111011000111111100111111011100112112121122122211022222010121222111101111011011010111110111010111111111a1011101111100111111a0110101a010111111011
10a10111011110011111110111111111011111111011111112202212010222111212102212222121101111001110111110011111111101111111110a1110110111111111111a1011110a011111111110
11a11011111010011111111011110111111111111111110012212210012112220111012220221120101011101100000101110111011111101111111a1111111111110111111a1111111a101111011110
01a11011011011111011111101111001011111111110111110122111211111211222101222201202111011011111111100111110111101111111111a1110111111111111101a1011101a001111111111
11a01101011111111011111111101111111110011101011111112121210122201211221211121200111101111111111100111101111111111111101a1011011011100110111a1111001a010101101001
10a10110110111111101100111101111011111110111111101121121211202020112212122112220000001111111111001111101111111111111011a1111101111011011110a1111011a101101110101
01a11111111111011111111111111111111110011111011002111201122222222112122121212211111111111011111101111111111111101111111a1111111101111011111a1111111a101111111111
11a00110111010111110101010111010011111111101110111112222111100221201200111120211110111110110111101111101110111110010111a1111110111011111011a1111101a111111110001
10a11111001111111101111111111010111110011011101110021202110022011110222112121122111011111111011101101111111111111111111a1111111001110111111a1011011a111111101111
01a01011111111011110101111111111101111011011101111111111101100011111101001111111111101111001111011110111011111111111100a1111111001111111101a1111111a010111111111
01a10111100111111011011101110111001101111111111111111101011011111110111111111111111111111011101111011101111101011011111a0111111110111111111a1111010a111111110011
11a11111111100111111111110111011111111110101110111111011111111111111111111111001011111101110011111101111110111111111001a1111101111111111110a0111101a010111111101
11a11011111111011010111111110111110011111111111111111111001110111111101011111110011111011110110111111111111111121122122a1010212022220121122a1211100a010111111101
01a01111111111011011111111110011111011111111011111111111101010111101111111110111111111011111110101111111011110112221101b1012122120121211112a2210111a111110000111
11a11111111111110001011110111101011111110111110111111111111101011111101111111111111011000111111001011110111111112211110a1022021010122111120a0210100a101101111111
11a11100110111010110011110111111111111001100111111101010111111111111011101111110111111110101111122110112020222100222122b1122002122002122001b1211111a111111110110
11a10111101101111110010110111111111110111112112122212110222110011202020111111111010111111111111022021201202122022112201b2022122101001222101b0001011a110111111101
10a10111011011111111111111111010111111111221112120212111111202001021012101111111111110111111111102211111211201202222222b2221210212121212220b1011111a111110111111
11a10111101001011011111111111111111111111200201210022011121211010011211111111011011101011111011112221001121211112122221a1121011211021121120a2211111a111100111011
10a10111110001111111101111111110110001101220221111102111211110112222200101111111110111111111010102111020211111121211221b1112122121120102111a2211111a111111101100
11a11111100101111111111111111110111100111122202020112110110202011110010110101011101111101111011011222212011111112021210b0100202221221112021b0211110a111011101101
01a01111110011111101101110011111111111111120112122122012000101212120121001111111110111011011110012200101200211101020222b2222202111111121211b2211110a001101101111
11a11110111001100111111111111111111111011121101110022212212021200011022211111110111110111110110112121211222112110210202b0012122012102111212a2211111a111101110111
11a11111110111010111101011111110111111111111111221111101101022220211210211101110010111110111101111012110101210012010212b2200222211102220122b1111011a111111111111
11a01011110111111110111111011111101100101100222212022012220212022120121211011101011111110000011111201212211111122121222b1220122111122112000b1111111a111111111111
11a11010111010101100111110011110111111111212211122122100012210111111112111111101111001101111111120112101201202111122212b0202212122101220200b2200110a011110111000
11a10110011111111111111011111110111111111201222121110220120022200121111111011111011111011111100122022211221120122022221b2101021121222102122b2111111a101101101111
11a11101101111110011111011111010111100111021221122122122210221201220211211110111111111110100110120021211211001122122212b2221112211210211111b1011111a011111111101
11a101110111111111110111111111111111111aabbbaabbbbbaaaaabababaabbbaaababaaaaaaaaaaaaaaaaaaaaaaaabaabbbaabbbbbaaabbbabbba0222202011210122120a2211111a001111110111
10a111110111010100100111111111111101111a112020121210122021221122122222121100101111110110011111010111122222021102220212221122210211211102200b0211111a110011011111
10a100111111111111111101011101111111111a112102022021221110221111111211111111111111101111111111112122022210002111222200021202222210121111110a2111111a111111110111
01a011111110111111111011110101110111111a021012212220112002100021122112221111110111111111110111110020022121110010121212110212222012100210221b1211111a011011110100
11a111111111110111111111011111111011011a011101112212101021211101112212221111101110111110101011111121011021222012121122222222011100221222200b2111101a111111111111
01a111111101011010001111111111111100111a121201202221221022111220221112211111110111111011101111012111121221111110012210222222022120122201210a2111111a111110111111
11a111101111101111101011001101111010110a122112022222222021101100102022221111101110111101011111112221112201201210222222212220022002122222212a2110111a011101011101
11a001111011111111111101101111100101111a011010011211210221122200222222201111101101101111111111112211211120100120221120210220221210101212101b1201011a111101001110
11a011011111111111111100111111001111101a012021201122211012121011212122211100111111111110111111111001221112221001122222222120121022010021221b1101001a111111010111
11a111111111011111111100110101111110111a122220221112010022111111111120111110111110011111111111112022202111121211220222120222022002102122201b0211111a100111110111
10a011011011101111011111110111111110111a102210012112122021112222000201021111111101111111010111112012212211222212021221022220022120021200220a2111010a111111101111
11a111101111101111100111011111111101111a120102111222022021110220221112110100111111111011111111102120112210111112220222222022011011110011112a2111111a001110111111
00a111111110110111111111100111111111111a111222011222121122001111211211211010011010001011111100111010011021011222222221221212212111112110121a1011111a001111111111
10a101111111011110101111111100101101111a112122211222101012012101112211221111111011111111111110000020212211201212022022202222002202112020110a0111111a111111101110
11a110101110110100111111111101011111111a112011121001202012220110121221211111011011011101110111112211211121210212201222220022102111220210202b2110110a111111110111
11a111111111111011011111101011111111111a111011012221222222112022001121101111101110011111111111112212101122120222102211121011212111111001111a1011011a111111110111
11a111100111101111111111110111111001011a122211120211110122101122212111220111010111111111111110110011221121011110112011122111120111111111111a1101111a111111110110
11a011010111111011111001001111011011111a120122202221111112110102211012021100101111110110111111112011221112102001122012022111011100111101111a1111101a010001001111
