84 2
70 104
122 49
126 101
64 67
119 18
56 105
111 104
8 43
26 34

111111111111111111111010111101111111011110010111111111111111110101111010100111011aa1111111111111110111111111111101111111111101111111110111111011111011111100a101
011111111101111111110101011111111101110100011011101111111111111111010111100111111aa1011111011111111111101111110111111101111111111110111111111111010011111111a101
111011110011110111111111110111101111111111111111101011111110011001111011111111011aa1111111101111110100111010111111111111111111011010110101111110111111111110a111
001111111011111111011111111111100110111111101111111011111111011111110111111111101aa1111111011011101111110121121201122110121120012121012100111101011111110111a111
111111111001101111111111111110101100111011011000110111110110011110111111101111101aa1101101010100111011012122110100122201212112221222221101001011101100101111a011
111111011011101011111111011111101011100111001110111111001111111011111111111111110aa1111011111111011111010011102022122102222121220121221110110111111011001111a011
111111111111101010011011110101111101011111111111110111111111111110101001001110100aa1111110111111010111011022102012120221220112222212201110011111111101111101a110
111111111111111111111011110111111110110011111011110101111111111111111111111111101aa1111111011111111111110221201110100202221202112122111111101111111000101010a110
011100111111000111111101111110111010111100111011111100110101111101011111111110111aa1101111011111010110110100011220222022221121101021100111111110001111010111a111
111011101111101101110010101111111111110101110111111111111111111011111111111111111aa1111111110010101101100212212112101022120211221112212111111111011110111111a011
101111111110111111011111101011101011111100111011101111011111101111111100101101101aa1111111101111101111012112121221112122222112111212222011111010111101111111a101
111111100011011111111111001111111111011111111011101010100100111100011111111111111aa0111110111111111110112221011202112220211222002021211111101110111100111101a110
100111110101111111110001011101110011110111111111111111011101011011111011111111111aa1011010110011111111111111012110211202100121012102200111111111111111111111a111
111010111111111110111111111111101111111111011111111111111011111111111001111111101aa1011111111101111010111101211110222101210121202211012101111110011111101001a110
011110100001011111111011111111111001111011111101101111110111111001111111111111111aa1011110001011111111012211112121111100121220222211112110111111101110011111a111
111111100011111001100111110101110111111111111011111110011011111111100111010111111aa0110110101111010110112111102002220202200221200121012111110010110111110001a111
111011111111011111111011111111111110111011111111111111111110110101110111111111111aa1111111111110111111112121121221212012111012221112121011111111011111011111a001
111111110111111101111111111110101010101011110101111111011110111100101110011000110aa1111110111010111111012211001012220202212212102110222111111110111111111111a111
111010111011101111011011111100000111101101111101001110111111111011110111110011101aa1110111110111110101110022120202222210211112101201200111101111111111111110a111
111111101011211001122222220110021202001122011111110111111110110111010111110111111aa101010110101111111110212122bbabbaaaaaabbaababbba2122111111111001110111011a111
aaaaaaaaaaaaaabbbbaabbaaabbbbaabbbaaaaababaaaaaaaaaaaaaaaaaaaaaaaaaaaaaaaaaaaaaaaaa111111111011011110111111101b2210211201111110222b2010101111011100001111111a111
1111111101122121221122122220211221120222221011111110011111111111011111110111111111a001101111111111111111221212b2212022112121210121a1221111000011111111111111a111
1111111011110011122102120211111212100120101111111111110110011111111011111101111011a111111101011111111101210211a2102121122122112001a1112111111111011111111101a111
0111111011120111102122202022111010221212111110100100111011110101111101111111011001a111001110111111111010010112a2112202222211022102a1022111111111111111001111a011
0011110111100211212011012122212201111121221111100011111111011111111111111101111111a001100111111000101111100221b1111211122112110212b0222111011011110111111101a011
1111111001122101212001111221121211222122101101011111111111111110111111011101110111a111101111111111111011001020b1220110222121221021a1212111010111111011110110a111
1010111011110001022111112121122110122110121010011111110111101111110011011110011111a111011111111100101111221201b2111020010211101122a1110111111001110010110111a111
1110111110001122112220001011121121212212111111101011110111111100111111011111111111a111011011101101110110112111b2021101222020211002a1221010111111111110111110a111
1122112122221122122220222202122121011122211011111111111110011100011111011101111110a011111111010100111110220111a2220210001221211022a1211111111111111101111111a001
2110212110122202122020222022222010221212210111101111111111111011111111111111101111a111101110111011111111011200a2121210101021202200b0122111010111111010111111a111
2001112021222121222222212000001002221112001111101111110111110111110111110111111110a111101111111110011011121222a0221002102112022200a1012110111111111111101111a111
0121102112122020122021222121210102201120210110111111110111111010111011101110111111a101111111101101011100011111a1212022121222211111a2121110110101111101101111a100
1211102121022212212022122222210110121111221111111110110111101111110111011011111111a010011101111110110111211122b1222201222221222111a1212110011111111111011101a011
1211121210220222101222221012202002022111201010111110111010101111111101111110111110a110111011011111011111021021b2121121221112122202a1101111111111011111011011a111
1110221020122212222222222220222222211011121101111111110100010110111111100111010111a111111111110111110111111211b0001220210121210212a1112100110111111101011101a111
2212122202112220222100102222021221200211111111111111111101100011111111110011111110a110101010101110111100101211b0122102122221211222b0101220111111111010011111a010
1022100222220222212222222201212202121221211111111111111101010100111011111111111001a001110110010111010111011002a2222112121001210022b2212222111011011101001111a111
0222221211121002221222202112222110120121011011110100101100111011111110101110111111a111111111111101010011111022a0120211211221201210b1121121101001110111101100a011
2221221011001211021220222220220011122221021011101011111111011111101111011111111110a111101101111111100111001122b2100222120110111111b2111111111110010111010111a111
1221222111122202102002222111021100111022101111111111111111111111110111111011110110a111111010101101111110111201b1112110122001202221a1222200011110101001111111a011
baabaaaababababababbbbbbabbabbbbbbabaaaaabaaaaaaaaaaaaaaaaaaaaaaaaaaaaaaaaaaaaaaaaa011111011111111101111010212a0002022222212201202b1221221110010111101110101a010
21120011110222022222221212222222012202011210111011111111101111111111111111101110110111111111111111010111101112b2121221201022122211a2220212010111011111110010a001
22121122122122022021222202112002021110222210111100101111111111111111110110111111111110111010111111111111101120a2221010221201210012b2102221111010111101101111a011
22121201022222000102001020022202112102020100101111011100011110111111110111011111110101111110111011101111110212a2221112120222121211b1210122101101011100010111a111
11211222121000212010002222222221122112201011111111110011111110011111111111110101111111111111111011101111111200b2212001220101222020b1111021111001101111111111a011
11211110011222121222120220022220121102220011110111111111111011111111111111111011111011111111111101111111001210a2212100121211202021b2221100111111111111111111a111
21202021012221022222221022212222112221221211111101100111100010111111111111101101010100111011111111111111111012a2120121222101202120b1112212111111101111111110a101
11121020112200201222221022211121121221120011111111111101110110101111111010101111010111111101011110111111111012b1212022202222110101a0211111101011100100111100a110
20010202101002122001222022221022112122112111111110011111111101101111100111111111111110111111101011111111001220b2222122221221222122a0121001011101011111111111a100
22011021122120122102222020102221222000022111111111111011110101111111110111111111011111010110110101010111001000b2122212222002022112b1210221111111111110111111a110
22120021111120211210210022222121110111000111111111111111111110011111110111101110111011111111111100111111111101a2101212120202221201b2212201011111111111111011a111
22121121121012110011112022122201110110011111111001111110110111011111110110111111010111011111111011111111101112b1222201210110212210a2122202111111111110110111a111
01120100221211121121100221021011111010111111111111122101011001221021211100212021101111101110111011110101111102b2201210111220102111a1002112101011111111111111a101
10201221211011011002222220211121100001101111001112111212112111210021110121202011111110111011110111111110111102b0022001011020101202a2221101110110111001111111a111
11211220011111002220122122201201111111101111110112022111121022120210101110001112111111011001011011111011111202b1201120021121222212a2120222111001110111111101a110
21001221111212211122210101120201111000011111011112011002222111121202120222222201111011111110110111111111111211b0001122020120021222a2212111110111111111111011a111
11110011110211102101211121102221111111011111111112201010002212002101112112111210111011111011111111111011111220a2222212212011221112b0222021110011001111110110a011
00110121211020221022221112211121111111110101011112211211101121122121121112221121001011110101111111111111111211b1220211202122111121a2111120111111111111111110a111
00121101201122111122101221121110110101101101111111022202022221112122121212210212110110111111111111101111101002a2100121221112120111a2111200111010011111111011a111
11111111011111110111111111101101010110011001111111011012212112221122110212212022110101101100110111001101111101a1102122112211211121a2112202111101111011101111a011
11011100111111111111111111101111111111001111011111201120120111012202000122101110111101111110101101111111010021b2101122122122222211a0021122111101111111111111a110
11011110001111111100111111101111110111100100111112122211121202221121200220222111101011011111101111110111011222a1100202102121202111a0221001011110101011101111a111
11111111111011111111101110111111111111111110111100021221212111111010122201112212110111111101111111111111111210b2112002122200211111b0112101111111101110111110a001
11010111110111101100110101111011101111011101011111111112220122112111202101022212111111110011111111100111111222a1211212220000021110a1101112111101111110111111a101
11110111111101011111101111100111111110111110111112101122211221121221201022212210111001011000111111101111111222b2120022212221120211b1220222111011011111111111a111
11111111111100111101111110111110111011111101110111010011121001111221121220211220101111111010111010111111111011a1111111111111010111a1100011111011101111110101a111
11110111010110111111111111011010111111111011100110212201220201222111022211112212011100110101101101011111010101a1101111111011111111a1111111110111111111000111a111
11111101100101111111110110011111111110110110111112011222211211112101122221212222111111101111111011101110111010a1011111111111101111a1111111111110111011111111a100
11111011111111101111111111111011111111110101110001221212002012121111221121201002111111111111001001111111111111a1111111110111111111a1011111000111011100011111a110
11111011111111111111111110101111111111110111011101210121221102121011001111111220111111111101111110111110101111a1011111010111111111a1101111110111110111111111a011
11110101111111110111111111110101111111011011111100211121121102110011122102120011111111111100011110011111011101a1010111111111111110a1111011001111100111111101a110
01111111111110110111111011111111110101111110101112122012111111221201222220211221101111111111111011110011011111a1111111101111111110a1111101110011111011111111a100
10111111111100111011101110111101111111011111111012011211201121122222222111021121111111110110110111111110101011a1111111011111110111a1101111110111110111111111a001
11111110111011111111011111111111011111001111011112022201222220211121001211102111001101111111101111010001110001a1111111000111111011a1011110111111111110111101a011
01111101110011111001110111010111100110111111111111020012102012201212222111112110110101111111111110111111111111a1111111111110111101a1111111111110001101111110a110
11100011111100111111110110111111111101111101011112220221211021022021222112210200001101111011111111110111111111a1101111011001111011a1111111110011111111111111a101
11111111111111110111001111111111001110010111111002121201222101202200202022111222111110111111111111101111111010a1001111111111110111a1110111111111110110110110a111
10010011111010111111111111110111111011110111111112122221201222111012122222121221101110000110001110101011011111a1110111111110111111a1110011111010110111111111a111
11101011111110110010100101101111111111110111111110101210022220221012112212202220011111101111111011011011111011a1110111111111111110a1110111111011111111101111a010
011111111111111111111100111111aaaaaaaaaaaaaaaaaaaabbaaaaaabaaaabaababbbaabababbaaaaaaaaaaaaaaaaaaaaaaaaaaaaaaaa1111100111101111111aaaaaaaaaaaaaaaaaaaaa11111a111
111111111111111111011111101111a11111111111111111122021101222110020112121221011021111101111111111011111111001111111110111011111111001010011111111100101a11010a011
111111101011101101111111110111a11111111101111000121212111112021121110201210112101111111111110111111110110100111101011101101111111001111111111111000110a11010a111
000110111111001101010111111111a11111111011111111001120102212001012111211220220221111110011110101111100111101111001111111111111111110111111111111111011a11111a111
111111111001110101110111111111a10111011111111110111111110011111111111111101111111110110111011111111111110101111111110110111111110110111010111101010110a11011a010
101011111111101101111111111101a01111111110101111011111111011110111101010101111111111010111101101111111111111111111100110110100111101111011111111100111a00110a111
111001111110110110110111111111a11111111111011111101111010011010111111011111111111111111011010011100111111111111011110101111111111101001111111111111110a11111a011
101011111100111111100111001101a11111111111100111111111111110111111111010111011111111111111111110011111110110011022211121111222111101112211211201011100a11001a101
110011111111011111011111110111a11110011111100111101110111010001111111111111111110101101111111111111100011111111101200211102210201212122011101101111011a11111a101
111111010111111111111011111101a01111111111110110110110111011111001111111111111011111011110011111111011011101101121021211120211220112112202122101111111a10111a110
111101111101110110110001111111a01101111110010110101111101111011101111101110110111111111111111010120212021012101022222022122222020222112221210211111110a11101a111
110100111111111111111111110111a11111111111211212211122120120101011022101111111111111110101110111221202211221011221020122211222222121110222201101111111a11111a111
111111111111101111111011011111a11111111112120112212120122221122011212221011011111111101101111110102112111222102222222202022222221222220200111201111011a11111a110
111011111111111101011110011101a10011100111210111010220111201111212202101111111110100111111101111121010120022102012220001220200111001211121022011111111a11111a111
111101111110111111111011011111a11111111111122111212220211011211221102111111101111011101111111111102221112212111220200222222122121112112111212211010111a01011a111
111111111110111010110111011110a01101010112100220101121012101220122200121111111111111111111101110222102121201112222222122202202201111011122221111111111a11111a010
111010111011111011111101011011a10111011112202222112120210102221021122121111111111111111111100111111222121202222012122120002212220222121211211101110011a11111a101
011110111101111011111111011101a11101001011111221212102212212021102222212111101111110011011111111122020210121210212122222220120110122120101110211111111a01111a111
111101011111011110111111101111a10110111111221110022111011210011222102220111111111101111111111111211010212212102121222022222022202011122012111111101100a11111a111
111111111001111110111000010110a10111110112100221220221122222211220111112011111011011111011011110112011011111102012222222222221111012212212211110111111a01111a101
110111101111110011111101111111a11111101112100122110122202210121121202110101110110001011110011110212122222222111221201021222202101112221110022211011110a11101a011
011111111111110111111110111110a11111001101122121120111202120120202120000110111111101100011010110221112212220112210112022201010010121200111220011101110a01111a101
011111011111011111111111101101a11101110102212201121011102221122122222201101011110111011010101111211212201121210222211111120222221222201012222111011110a11111a110
101111111111011110110111111011a01111110101110211210211012112111011111102110111011111011111111100021212101202201120021220012101112122212012120101101011a11111a011
111111111111111001111011111111a01111111102201101111200120212022011210211111111110101101101101111122111112211111022022122221212220211111211011211111111a11110a101
111101111110010011111101111111a11110100111222221212200010112012111221122111011111011111111111111211020102101221211221212102222011101222102222101111111a11011a010
111111111111101111111111111110a11110011112221111021112212211120210212220111111111001111001111110122022121222212122222222222120201101101101102110111111a11111a111
110101111101111011111111001111a11001001112200121210011202011112012222022111111001111111111110111122111212122120220202222222222112222110101211111010110a11001a111
111111101010011111111111111111a11111111112110210111122211110000211212211111111101011100101111111020212211122102202222222111222221112021221211101101111a11111a111
111101101111101111011111111001a11101111112122222022022120112212112211011111111111110011111111101212001021101221222220122222002121112221110020211010100a10010a111
101111100111110111111011111111a11111111112021102200101012202221122222011101111010011110111111111211110220120102220222002221021021222120100211111111011a11010a110
111011111111011111011101001111a11101110100102212210120112220111122212102011101111001111111101111011200102222122222222201222022211222222212111101011101a11011a111
101111110110111111101111111111a11111010110122111120211102212222010222212110111111011101111111111220121102101221221222222002022221221121110222011011111a11101a100
101110111110010111100011001111a11111100112110101012011102101122210202122101111111111111111110101120012110222102000002222101121221021202200222101101111a11011a011
111101111110110110110111110111a11111110112221120200112211022102220221202111111111111111111110111001121211022212121222202222212212002121011210011111111a01011a100
110111111111111101101110011111a11101110110112102011122220212112110212122011110011101101111110011210121101112122022220212112222222212100222101111111111a11011a111
101111111111111111111011100111a10110001112211212212221212211210221221210111111111111101111111111211122112221212012220202210211222111101222202201011000a01111a111
011111101111101101111111011011a11111111112122022222121111120112122212112101111010111111111010110111001102021011120022202200222201100102102111111011111a11111a111
110111101111111101110011101101a11001111112100101212110111221222212101111011011111111101111111111212211111121122201221011121121111111010111111111111110a11001a110
111011000111111111111101111111a11010111111122112101122201221121110212120111010111101111110111111011121002010221001122201221222211110110111111111111110a01111a101
111110111111010111111110101001a11111101111122120221221212212102110111221111101110111001101111100112012112122022212100212222022211011111011101111010101a11101a111
