14 69
149 71
122 49
126 101
64 67
119 18
56 105
111 104
8 43
26 34

1111111001111011101101111110101101111111111111111011101010111110010111110101110100111a1111100100111a11111a111111011111110110110111011111110110111a01111111111110
1111101111111001101111010111111111111111111111100111100111110111111101111110111011111a1111101011101a11111a010101110101011111011111111001111101111a01111110110011
1111101010110111111111101111111011110111111111111101100110111111111110111101101110111a1111100110011a11110a111110110011110101001111111111110111111a11111100011111
1111111111111111111111101111111011111111111111110101111111110111110011111111111111110a0100101110111a11101b222222112112211222220121112221111111111a11110111111111
1101011111111111101111111010111110111110111111111111111111011111011111111111011011101a1111111001111a00110b221002111002221112211221202210101111111a11111111110110
1111111111101111111111111110101111111111111101111011111111111111111111110111110111111a1111101110111a11112b101122212101111021212010220211001111111a11100111110111
0011101011011111110101011111110111111111101111111110111011111111111111111111100111100a1111011111110a01101b101210122100111001201111121111111111110a10011011110111
1111111101110011111011110111111011011111101111111111110101111101111111111111100111111a1111110011111a11112b112112000222102202212022200111010111111a11110101001011
1111111110111111011011011110100101111111011111111111011111111111111111111111111110111a0011101111110a11111b122221201112211202122110112221110111111a11111111111101
0111001001111111101111010011101111111111111111001111010011110011101100110111101111111a0111010011111a11100b122120112212001101112100102211111111011a11111011111101
1111111111101111111011010111111101010111111111111110101111111111100111110111111111111a1001101111110a10111b012020021221210102220111010211111011011a11011100111100
1101111101110111110000011111111011010111011011111111111111101110101111101110111111111a0111111011111a01110a101121211012201222102212112111100111111a01111110111010
aaaaaaaaaaaaaaaaaaaaaaaaaaaaaaaaaaaaaaaaaaaaaaaaaaaaaaaaaaaaa010101111111111111110111a0110001111111a11011a111111201212210020210221112221011011001a11111111110111
110111011011111111110111111111111101101010111011111101011101a110111111111111110110111a1101101111111a11112b222211211210202121121220202111111100111a10111110101011
111010101101111111011111111101111001011111111110111101110111a011111001111111111110111a1101111111111a11112b111222102201201012221221112221111111111a11100111001111
111110111100111011110110100001110111101101101101011111011111a010111111010011111110001a0111001111111a10001b122122102120202122222211121001111111011a11111111110011
011111111110110011111011110110111111111101111111011111111111a101111111111011111110111a1011100111011a11111a022211212222110122121221202220011010001a10111100110111
111011111101111110111011101111011111111001011110111111011011a110110000011111110111111a1111111111001a11111b211212222122211212122211201111111111110a11111111111110
111101111011111111110101110111101111111111101011111011111111a011111101110111111011011a0101110110101a11112b110212011211101102212122022220111110111a10111101110111
011110110101012101011121022010210121111110110110111111011111a111000101111111111111111a0111110101111a11112b022111111200020112101211011211011101111a01011011111110
011101111112110112200211220221121111012211111111111111111101a111111111110111111111111a1111011111111a01112b202101120112112221211021112220110100011a11101111111110
111001111102222012111122212002021211221212111111101110111001a110110101110111111111111a0111111110011a11110b112021122022022222212220021121110110111a11111111101000
101111111012111101111212120212110201110002111101111100011101a111100111111110111011110a1101111111010a11012a101020111001121102001021110210101011111a11101101100110
111111101111112200212211210121101220121222111011111110001111a111111101111111001111111a1111111011111a11111a211222022112112212111220011221111011011a11110111011011
111111111011022021121011221201222012120212101011110111111111a111011111110111111111011a1111111111101a11100a202222100222101202110120221100111101111a11111111111011
110100110011102112112201200102212220010222010001101111101111a111111111010001111111111a1101110111111a10102b212220222202011210212121222221111110101a11111110111011
110111111110111021120121210210222102021112111111001110100111a111101110111101111110111a1111111101011a01012b001002120122012022112021210110111111111a11111111111110
111111111101021112010210220210100121212222111101011111110111a111011111111101101111111a1010110011110a01001b122101210112202112212022022021110110111a11111111111001
221112122212120221222221222222100021110122111110111111111101a111111111111010111111101a1110111111111a01112b122112112121212011200002220111111010110a11111111101111
012011022112222000220202221221111110121010111110111010011011a111111011011111101011111a1111011100111a01112b102212220110110001120121111111111101111a11111101111110
021011220222022022112221122010212010211211111111111111011101a110111100111110111110111a1110011110111a11102b211211212021222212211002111111011011010a11111110111111
211011022222121122202122211121210122121011011111110111110110a011111111101111111111010a1111111011100a11111a222222222122112201121012121001011111111a10111111110111
1112112222121111220110212122222121210011abaaaaaaaaaaaaaaaaaaa001111111111111111110111a1101111111101a10102a202222110121020111202211212010110011111a11111110111100
2222111210222221202222122222222112211122b10111111111111110111111010111011101111111010a1101111111101a11111a021012111110002102200211221111111111111a11111101111111
1222122221121222210122212201022222112210a21111111111111110110011111111010111111111111a1111110110110a00111a122210121221211222211122122121001101011a11111011011101
1212011121222221222222222222202201212022a01110110110111111111111111011111111110111011a1111111111111a01111a121221122210221122111112101022210111111a11111011111110
0112222221002120022221202120122011222111a21111000111111111111011101111111111101101111a1110111101110a01111a120022002201222010112101220222221111011a01001111111111
2210022222101212021220112220022122011220b21111111011110111000111111111101101011101111a1111111111110a11111a102221211111121221211122221222001111110a11111111110111
1210102011210220220121121012201111022112a01111110110011111111101111101111111100011101a0010011111101a11011a102221222112212000120212012220011111101a11111111111111
1112022121202222102122102220022122222212a11110011000111111110111101111111001111111111a0101011111001a11111a101210110022120001112122212212111011101a11111111111111
2012221211222122020022002112222112210011a01101101110110111110111111101011100111111110a0111111110111a11111a122212210211102211122120121001110111111a11101011111111
1000202021102120210222112202211211212220a21111010110111111001011111111011111110101011a1101101110111a11111a112201201011120101122100112111221100111a11011111101111
2212020110201220220222212222222211112111a00101110011110101101101100110111111111111111a1101110100111a11111a102111102111121122112010222110111110110a11011111111011
1111010110011012002202121022101212112220b11111111111111011011111011111111111101111111a1111111010111a11101a122112112011200200110011110011111111111a11110011011111
1012112022102012202211220222120100212220b00101111011111111111111111111111110101101111a0111110011100a10111a101210202121100122202201211111120111011a11110111111101
2111221211022221220111112222102220222011b11111111110110111110111111111111011111001101a1111111101111a01110a112211122102121211121221121210210101011a11101111111111
1020201012122221212222021022020220010210a11111111100110111111011100011101111110111111a1100111111111a11101a022122212220221201212211111211121011101a11111111110111
1222102201202102212222122022210220111110a21111111111110110111110101111111110111111101a1110111111101a00110a100102112010221210111221010110121001011a11111111110111
1211221112012222202222222222222220001002a11110101001111111111110110111111110111111011a0001011011101a01011a020012212101121121011211111211020101110a10101111101111
0012221102122222211122222022201101122111a21111000111111101111111110111111111111111111a1110111111111a11111a012212220211112100021022211111101110110a10111111111111
1110220101002211200210122122220111111111a11111101111011111111110111111111111111011101a1111110111110a11010a101201222022121202222211111221021111111a11001010111110
2112011202210111102222222110112111111101a11111111101001111111110111111111101111101101a1110111111101a11111a112012222111001022111201201111011110110a11111011110111
babbbbaababbbaabababa1122121222110011111a11010100222222222011012211022212021111111110a1111111111101a11111a012121121212111120011212221022101111111a11101111110111
21020120022211122110a0201202122111111011a11111111110120221221210122212222222110111101a1111110111110a01110a102112102100122211211112221111221101010a11110101111111
02202112112111222112a2222122002111111111a11110111201021011222220220111220111120211111a1000111111101a11111a111020221202120221120101222002211111111a10101101011111
00211122112111102110b2022222121111110011a10011111221220221011201010211101012222211101a0111111101010a10110a112001221111012102112211112022211111011a11111111111111
11212122112122101020b1111201120101111101a11011111211210222111102201212022201202210100a0011111111100a11111a121221222222212102110201222202221001111a11111111011011
11120211112111111222b2222210002101011111a01111111212012221102121120102122110120111011a1101111010100a11111a122122121121112110210222011111221111111a11111111111101
11121101212112211110b1212012002110101101a11101111222121122201122220111102211210111111a1111111011111a00001a101020022102120220112000111122021111111a11110111111111
11010111011110111111a1111111010111111101a110111112102222202211222abaabaaaabbaaabaaaaaa1100101111001a11111a121120212111122222222110022202221111110a11111111111111
11110111111011111110a1111110001110111111a111110112122121000211221b110211012121221110010000011111111a11111aabaababaaabaaababbbabbbabbababbaaaaaaaaa11111110110111
10110100101011110011a1101111111110000111a110101111211220002202220b111112210221211100011111111011101a011111111201222011221121210222201211221111101101110101110011
11110110111111101000a1111110111111110111a101111111211122221120022b211112212110121001010111101111101a101101112011211000021220012110221101221111011011111101111011
01011111111111101010a1111011111111111110a111111112220211021101221b101001220221121110001010011010110a101001122120111101121112221210110012211111011111111110101011
11110111011111110111a1101111111111111111a101111101111022002112112b120012212221121010111111110111111a101110101122002100221110112222211101011110101111100111011111
01111111111011001111a0101111111111101111a110110112222212022211010a102211221022221111111011111111111a110011111111011111110101111111110110101111111111011111111110
11111111111111110111a1111111111111110010a111101112212212212012220b112221102022211101110111110110100a101111111111111011011111111110011111111011001101100110111111
11011111101011111111a0111110110111110101a010011112110211122021121a112202121121211111111001110110011a111111111111110101110011011110111011111111110111101111111101
11111101111111111111a1111011111111011101a111111102121012202221122b102121212221221011110110111010110a111101110111111101011011110111101110110111101111010111111111
11101111110011111110a1111101110111011100a101111112211001212211211b110222201102011010111111111101101a111011111111111111101111011111110001110111111110111111111111
01111111011110111010a1111101111111111111a111111111221012111110221b210201210211211011111110111111111a011101110110111111101110111111011111111111111011111101111011
01111110101101111111a1011011111111110111a111111111222211122212122b120212100100221111111111111111111a101111111111111011111111110110111110011111111111111101111111
11111111010111111111a1111111001111111011a111011110111211102222212b212122111201201111110011110010110a111111011011111111110111001110011111101111111111111111111001
01111110110111101111a1001110101110110001a001110112100112222210101a111002212112111110011011110111011a111111011101101111010111111110111111001111111111111011111111
11111111111110011011a1111011111001111111a111111111111122212010121b102210220111011111111111111111111a111101111101000010111100011111111001111111111001111111001110
11110011111111111011a1110111101110111101a111111101110221100111112b212201120220011111111110111111110a011101111111111111110011111111111111111110010111111111110111
10011011011001111111a0111111111111111001a111101011201010222121012a220101111211110101011101111111110a101111111111101111010111111111111111101011111111111111111101
11111001111110111101a0110111110111011011a111110112221122012221001b002201121112201011111011111111011a010111111111111111111111111011101101111110111110011111011010
11111011100111101111a1111111111101111101a111110110120112112112212b102211112122221111101010111111111a110111010011111111111111111101101111101111110111111111101111
11110111101111111011a0101111101111101111a111111112201120212120121b101012201110121011011110110111110a111111111110101111111111111101011101110001111111111111011111
01111111111111111111a1101111111100001100a110111110101012201210011a021012121200221111111011111101111a101111111111111011111111011111011101101111111111110001111010
11111110011111111110a1110011101111101111a111101101122211221111122b120010112222111111111011111101111a111111101101111111101110101111111110111111111111001111111011
01111110001101111111a1111111110111111110a011111111112112212210100b112222212121111111011111101110000a111111111111010111011111101110010011011100111011111110111100
10111111101010111111a1101011110111100110a011111111111100111001111a111101111111111011111111111011111a111110011111111101100101011111111101111110011111111111101111
11111110111101001111a1111111111011111111a111111111011111011111010a111000111111001001111110110111011a111111011111110111101110111111111100111111111110111100111111
11111011110111001111a1111111111110111111a010011111100111111111101a111001111101111100111111011111111a011110111110111111111111111111111110101011111111111111010111
01011111100111111111a1111111011111111111a111011111111100111111101a110111111001110011011111111111111a111011110112200112211112011010121221211011111111111011111101
01111011111101111111a1110111011101001010a111111011101011111111111a111101111110111110101111000111110a011111011112110210200011122102120102211200111110011111111111
01111101111111111111a1011111101111111011a111101011111111111011111a110111111111110010111111110111101a111111110111120012120222121112102211201221101111011110111111
01010111110011100111a0110111111100111110a111101111101010111111111a111111011110110111101011011111212a202122112022020222020222222222222202100222111011111111011101
11111111101110111110a0111111101000111110a122121200001112120010122b112221110111111110111111111111111a222211011212122202222210021211220212121112111111010111101111
11011111111101111111a1111010110111110110a112111111221222112121201a221120011101011111010111111011101b111111121202202100201022202201112210122102011111101111111101
11111100110111111111aaaaaaaaaaaaaaaaaaaaa121121210212112210212121b222211111111011111111111111110022b221201022202102220212212022201212220212221101110101110011110
10111110011111101101111111111111111101110111221211210211001021011a120020111111011101111111111111101b202102222022021200022021220021020010212112111111111111101111
10111101111011110011111110111111111101111112122022211122022221202b011001111011010110111101011110112a111111212012022020220222222202221001202012011110100101101110
11101010111111011111101110111111111111111212021220021222211122122a001202111011110111111010111111011a111110102202010220022121222111111211110122111111011111011111
11111111111111110111010101111101111111111002221121102122112101111b110122110111011111101111111101102a122111020222021020222222022022200211012121010011110111111011
11111111111111111111111011111111111111111022102222110211111112021a201202111101111101111011001011222b211202220201212222202220202012011121122122111101111111011101
11111101011001011111111111111110011111111022220121111121101012111a021102110100111111111101101111220a112212002202220102211212202121011112220021010111111011111101
11111110110111011111001111111110111111101220212121102112000021121a120101011111111101001011101110112b111221121102222012222112202111202210010120101101101111111101
01111110101111111111111011101011111111110102122101221022120202122a021101111111111101111011011110022b211112222202211220022222221001211112122012110110111100101111
10011110111011101111111111110011011101111001221221000021201112221a100121111111111110111111110001021a122121202212022202202221012220111022122110011111111110111111
01110111111111111111110011011111110111110222120212202221121011011b110102111111111110011110111011220a212212110112202222222112220122122101021012111111111010110111
11011110110111111111111111111110011111111021220221222110112112001b111211111001111111011111100100222a010001121110222212000212021112221110011020111101111110111111
11111101111101111111111111111111111111101121112002212112002120121b211222010111111111111101101101222a120122102220022120101020101220122222212121110111101110111010
11101110110101111111111001110111111011111212012220201020112102211a012111111001111011011111111011211a021221112200222112111111122221112211002112111111110110101011
10101111011110111111011111111111111101111110210012012011201020010b221211110010111111111111111101211a222211112102212112022212221121212111121011111001011011111111
10111111111011111100101111111111101110101021110101110100102222112a221201110101111011000111111101202b221110011101022012221122222111102012111200110110111110101011
01111111011011111110111011001111111110011122010220121212002010202b212111111101111110111011111111101a201111201122010222202222221222022221111111111111111101111110
11101111111111100100010111111111111100011202201021202020112202202b112012101111011101100011111111121a021221120222212002222122202110020010100102111110111001011111
11111111111111111110011011101101010111111221221112222121022221222a221121101111101111100011101111021b212212121210221222210021201211210121122121011110110011101110
11111011111111111001111111110000101111010101112120222221221022122a212122111011101110111111111111222a011222020111022121200201220100011121022122111101011111011111
10111011100010111111101110111101110101111112122011122112102012110a200002000111101010011111001111121a001210112222000020020012011012111211212121101111110101111011
00101111111111111111111001101110101111101222122011222101220201221b211002111111101111100011111111221b121221221122222221002201100121001102101101110111110111111101
10011111111111110101111111101111011101101221102111121122100012221a121100110111111100111110100111222b102101221212202012222222001121122211110021110011111111111111
11101110000101011001001111100111111111111201210212220021222222202b112210011111111101101111111111101a110110102210201120121101022212221212111111111111111111001111
01111111110111011111011111110111111010110021121022211120220211021a200201101111000101100111111111001b102221111222222222222212222211202021122210111111010110011111
11111111111110110101110111111111110111111012111112101111011221202b112222111111111111110111110111121b112112001022020202100110211101111011110101110111101011111111
01111111110110110111111010111111111110101201102010120221112222221b001022111101111101111111111001202a121212102121012121221221110111110110111110111001111100110101
11110111111111111011111111111101111011111112122111002112211212220a112212011111101101111111110111211b112111021111210221211112021011011111101110001101111011011110
