49 18
89 103
122 49
126 101
64 67
119 18
56 105
111 104
8 43
26 34

111011111101110111111111110101101111101a1011111011111110110010111111011a1111111001111101011110111101101111110111111110111111011111111011111111111111111a11111111
111111111111111111111111111101111101010a1111001011111111111111111010111a0011110111110001111111111111110111101111111011101011111111111110011010111100001a11111101
111110011001011110111111111101011110111a1101111101111011100111111111101a1110111111111011110111111111111111111000011111111011111111011110111110111111011a10101111
110001111011110111110110011111011100111a1101101110011111110101101111101a1101111111111111011111111001101121221010011002220102011200100111111101101111111a11101110
010011111111111111110111111101111011101a1111011001011111111110100111111a1111111010010111011110101111111122011112022020201111002210220211111111011111111a11111111
111111101111011111111110111111111100111a0111111111100111010111111011011a1111111111111111011111111010101112010012012011212222221202220001111011010111101a01111111
110111010101111111110111110110110111001a1111111110011111111111100111111a1111100111111011100111111101111010201101112110020122200100101011111011111111111a11111100
011100101101110011111111110111111111111a1111111111010111111111111110100a1111100111111011111111111011111111102112112111021102202111021111101110001111111a00110111
111011101111111001011111110111010111111a1101011010111111111111111111101a1111111111111111111011110111111002210202121211111202000222121221100110111111111a10100111
111110111111111111110111101101111111111a1111101111111111110011111111111a1101011111111111111111110111111102121102112111022202002111021211110110111011111a10101001
111101000100111111101111111110110111111a0101111111111111110111111011111a1110010001101000111111110111111112022210112110122111212121222021111111111111110a11110111
100110111101110111011110111111011101001a1110011111111111111001111110111a1111011111111001111100001111101121112022200011222002102022102121011010110000111a11111100
110110111101011111111111111111111111111a1111111111011110011111011111011a1111110101111111111111101101111121122121121022211010221210221111110001111110111a11111111
111111111111111110111111111001011101100a1111000111011010111111110011111a1111110111111111101111010101111111112112111220001222011211110121001000001111111a11101111
111110111101110111101101101011110100111aaaaaaaaaaaaaaaaaaaaa11101111010a0011101010001111110111111111111102111202212000122102221211210001110011111011111a01110111
11111011111111110011011100011111111101101111111111111101111a10111111101a1111101011111111111111111001111111021002010200112112121002212011111111110100111a10111101
11001111111111101111110101111110000111101001111101011101111a10111011111a1111111110100101111111110111101100122222202220101012211101111220111011111111110a11011110
11010111111110111111111110111110011111111111011011101110011a00010111011a1100111111101101111111111111111112212102211221211202112021211221101111011111111a11011011
11111011111111100010101100011111111111111101111111100111111a01111111111a1010111111011111111101111011111111220021102101101122101221211021111100100111001a00001111
01010111111100220021121111121220212111210111111111101110111a01110111011a1111110011101011111110011111101121122100221001210112102122211121100111111111111a10111111
11110011111122121221200202020112120212120111111011111101111a11110101110a1001101111010111110111111111111112121111121011211112002011122111111001111111111a10111111
10101111111202012101221110021211201211121111111100111100111a11111101111a1011111111111111101111111111111101122011022222212001222122110011100101111110110a11111111
11011111111220102221021002002102102021012201011100111110110a11110100111a1111100101101001101111111011011122121111112002112111111212112221010111111110111a10111111
01100111110112210101101111202112220210222211110110111111111a11011011101a1011111110111111011111110111110102122121100122111221111122100021111111111101110a10111111
11111111101112212211210212121112121012111110111100011111111a01111111111a1101011001111111111111111111110020002112201120110201112111122111111111110100111a01111010
11110100010100022222222121101112121101222011111110111111111a11100111010a1111110111111101111111011111011121112210211201122222101011222211111111111110111a01111111
10111100111102211211222212122122111120002211111110111111111a11111110111a1101111011110111111111011101111112210002211201110221112220000111111110101110011a11100011
10111111111211000112122211120012021012121110110111001011101a11011111101a1111111011111111111011111111000100012120211211121222211011112001111101111111111a11111110
21122212111110102222202221222222202121012110111101111110111a11010010101a0111011111011101111111111111111121012212222102101222221101210020011111110111111a11100111
12201011000101122210202111202202222120221201001111111111110a11110011111a0001111011101111000110101111111112212111222110211102221121101111111111011110111a10101110
01121212210220122010112222022220111202221201101101111110110a01101000010a1111111001110111111111111111001122110222122012111220220201101221111111011111110a01111110
12022202201022220220200022022222202010121101111111110111011a11111011101a1111111100111101110010111010111112220012122022121101111110112210111111101100111a11111011
21112210202202222222222121201121022212121211101111110011101a11110110111a1111101110111110110111111011111111121011012122021020121000120221101111111111101a01011011
12012221200202120222221202212211211221221111111111111111111a11111011101a1111101110011110111101000111110021201022012201202102111200121120110101111010111a11011010
2021111220222022201bababbbbaabbbbbaaabababaaaaaaaaaaaaaaaaaa10111110111a1111111111101110111110111111111111121122120220112211102202011222211111111110011a11111101
2221212112122122222b220212202222222201212011101111111101111111011110111a1101111111111011111001101110111100012101222120202211102211211220211010010111101a11111001
1112111112201100102a222121222222102201111111111001111111111111111010011a1110101111110111111101001101111111000012020212101221012021121121211111111111111a11111111
1202222102212122202b021220222112022221011201111111110111011111110111100a0011010110111111110110111111111111020202120111222122221201211111010011111011111a11111111
2222000021002222222a220102112220211120002111111010111111111011111011101a0110111111011111101101111001101111122011001221222201002221212021111111111101111a11111111
2002121211002022211a012022212022210121201211111111111001110111111111011a1111110111001111111111111111111001120212122112221221211212121222121011010110111a01111111
2011210011112022222b212222222221212120112011101000111111111111111111001aaaaaaaaaaaaaaaaaaaaaaaaaaaaaaaaaaaabaaabbbbbbbbaaaaabaaababaaaaaaaaaaaaaaaaaaaaa11010011
2100221212212202222b20201000220011222111121110111111111101001111101111101111111111111111101101011011110101121001120222102110012212201210011111011111111110111111
1210222012022222202a22202202122100101210211110111111001011011111101111111111111011110011111110101111111010111202211000012212121200221122121111111110111111111111
2221212012201112022b11012222212022221212121011111111110111011111111111111111101111111100111011111100110111112111201022220102211022010001211111111110111111111110
2012120201221222222a11021211222001122212120111111111011101111111111001111111011111011111111011111111111110111122211200202011211222012202101111111001111011111111
1012021221021121220b22120212222221112220101111011101111011001111111111111111111110111101101001111101111101111122212211221102111220002002211101011111011001111011
0020012022221221212b22200102101220100210221001101111101111111111101100011001111100110111011011110111110011111100112210102022022221211222211111110111111111101101
1111111121121022202a00212021012012010221221110110011101110111111101111111110011111110111111010111111010111121120202022122222120112012120120111011111001101101101
2120220111222222112a21220220220022220121211111101010111111111111011111110011111111110001111111111101111011110221110222110121222101102010121111111111111101110111
1011200102122202120b02222022222101112121021011011011111111110011100111111111111111011110110111111001101111022220121210110112002122212222101100101111111111011111
1110122201211121211b22122010102111111111111011111001111101011110111111101111111110101111111111101101100101020211112112222121122002102212221111101110111110111101
0121222022200211112a10022111221111111110101100111111101110111111111111111101111111111111110111011111111101112120112220121221220121202221121111010111001100111111
2212202122021010012b12212001110111111111111111111222022122122222111112221122111211111111100010111111111111112212122211201012022022121201221100010111110100101101
0210122012211111122a10202120102111101110111101110211101102012102101211011021002001111011111110111111111111121121202211121012212210220212121111111101111000111101
1221200222212201112a00101211020110111111111110101112121222112202210022012211121baaaaaaaaaaaaaaaaaaaaaaaaaaaaabbaababaababbabbbaabbbbbbbabaaaaaaaaaaaaaaaaaaaaaaa
1201112021211012021b12220101111111111010011111110121122002121022221211221122111b11111111111111111100111011010121121202222101202112111121010111111111111101110111
0212200212222112110a21121222201111110110001101111212200212221201121201012222122b11111111010111011011101111111022220011012102110121102121221111111101111101111111
2101101212100011122b20112122211111111111010111111212120220120200122210122110002a11111011110011001111111111112221221202212021122211221221111111111100111111110101
2102121112120211121a20101100121111111111111111011221101022210220201211220122112a11101111111011011011111111011022121122112221220211221010010100111111011111111111
0111101111111111111a11111111110101100011011110110100022202021121222102111111120a110111111110111aaaaaaaaaaaaaaaababaa22122211121022122212201111110111101111111011
1111110111111011111a10111111111111101111111111011221122202212220222121020122102b101110101111111a1011100011000001210a20021122212010210221111011111110111101111001
1011110111111110011a11110011111011111111101111101012212212122020111222220021212b111111101101111a1011111111121001202b02121211122221111112210111011111010111011011
1111011011111011111a10111011111111111111111011101221201112222222221111012111220a110001110011111a1101111111102022201a22221101210211122221221111000101111111101010
1111100111110111111a11111011111110111111111110110222222102112212112111002111110a101110011100111a1011111101102222012b10202112210212110112111110101011100111111111
1111101111111110111a11111111111111111111100110011211222012121201121002212121221b111100011101101a0011111110020101120b11112120222122111221211110010111111111111111
1111111111111001101a01111111111100010101111111110012121211111120110122122012220b011010111111111a1111011111011111011a11111111101110110111111111011011001111111111
1111111111111111011a11100101111110111111111101111112122112212112201212101111222b011110111001101a1110001111011111011a10111111110110111100111011111111111111100111
1110001111111111110a11101011111101111011111111111022022112111222110022201001112b111110101110001a1101111111111110111a10101110111111111111110111101001110101110110
0111111111111111110a10110111111110010111110111111211101112221211222022211011210b111111110111110a1011111001111111111a11111111111111011011111111001111101011111011
0111011111111110111a11111111111111011111111011011210001221111222220211112212002b111000111111111a1111111110111101011a100aaaaaaaaaaaaaaaaaaaaa11110111111001011010
0101111111011110011a11111110110111111111111100110022120122102210201200211010222a011111111111111a1110111111111110111a111a1111111111101111011a11111111101101110111
1011111101110110110a11110101011111111011101110101021212100022212111221121121011b111101111111111a1011111101010111011a000a1111111110001011101a01111111111111111111
1101111111111101101a11011111011111011011110110111110212202221110221112221211210b111111110101111a1110111011111111111a111a1111110111101110101a11111101111111101011
1111111011111101111a11110101111111011111011011111110002122122110021211111222222b111111110101111a1111111001111100011a100a1001001111111111111a11111110111111001111
1110111111101101111a01111111100011010111111011011101021222202112210200000211221b101110101111111a1111101111011101111a111a1101110011111111111a11111111111011011010
1101111110110011101a00111110111111110110111101111022201111101100121122122012211a111011011111111a0110110011001111010a011a1010111111111111001a01010111001110011111
1010111111110111110a11001111111111111110111111001210011201222011221022000101020b101111110111110a1111010111111110111a111a1111111111011111111a10000111111110100101
1111111011110001111a11111010011110110111110111011222101011022211022102220211111b010111111111111a0110111111110101111a111a1111111011100011111a11110111111110111101
1101101111111101101a11101011111101111111011111011211011201111221010121201110212a100111111101110a1111110111011111100a011a1001111111111111101a11111101111110111111
0110111110111111111a11111111110011111101111111111122222111112021020022121002110b111111111111011a1111110110110111111a111a1111111111101111111a11111111111111101011
1111011111111111111a11111110100011111101101101111221101012121122021211111102122a111111011111011a1101001111111010111a111a1011111010011011111a10111111101001111110
1011110101111110011a10111111111111101111011111011202122201120112101221112222101a111110111011100a0111101111111111110a101a0101111111111111111a11101111101111111111
1001110011110111110a10110111111111011011111111011202211011121212101010211202220a011111111101011a1111110101100110111a111a1111010101011010111a10001111101101110111
0111111010111111111a10101011011111110011111011001111111111111001111111011111110a111111011101101a1111011110011011111a101a1111111111111111110a10111011110111011111
1101110111111111111a11101011111110111111111111111101110100110111111011111111011a110111111110101a1111101111111110111a101a0010101111111111111a01101101111111111111
1111101110100110011a01111110101010101111111111111111011000101101111011111111111a111111111111011a1110111100111110101a111a1111110110111100111a01111101101101010111
1110110010011101111a11111011111110010111011110110111111101110101011111011110111a111111111100010a1110111111000101122a012a2112121110122102112b20101111011111101111
1110111101111010011a11111111011111010111100100110110111011000111111111110010111a111111111111110a1111011111011000120b120a1120022100122122222b01101111111111110111
1011010101101111111a11111111001011011111111110101111110111111111111111111111111a110100011111110a1111111011111101110b222a0121021110002021212b10111111111101111110
1111011011111111110a11111001111110111111110111110101011110111110111011101111111a101111001011111a2121222120112111022b222b2222220101111112122bbaaaaaaaaaaaaaaaaaaa
1111111110111111111a11011010110111111111102220212101112211221211111111211111110a111111111111111a2011102221202121022b212b2212010022010121222120101101110100110111
0101111111111110110a11111011111111111111122211212121121122211121122202221111111a111111011111101a1110121222120122210b202b2202101100111110221100110111100111111111
1010101111111111111a10101101111011111111122101221121101011112102222210121111111a111111110011101a2221210121202022122b122b2002222101002111120021111111111101110111
0110111111010100111a11010101111101111101101122111022211200222110122211021111101a110111111111111a2211121022111211112b102b2000122122121212012211111111111111011111
1101111111011111111aaaaaaaaaaaaaaaaaaaaaabbaaababbbababbaaaaabaabaabbaabaaaaaaaa101111011110001a1102102111212112122b122a2221222101122201111111111111111111001111
01011111110111111101111110011111111110111122220111120201222102021112112200111111011111010011111a1102121120021202010b222b2222102211212102221120011111111101111011
01111110011111111111111000011111111001011110200120111212122212020012212111111011110111101110111a1112212212122122110b222b1122210212222122102001111100110110101111
10111011100111101111111111101110111111111211120211102121112112210211012211101111101111011111110a2211202012221201221b222b0220222202000210221201111111101111110111
10111111011011110111011111111001111101111102222211100220110021211211122111111011101111101011110a0002122221211122222a121b2110221122121110221212011111111111101110
1110111010011111011111111111111111111000101001100122121abbbbbaabaabaababaaaaaaaaaaaaaaaaaaaaaaaa2122222112212220122b222b2222222110111120122101111111101111111111
0111111101111111111110111111110111111111102101221222220a11121121120121101010111111111111111110111120101101110112022b102b2222120121002122211020111111101100101111
1101011011111011111111111101111111011111122020121220112a12200110120221201111111111011111111110102220221111212222012b222b1221222122122110101020010111101111111111
1111110011111111011011111111111111111101122111211112222a01210122121212121010110101111111111111002102212101112222001a110a0102201111112221110211111110111111110111
1101110011111111111101100111100110111111112022222010112b10220112221110011111111111101101111110111222222121212022222b221b2202222200111222021120101011110111111101
1111111111111101111101110111110111111111100011201220111b01121102121111121111101110111110111101011210120011011012101b022a2202202220120211101210111111111101111111
0111111010110111111110101111111011011111012221211222121b02111122110112011101111011111111111110112021022121112112212a202b2222222121112010211211111101111011011011
1011011111101011110111111101110110111111100021200120112b12221020202021110111100111111111111101112211112011112022222b020b0222222211102212002111111111101111010111
1101111111011111111111011111111111000101011202202101202a21220211011120001101111011011111011000110121102210220121222b222b1222222222011211121022111010111011111111
1011111111111110111101011111110111001111011022022121121a20222122120212101101101111101111111111112012111102102111222b220b2020222122212012111201111011001111111111
1111100110011011101111111111111111101101110220112111222a11210212011110220111011110101101011110111201122111112111222b022b1222212122102122121001011111111011001111
1111111111110111111111011001111011111101112011200222020a20211011122111121011110101111111100111102010112211220102222b211b2122202020210111122112111111011111111111
1101111111011111011111111010111111110111121211111220122a20111222212221201111111111111111111111112022221211212012021b201a0222211012102210110022111111011011110101
1011111110111111011111111101110111111110112022122112102b12200010122210001011111111011010111110012222212120122222020b012a1220122101220221021222111111111011111000
1101110111101100111111101111111111000111002102222101200b20221012102111111111111111110101110111111101110121222112222b220b0202222222221121011122111010001111011111
1101111110101111111011111011111111100111111211122121210b21211111211121101101111111011111111101110101201110221120002b201b2220221111110212221221111111011111110111
1101111110010110000011101011111110111111001112122211212b22002212222211111110110111111011111111111111220121222002120b221b2212120102110202021111010110111111110011
1101111111101010111111111011111111111111121212221011012a22212121211111111110101101101111111101101020202211112212122b222b1120122212010112220102111001111101111111
1011010111111110111111111111111111010011120121011212202a20222011022112011111111110111110111110112202122122210002002b121a1222202111010111110101011101101110111101
1101011000111101111101101111111110111111121121102221201b12112110200110111010110111111110111111101102222011200002010b001b1221221111111110111111111111111111011111
1111111111011111111111110110111111111111122222112211211a21001012221221121111111110011111111111112210001122111121212a220b1212111111011111101110111011111111111011
