49 18
89 103
122 49
126 101
64 67
119 18
56 105
111 104
8 43
26 34

10110110110111111001111111011111111011001010111111111110110a1111111111111101011110011111001101000111111111011001111101111101110110101111011111111110011111111111
01111111011110111111111110111111111111110110101000111110101a0110001001011101110011010111101011001101101110011111111111101111001111111111111111111111111111110101
11110111110111101110111110011111110011111111111111111111111a0100111101111101111101011111110111111111011111111111110010111111101111110111101111111101110111110101
11010110111111101111001001101101101111111111111101111101111aaaaaaaaaaaaaaaaaaaaaaaaaaaaaaaaaaaaaaaaaaaaabbbbaaababbabbaabaaabbbbbaabaaaaaaaaaaaaaaaaaaaaaaaaaaaa
0111111011110111011111101111111111110011011111100111111111111101001111111111101011010110111111111111011111221011211101211220201221111120110111011111111111111110
0111101110110101010111110111111011101011111111101111101111011101111111111111111111101111111111111110111010211222002111122112212021222101101111111111111110001101
1101110111101101010111111010111010110101110010111110110001101110111011111011011111111011111111001111110001201222121222021210122101121220111111001010111101111100
0110111011111111111111111011111111110111111111110100100111111011111111110111111100110001110010000111110022002121101112122111122222102221110111111111111111111010
aaaaaaaaaaaaaaaaaaaaaaaaaaaaaaaaaaaaaaaaaaaaaaaaaaaaaaaaaaaaaaaaaaaaaaaaaaaaaaaaaaaaaaaaaaaaaaaaaaaaaaaaabaabbaabbbababaaaabaabababbbabaaaaaa0111111101111111111
11111111111101111110111111010111010110101111110111101011111111111111111011111110110111110101111111111110120212221212212201011212120122111110a0111111010101111101
10111110101111111111100111111111101010100110111111111111111011111111001101111111111111111010111111110111211012111222222102202221101122010011a1111011111111111011
11110111111100111111111101011101111110110111111101011011111111111010111101101011101111111111101110111111222111010222021201010221202101011101a1101111110111101110
11111101111001111101011111110111101111110111111110111110001111111111110111111011111111111001111111111101202222120020222110222010102222211101a1101011011011101111
11111101110001111111110111011110011100101011110110111111101111101111101100110111111111011011101111111011111110022112021110222022222200211111a1111111011111111011
11110110011001111111011111111111111111111111111111111011110111111111110101110101011111111111011111111011111222112111210220222102221101010111a1101111111100111011
11100111100101111110111110101111101111011111111101111111011111111111011011011111111101101111111101101111110111121112221221102222112111211001a1110111111111111111
01110010111111101111111101111111110111100111111011111111111111111111110110111111101101011111110111010111010121022211122221111001122211201111a1111110110111100011
11010101111111011011101100110111011111111100111011111101111111111101111100111011111110111111011111111111200212102112210111221211122121111111a1111111000101101111
11101111111111111111101111111001111110111110111011110111111011101110101111011101111010111110111101111111211121211012012212020200212222210110a1001111111110111111
11110111111001212002012211020221021002202101110011111111110111111111101111110111010111111110111011111011211202111112110111111221002221111101a1111111110011110111
11111111111212212222221222122111121121001111011100010111110101111110100110111111111101010110101111110101021112202111122001022202120102111110a0101111011100111111
11100111111222022111121212210101211221002111101011011111111111101111111001111010111011101010110111111111221112211222221222121020111021211111a1111001111111111111
00111111111201101202121022221112100120122011111111111111111110100110011000111111110111111101111110101110220101101201111110101211221101011111a0111110110111111011
11010111011022211202101220202212012110221210011111111111111111111111111111111111101010111111110111111111122212101201110102121122211002111110a1111111011001111101
11110110011221111112212211111221200021012111101111010110111111011111111111111111111111111111110110111111022012002120211012120102121121210111a1101110111111111111
01101111110201122022102211122112012101122211111111111111110111111111111100100111111010110111111111111111210210201220121112012000221121210111a1001111111110101111
11110110101022121202111122222120021222211100111100011010110011101011111111110001000111111010100111111000212122110210222102201211120212111111a1111011110101011111
11111111101012121111212102120201212201012210111111111011101111111111111111011011111111111111101111111011112100121021100212010111221222211010a1111111110101011111
bbbbbbaaaaababbbaabbbababaababaabbbbaaaaabaaaaaaaaaaaaaaaaaaaaaaaaaaaaaaaaaaaaaaaaaaaaaaaaaaaaaaaaaaaaaabaaaababababbbbabbaabaabbabbbabaaaaaa1110111101111111111
2220111122112022202212222120012120102221011111011011111111111111110101111110101111111111111111101111110112012110101102221121121121021211011111001111101111111111
2221002201221221102222222112022012211022121111011110011011110001111011111111111010011101111111111111100110111221122112111122110111220211110011101111101111110111
1222201001011202221222210011122110121111211111111101111110111111011111101011111111111110111111111111111002120102200010211101021021121221111111110111111001111110
1110222221222021201102210022212011001021221111110111111011110111110111001100111111111101111011111110011102121212201201201010122220221121111111111111111011111111
0010011122012222020201122002221101022112021110111110111111111001111110111011011111111110010101011110111022222101122112221112112112002021110111111011111001011011
2101201212220220112222212221222112222212101110111101111110111111111101011001111011101011011110101111111011111012121120112220022101200221121111111101001111110101
1012022222122222221022112002210122222111111111110110111111110100111111101101111110111110101111101011100101022221220221020001111211212110211101101110111110101100
2112100221212112222212120022001212121122121011111111111111101011111110111101111110101111110101100111111111012221111122121210020122211121221111111111111110111110
2112112211102022222222222221120202122102111101000111111110111111111010011111011111101110111011111110111110100100110121012112011101120221121111101111111011111011
2221011101112222222202212022222101111121010111101011111011101111111111111001111111111100111111011111111101112221211101220122200121202110021110110111110111111101
1020222221112202202222220120221022111211011110111111111111011111111100110111101111110111101111101101110011122212112211121101122212201202111101111111011101110110
0120221121122200020202002022202202212122121011111111111110101111101111111111011101110111111111110111111111022020212110202122010000221222221111111110111101110001
1220211102022022221121020222121212122111211111111111111111001110111101111111101110110111010111111111011011111021022222110002011021211011121110111111111101111111
2121222121201022222222221222222222111220111111111011011110110111101111111111111110011111111111111011111111111021222201210111222222202110111110110111111111110111
1112112101011210222102102220002221101222110110101110011110111010111011111111101111110111111101010111010111121121122220211210120121122011221111100011111111111101
1111201212221010002122222112021022212012111011101101110111110011111111011111101011110111111111101100110011111211012001220221012010102222211111111111111010111111
2202111101200122222222121220021101221122111011101110111111010110111010111101101101111110011011100111110111111022122202222222100221200221221011110101111111000111
2220111201201221222201222221022202022220210011101110011110110101111111011111011111001100111101001111111101112001021211112112121012011212221111111111100011111011
1221212220012221120012210101100121211100000101101111001111111111101101101011111011111111011110111111111111112212011201111222111021101222211111011110001111001101
1122122101210222122210202222220222200010120010111100011100100111001111111101111000011001010111101111110011102021211112222211210121112221111110111111111100011101
1120210111002222202002222022012120212021221011101011010111111111011110111111111111111111111111111011111011122202121222121110212120000222111111010111011101100111
1202211111221220211121122111112010111110010001010011111111111111111100111111111110011111110100011111010111121012212022111022111111012211221111111111111111111111
2210210002111210111210111011222100101010111011111110111111110111110101101111111111111011110111111011101111022022211221122121121010211210221110111111111111111010
1121102211002111210022022020211111111111110011011021110112121112120022222110011111111011101111111111111111111120211212021221000112011210121111111111110111111111
2222202112221122221221120221210111110111111110111212101212210220211021211222221211111101111111111111111111121212211222112220011212112111201111110010110111011100
2220210120201121012120221112202111011011111111111022101211111022120211222111112211111111111111111100010101121111210210101112202201111121101110101110111011111111
2111222122002020120212121110021111110111111111111222102211212221212221122002102111011111110111110011101111112002210021222001110121000210221111111111101011101111
0112102122210120121202201112212001111010111010111211111121112112101212112112221111111101111011111111100111111221112222211121121122011110221111111001110111111111
0011021212111122212202122012211111111111111101111210021022212100020122122112222211111111011111111111111111101210121222121120221211120011221111111011111101111111
1211112022221000202222111111022101011111100111111101110112020012012010010111120211100111111111111100111111111112220221102120221120212012211111110111111110111111
1111111011110110111111110101011111111010110111110201221102211211021122120212221111111011011101011111111011101220bbaaaabbbaabababaaabbbbabbaaaaaaaaaaaaaaa0110001
1101000111110111011101110111111111101111101111001200122221212200120101112222121211111111011111011111101101112110b211101211111211102122221111110111111111a1011111
0111111011111111110110111101111011111111110111111102100112110122112021121121200110111101111111110111111010102211a120222202122022122112201110111111110111a1111011
0111111111111111111111111011101110111111001111011222200110202202212110121222011201011111111111111101110111121012b212022211012010010112210111001011000011a1111110
0101111111101111111110101111011101111111111110101112002212011202021210211212212210110111111001101111111101111120b121022010112211121112022111111111111111a1101111
1010101110011010110111011111011111101110111111111110221000101002121122221122112210110111111101111011111101102021b011001110221001012221222011011111111011a1111111
1101111111101111111110111011110110111111011111111221112101112111211220111110212211111110101001111111011111110111a010111111101111110111111111110111010010a0110110
1010111111100111111101111111101011111101101111111210101201011211111120021120221011011111111011011111111111111111a111111111111111110111110001111111111111a1111111
1111110111111111111110111101111110011111100101111210211221101122000222221211101111111111101101111101111111110110a111010010111111111110101011111010111111a1110101
1100110111111111111110010101101111011010111111101122110112221101210221122121222211111111111011111111111111100100a110111111110111110110110111111101011011a0111111
0101111111111111101111111011110111111111111110111012012112121201112212202102021110111111111100110111010011011011a101100111111100111011111111110111111111a1111110
1011110010111101110111111111111011111011111111111212022201012122112222202111202111011111110111111111111111111001a111111111100111111111111101111011111111a0111111
1111111111111101011100110111101110111011111111111211100201210220211212101201101011110111111100110010111101100110a100111111001110011101011111100111111111a1101111
1111111111111111110111111111110101111111111101111221211200121210201121210122221111111100011110111101111111101111a100111101010111011111110110110101111011a1111101
1010110100111011111111110111110111011111011101101211022112022121122121011210212101101111111111101111111110110111a101111110011111011111111011010101101111a1110011
1011111111111111111111111110111111101100111111110112210221020201011012100221111110111111111011111111111101110011a101110001111110111111111111010111111111a1101100
1011111001111011110111101111101111111111110110101211121121110211222201110212021211001110111001111111010000110001a111110111111111011111101111100101100011a0010111
1111111010111011010110110111111011101101101111111222222012202210001121120112221111111101111011111111111111101111a101011111111111011111111111101111111110a1011111
1101110011111111111111111101101011111101111101111101210111002021221211222211012211100110111111101111111111111111a101111001101110011111101111101110101111a0111101
1111011011111111111011111111001110111111011110111121122122101211221121222121220110011111111111110010111101111011a111111111111111111110111111111101111111a1111110
1111111111111111111111011000101101111011011010100112111011122101122122111121012200111011111111110110100111111101a101111111101011011111000111111111111111a1111111
1011110111001111111101101111111111111110111100111101102011112210221122120100122111111001111101111101111110111111a111111110101111110111111101111001111110a1111111
1010111111111101111111110010011111111110111111111211111102021200021212122211122210101110111111110111010110101101a010111111101101111111110101111111111111a0110111
1111110111111011111011111111010111111111000111111122001112212121200212020212222211111111111101111111101011111011a111111111101011111011110110111101111011a1111111
1101111111111110001111111001111001111100111101110111011101110011111111101101111111111100111111101111111110101111a111111111101111011111111111111100111110a1111110
1111101111101001011011110101101111011110111111011111111111111001111011111111111111110111111100111101111111111111a101110101101001111111111100111111110111a1101111
1100111111110110110111111101001111111111111111111111110011001011111111111111101111000111111010011111001111011110a111110111111111111111111011101010111111a1100111
0011111110011111001110011111011111011101111111011101111110101100101011111111111110111111011111111101000110111100b122212012220011021202010212211110111111a1111111
1111111111111111111011111111111111111111111111100011111111100110111111111011010111110111111101111110111111110111b221111100201202121211212212220011111111a1100101
1111101111011111011101111111111111111111010111010111111111111011101111111110111101001111111101001111111111011112b201122110110221222222121111000111111001a1111001
1111100111001001111110111110111111101110111111111110110111011011111110101111111111111111111111112200110211222112b010222120122002201101010220101011111111a1110111
1100111101101111111111011111111111010100102102022122011201012222212111111111101111010110010101012210122111211102a221222222212200111222121020120011111101a1111111
aaaaaaaaaaaaaaaaaaaaaaaaaaaaaaaaaaaaaaaaaabbbaabbbaabbbaaaabaaabbbbabaabaaaaaaaaa1101001111101012221121111111222b221222212222210122221212100211011100111a1110111
00111110011101101111110111110111111111111111000111122110021202022120011011111111a1011011011111112212121221100110b202121220122201122022211010111111101111a1100110
11111111111111001111111111111111111111101220221122221102112202020212221111110111a1111111111111000022221120021120b122222202101122212121111011011111111101a1011011
11110101111111111111011010101111101111111021022221021122111221201210021201110011a1101111110011102012001122221112b021220202022221121121112012211011100111a1111111
01111110110101111001111111111111111011111121022121111122110212121212121011011101a1110100111111110222112100102002b202222222000201022122112011121111110111a1111111
11011111111111001111111111110111111111111211122221100121211021010211022011111111a1011011010111012121210210120222b222212222222210221122112122210111111101a1111111
11111000111110101001111110101111111110011001122220122020221012202201221111001111a1011111111111110222112202120111b121222200022212110211111100111111111111a1000010
11101111010110101111111110111001001011111102201021012021122211221021202211101111a1011101111011110111122110122112b221022022212121221022111211211110101111a1011010
11110100111101111101111111110111101101111220112112110210101121121112212010111011a1011111100101111101122011111212a202102110221002111120222020121110011101a1101111
11111101110100010111111111001111111111101112212220121220122110102102022211101111a1001001111111102222100202020122b112121222122020212222101121201111110111a1111111
11011111111111101011101111111111111111111221212111122222100112222222220111111011a1111110011111111111011111211222b220222222120112011210111101111110011110a1101001
11111111100101101111011111111111011111001012122220101201210112122000121001111111a1111110011111012111201121121110a022202212220222220211012101211111110111a0101111
11100111101111111101111101101010111111011112212221210121122122021112021011111101a1111111111011112122011221220111b122212022112221111110111122121111000111a1111111
11111011111011110101101111001010111111101212201221011222222110212201010211111111a1111111100001110222121102120212b222201212011221121120111000201101111111a1111111
11111010111111111101111111111000011111111222212221122102220010212112111110110111a1011111110110011211022111000221a022202002222221121202021212001010011111a1101101
11111111111111110111110111111111111011110222112220112022122111201002221011011111a1101010111111111011120111110001b220020222212222001122210022020101111111a1101100
11111111111011111111111111111010111101101022211011102021211011022122102111111101a1111111111110112211121010220222a222020122022220112220021220101111110110a1111111
11011111111111111111011111011010111110111021221222210221200210200221112111111111a1110101111111111221220212121012b022222221221121212221012122101011100111a1111011
11010101111101101111111111111111010011101200112201210002021001021010122111111111a1111101111110100102101211122022b120222202120001100122222221101111101111a1011111
11111101101111111111110111111111001111111121102200111021112112021021011200111110a0011111101110112102222000211220b202202222221222122122221112211111101111a1111110
10001101110111111011111111110010110011001221211221101221221222211101112001101101a1111111001111110222211120201220b012212211122200100011202202211011111101a1111111
11101010111111111111111111101111110111110122121122110122121010201221212111101011a1111110011101112201102121112012b122221201202201111211221022221111101110a1101111
01110111110011111111110010111111111111111121110022212111102021122202122211111011a1111111111101112200220022122112b120102221202122120212112221020111111111a0111111
11111110011011011011011111011101111101001022022222121011220201210212121200111011a1001101101111112020111122010222b222212022222222222101121221201110111111a1111110
11110110111110111111111011101110111111111122212121112121111112111122212211111110a1111111111011111222212221021112b221220202220112102222111220111101010000a1011011
11111111111011111101011111111111111111111021212212112010022021212121111011101111a1110101100010010112212212201120a112212220011121101120022212220111101101a1111111
11111111111111111011111101111101111111010012022122112111111221220002212210110011a1111111111101112011110200200212b122122201211111111111011111111111101110a1101111
11011111111010110111101111111111011111110102222121021111122212021012212211101111a1111110111010012122210112222121b200212212002121111110111111011111111101a1011101
11010111100111111111111011111011111111111121221012111121111211102111201011111111a0111110111111012112102210221102a112121112022221111111101011100110110101a1111111
