49 18
89 103
122 49
126 101
64 67
119 18
56 105
111 104
8 43
26 34

110111111011111010011111111111101101111111111101111011111101011a110111101111101111111011111111111011000011111101011011011101111101111101010110111110101110110111
101111111111110111110111111111111111111111111111111011110101111a111111101100111110111111101111101111011110110111101100110111111111101111111111011111111110111111
111111111100111111110111111101111111110111100111111101111111111a011111011111010111111101111111011100111011101111111101010011111110011111011110111111111111111111
110011111111111101100011001101111111001111111101111111001110011a111111111110101011111110011111011100010101221000121122022021220221012221111111110111111111111110
111111100110111100111110111110111111110111111011111001110101011a111101111111111010011111111011101101111022021111222112100101111022112211111111011011110111111111
110101111111110110111110111110111111011011111111001111111111000a011111011111111011111111111111100011101111200121112212210111020110221221110101101110111111111101
111111111110011101011111111001111111110100111011011101011110111a111101101110110111101111111111101111011122100222222220102221121021210221011111011011111111110111
111101101110101101111111110111100111111010111111110011110111111a111110111110111111111111111100101011011121212221112011112221222221212221001110110111110111010011
111110111111111111111101111111101111101111111111111111101110111a101110111111101111111111111111111011111010221220121112021110210122111201110111111010011110111001
111110111111111111111101011111101110111111110111111111110101110a111101111111111111011101011111100111110122200111201211221202111112021211110111011111101111111111
011111111111101111101101111111111111111101111011111100011111011a011011111111110111111111111101011111111121110011111111221102121101222111011111111010111111001111
111011111111001110111011110011110111001110011101111111001111111a101101011111110111101101111111111110110122201211112221221222211212110201111111101101111011110111
110101111111111101111001011010001001111111111111101111111101111a110101110111111100110101111101101110101111100212001212121211210112021011111111011101111110111110
111111011111011111110011110000111111011111111101111110111111011a111111111111111011011111111111110110111102202022211210210121221021202201111011111111101111111110
111111111111111111111111011101011101111101111111100100101101011a111011111101101010110111111111111111011111022011120201101202112210122211110110111111010100101111
111110111111011010111111111111001111101100111011111010101111111a111011111101111101001011010111111110101102121211020010222012200221121201010111111010111111010111
aaaaaaaaaaaaaaaaaaaaaaaaaaaaaaaaaaaaaaaaaaaaaaaaaaPPPPPPPPPPa01a111000111111111100111011111111110111111121220211022122000222220211001121111111101111111111111111
1111011100101111111111100110101101011111101101111P1111110111P10a111111100111111111111111111110111110011112112002000121112210120121211111111110111111111111100111
1110011001111011111111001110100110100111100111110P1111110011P11a111001111101111111111101111110111011111021111121022122112110221221121211111111111111101111111111
110100111100201122122121222111011221012222001110111101011111P10a101001111101111101111101111111011111111012211222222110022220102200111121111111111111001011111100
111001111110111110222111222201121222110122011111111111111100P11a10010111111111111111011111101111111aaaaabaababbaaaaabbabbbbbaaaabaaabaaaaaaaaaaaaaaaaaaaaaaaaaaa
111110111012111101101211212121210112011002011011111101111111P11a00111111111101011011111110011111111a111121022111100101122120101220111100111110111111110111111001
111011111111020121112111101000021222211122111100101101110111P11a11111111111011111111110111001000010a111102112021122201210212111100012101110111100011111111111111
011111101102011122201211011010121121212202111101111100111111P11a11011110001010010110111111111111110a011112221221211111012200221002110121001110111111111111110111
111111110112110221211220112211121112020202111111110111011100P11a11101110110111011101111101111111110a111121222221010022122111011221200021111011100111001011011111
111111111102202222202121110112121211101221111111111110111011P11a01111111011111111011111011111001111a111112201001222112111110100111111201111111010011111111101111
110111111112222120122112222101222112202200011111011111110011P11a11111111111111011101011111111101111a111122222110201212221021222212211221110110111011111111111010
110100111100112122112022122121201102202102111111100111111100P11a11111101111011101111011011111101110a111121211012122122111111020011222201101101011011110111111111
022202122122221221201022021102212211121112011111110111111111P11a01101101110101111111111011111110011a101122010102210102211221221120201100111111111111010101111101
020212211222122201200211202012210101111110111110110110111111P01a10011110111111011111111111110111111a111011021101102121001121110222212111111111111111101111111101
221221201002212221021012020222211210012120110110111110001111P01a11001110111001111101111011111110111a111121221122011210220110212121211211111111011111111100111111
120220202212222122021221122122212220022212111111011111110110P11a10010101111101111101111001111001100a111012021012221222221220120221110201101110111101011101111011
211021221222222112221222222222202022001121110011111111111011P10a11100111111100011111011000111110111a111101201122000222221110111211112101011111111110111111110011
112112210211221122221222212012212201111212101111101111111111P11a10111111101111111111111110111111111a010011122111111121122222012120001121111111111111111100111111
020222211222220222210012202112021120201222111111111111111111P01a00110111110101101111111111011111011a101111121012220000121001222220211222211011111111101110111111
120022221120212222211222022220121221021022111111011111001011P00a11001011110111011111011001101101011a111111120110211010200220212220212110201111011111111001010101
bbbbabbaaaabbbbbbbabbbbbbabbbbbbbbababbbaaaaaaaaaaaaaaaaaaaaP01a11100011111111110011010101111011001a111110111101121010122122011121101212221111111110100111111011
1201202112222221002220122122112111122122211111111111100111111PPa01111111101111111111111100111110111a111101112212112110102211120201011121111111110101111101110111
012011220012222222212222222221221212111101110111101111110101001P11111111110101110011111111111010111a100111121210221111212222222012110021021000011111111101111111
222201011112212212222012102222120122111221111111111010111101111P11101111111010111111111111101110110a110111012122211212012121111122222110021111101101011011111100
111121221112222221222222121021210110112200010101111110111111110P11111011111111010111111110111110011aaaaaaaaabbaabaaabbbaabbabaaaaabbabbaabaaaaaaaaaaaaaaaaaaaaaa
112102201122122022212022212212201222111020111111011101011111010P110100111110111010111111010111011111111111112002200202011211222201111120001111111011101111111000
121212220022202222222000020222201110111211110111011111111011111P111010011111110101111100110111001011111101122221221222002210221202120122211111111111111011111111
212112121201122020221222221012220111010112111111111011011011111P110110111111111111010111100111001111111111102111221222111012221112012122221110111011111111011110
101102112021202121102220221210201221120111111101111101101111110P111110011101111111111100001111100001111111112210202111022022110001110120220111111111111111101111
201222211021122022201212121220210202100220111111110111111101111P111110100111111111101110111101011111011111111222100101222222111100122121220101111111111101011001
022112112212222222222002020212011221202112110011111111111110111P111111110101011111110100111101101000011111120122011220012001112211201020011111111111111111110111
100211210121210121201222200220220210211120111101111111110111111P011101111111010111111111101011111111111111120022110121121111121212120212000111101111011111110111
020221121120102222222200222122212201110222110111111110001111111P010111111111110110111001001111011111011011111121111112221122121121121120121101111100001011111111
111221110222222221202011112210210121201122111111111111101101111P011010101111111111101111100111111111111110120222111022111012011121110100100101111101111110111101
211111212120111121122021221211211111101111111101111110011111110P101010101011111111110111010101111111111110120221110112020110112001221122201011111101111111010110
212121210200201222212112202222111111111111011011010010111111111P111111111110111110111111100101111111111100121221111120101202121111122202221111111110111111111111
212101012212212221121201200211211110111111101111121111010120012P100221222122122211011111111111101110110111100111202121120022122221110211120111111110000001111111
111222120011222002022221212101201011111110111110112211112112222P201011222122222201101011101111111111111111111220121212012222111222110122121111111111101111111011
211201201210110112202102220100001101101111011110121101201100111P212220221010121111011111111100100111011111121112221112211012200122212121111100111011011111111111
222010220121122100211221222212111111011101111101112210212222202P222200221222222211111110101011011111111110111221111202122121121102112110201110001111101011111111
221122002112201112121222200212201001110110111101122201201202012P211101101122212001011111011111111111111101011120220201021100211222111222011111111111111111111111
002102222212121022100211112222111110011111111111111221111102202P222221122001222101101110110111110101100111100221201202110211012222021222021111011101111101111111
022111112010222222121222222020111101111111011111010210122020111P021021221222220211111101010011111111001111112111111101211111211222220210101111111101101011101111
111100111111011100011111011011110101111111111101102100221122222P122201220112211201110111111111111111100111002211011101221110101121112022110111111111011111011011
1011111101111110110111010111001111111111011aPPPPPPPPPPPPPPPPPPPb020222112011021211111110111111010111101011121222101222210211112222022120111111100001101101111110
1111111011111111111101110101101011110111111P11110201000220212211202101012210121011111111101111111111111110021211201212020102101112222002010110011111111111011111
1011111011111111110111111111110111011111111P11111220220011111111011002011111101011011111100111111111111111110112121221011212210201012021111111111111111111011111
1101101101111001111111111111001111011111011P11111222101122112022120202212201111210001111111111111111011111122211201112212022221122100020011111111101111111111111
0111110111111100100111100111101111111101111P01111122211212211210121221221121210011111111111010111111111111120220201221110112112211211002101011011101110111111111
1011101001110101111110101111111111100011101P11111112021122212111112211122111201011111111111111011111111111110111111111111111111011111111111100011101110111111100
1110111110111111110111111101111101011111111P11111122102222112212110200212121101110111101010101111011110011110110101110111111110011111101110011101111110011101111
1111111010001111111111111011111111111110111P01111122120110211121122212122122111201011101011111110111001100111110001101001011111011111001111111111101011111001100
1110110101010101111111111111011011111111110P11111112211202112100110122122122221211111110011001011110111101111111100111111011101110111110111111111010111111111011
1111101101110111011101111111111101111111011P11001211221212121012121211111121221211111111111100111101010111101101111111111010111011101110101001110111111101111111
1111111111111111110110011110111111111111110P01101112021111111101211210221202211111111111111011111011011111111111111111111111011111111011110011101111111101111100
1101111111111111100110011111111101101101111P10111102122201221021210122221112001211101111110011011111011111011111100111110111111110111111111111110111101110011101
1001111111111011111111110111101111101110110P10111101111122201212222222021212101211111111010010010111111011111111100101111001110111011111111101011111011111101111
1011111111111111011111111010111101111111111P11111112221121022002201121012111121211111001111111011111111100111111111101111111101111111010010011110001111111111111
1011111110011110111110111111111111111111111P11111112211012200221121210220112212011101111111011111110110011111111110111111110011111101111111110111111111111111111
0111111001101110111011111111011011101111011P00100110012221101212021211001222011111111111110011011111111101111111110011110111111111011101111111111111111111100100
1111111111011011001001111111111110111110111P01011212121211111010221112122210122011111111111101101101010011111001110111011111111101011111111110110111110111111101
1011111111101100111101110111111101111111111P11011121112111111221211221121121021110111111111111110111011111011101111011111111111111111101111110111011101110111111
1111111110001111100011100111111111101111111P11101210102222111101001102102110100010101011111111101111110010011111110111111111111111111111111011011111111111111101
1111101111111111110111111011110111111111110P11001110210202211111011222222101222011001011111111111111111111111111111111001110111111111010100110111111111111101101
0011111101111111111001111111111111110011101aPPPPPPPPPPPPPPPPPPPPPPPPPPPbbbaabbbaaaaaaaaaaaaaaaaaaaaaaaaaaaaaaaaaaaaaaaaaaaaaaaaaaaaaaaaaaaaaaaaaaaaaaaaaaaaaaaaa
11011010111111110101111111111110001011010011111112211111221022212110102P2121101100111111000111111111110110101111101111110111111011101010111111111110101110011110
11011111111111111111011111111100111111111101111112222222121222100200200P0000110201101011111111111101110111011111111101101101111111111111111011111100111111111111
11111111111101101111101111111111011111111011111111111110111111110110111P1111111101111111011111111111101111111100011101110110111111111111011101111111101110001011
11111011011111110111111111110111110111011111111110101111011101011101111P1111111111111110111111111000111111101101111011111011011110110111111100111111101111100101
11101110111011110100111001111001101111111111111110011110111101111111111P1001111011111001111011111111110101111101111110111011111100011111101111111110101001101110
11110111111110110011111111111101111111011111001111111111011111111111111P1111111110111011111111111111111111111111122122202212221202210212122022111111011110111111
10111111111111100001011111111111111111110110111101111110111101011111111P1111111001110111111111111111111111001010111111122021211012121212212120110111111011101110
11110111001011111111111001101110111111111111111101111111111111011101111P1110111101111111111111101011111001110102211210022211020001121121121100101111111111011111
11111111101011110111101111010110101111101011111011110110101111111111000P1100110101111111111111112212122101221212112222120022112212222012020211011111110111111110
01100111100101111011111110010111101111010221022212222112121112221101222P1101110101001111110101010112112011111002022210220221222211111221001222111111111111110111
11111111101011011111011011011101111111101012222212221022221121201210121P0111110111101110111101111022111021121121220220222012022222122122202110111011011111110011
110011101111100000010111111111111100111000010222122101220011110122122200P001101011111100111010110122210212122220220221122122211012220211100110111110011110111111
111100111110110111111011001111011111011011112122112022221102220211212102P111111101110111110011101211000101001211212212222222120022122021002122111011111101101011
110100110111110001111101101111111011110112111221200201222022110112211122P111111111011110111110111111202010201212222002021222002110120221101211111101111111111011
1111001111111111011111101111101111110111122101211112200221202212002121000P01111111011111001111102101221122011010222211122122222221021020121210111111111101011101
1111111101101111111011111101101111011111001220210112002211220212200120121P11111111101111111111111222110022102202220211112112210221202111101201010110111111111101
1101111111010111111011011111111111110111122112122010202121022202112001101P11101011111101011111112102120122122121202220200120000121101112102222111111111111110101
1111110101111111001111111101011100111111100010011211122221002011222212120P11011111111111011101110222112121101112222122222022222220122212020110111101111101111111
10111101100111111011001011011111111110110201221102121002210212011baababbaaPPPPPPPPPPPPPPPaaaaaaaaaaabbaabbbabaababbabbbababbbbbaabbbaabbaabbbaaaaaaaaaaaaaaaaaaa
01111101110101011101110101110111011011111212121012121110221000122b12111011011111111111110P1111101222122002222222122012100021122012021021122112000110011100110111
11101111111011110101101111111011111111111111112122121111021101210b22212211111111111011111P1111112211211112201211222222202212020112122001122112111110100110111110
11101101111111011111001111110101111001010202011001102111112112211b21121100111111111100010P1010111002221022212201122022212222222101211221220221111111011111101111
01101000101111110111101111101110101111111011012002121212022110221b11111111011101111111111P1110110212112112221211120100022021221111222011111222011100111111111110
11111111111111110011111101110101111110110211012211221010021112222b0222121101111101111111111111111220202111212120022212020202212220111200122210001111110111111111
11111111111111111101111111111101011101111102100112022201011200222a2202011111111111101011100111101211201002012111202220220222222222221102101210111110111111110111
11111111111011111111011001111111111111111222021211220222221122120b2120021101111111111111110110102111122012102012212220222021212200021121222001101111111111111011
11111101111111111111011100110110000001111020021212122211202100200a0220101111011111100110111111011002212021100122101220122222212112022221222222011110111111101111
10101010011110100101111011111110111111111121111212122100202202102b2201220101101111111111111101111111201221221210201212200122200101111101222101101111111111111111
11110111101101111111111111110111111111101212112110212001011120211b1022221110111111101111111011012221021111121001212122022222212012211111101122111000111111111101
11111101111111111011111101011111101101010211100212110210011102111a0222121111111101111100110111111121201120122012222222112022202121222121122221111101111111111110
10110111101101110101111110111111011111111021111111112111210122111b2022110111011111111110111111111112122110212222201220201212102221212112220000111111101100111011
11101111111111011111111011111111011111111202011221121212022222121b0102201111010110011101001011112121221221212102201102222022222201210202012220110111011111111011
11111111111001111101101011011110011111101222021212202002202202201a1111221010111111111111111110112122002201122112122122221120120120122222221212011101111101110111
01111111111101011101101010111101111111110212101222210121122200101a2212011110101001111001011011112121011220111110122222112212220211111111112221100101011111111011
10111111001111101110111111111101111100111202210200120122122221122a1021000101111111101101111111010102021122020122122022221202211101112112110212101101011111011111
11110111110110001100110111111111011111111112012212022020210212220b2201211111101101101110101111001202210121221102021221222222100212102122222212111111110111111111
00111110111111101101111110101111111111011122011121102111212121200b0112201111111111011101100111112200102122110111222121211122210111110111111110011110111111111111
01001111011110111011011111101110111111111222110121102212112021221a1100101111101110011100111101110121111121111101010220210010221011101001010011111111101111101111
11111111101111001001111110111111011010101012120011211121012022120b1021121111011111101110001111112012210120011021220211102112111111111101111111111111111011101011
