1 19
151 58
122 49
126 101
64 67
119 18
56 105
111 104
8 43
26 34

0100111111101111101111101011111111111111111111111111111111111111011111111110111101110111111001101101111101101101111111110111111111100110001011001011111a00111111
1110011111111111100111111011111111011101111100111011111011111111111111011111111111010111100111111111011110111101111101110111101111101111101110111111111a11111101
1111101101111111101111111101011011011111111111111101011001111011111111111111111100111110111101111011111111111101101100111111111101110111101111111110011a10110011
1111011011110101111111111001111101111111001011010111101011001111110111110111101001001111100111111111111112122212210202002122012221211210110011111111100a11111111
1111010111101111110011111111111101111010111101110110111110101111111111111110001111111101111011111010111102221022102200222122121011012220111111011111110a11111110
0110111111101101100010111111111111101111110011111110111111111111011111100111111111101101011111111111111010102221120111021122011211122100111111011011110a11111111
1011101110101101111111011111111111111110011111110101110111111111011011101111111111111110111111111011110111121221012121121012221220021111111110011110001a11001101
1111111111011100110011101100011110101010110111110111111100111111100110001111110111110111011111100101111012011221011222021111211212202111111011100111111a11111111
1011011111111011011111111101110111110111111111111111110111111110110011110111111111011111011111010111111121022120102111211011210010102121110001011111011a10111011
1110001111111111101101010101011111111010101111101111111111111111111011111111111111100111101111110111111021111122111100122111120222202121111101110111101a01111111
1111010110101111111111110101001111111111101101101111011011101110011101111011101011101110111111111010111012112222112120020221222101020211111011111010111a10101101
0111111111111111111111111111101111111111111101010111111111101111111111111111101111110101101111111111111112110011020112202211121002201110111111001001110a00111111
1111001011111111011111100111111011110111111011011111110101110111111110111101100110111011111101111111000021120111122021021111120222022110001111111111011a11010111
1111111111111111111011011111111110011100111110111001101101111100100111101111011111111111111111111011101111212221121121122202222212102011101111110010101a11111101
1111111111111111111111111110111010111011100111111111110011101111111111111110111111111101011111111001011121211201211121021002120120202221111111110111110a11111111
1111111101111010111111111101101111110111000011111111111011110110111111101111110111000111011011111111111011110112120012112010000220011211010011111101101a11111111
1111111110111111111111111111110101111111111111001110111101111111111111101110111110111111000111111111011100202211112002101011222112202021111111111111011a10111111
0011111111111111110111110111111111101111111111111011011111111010111011111110111101111111110111111011111111221120020212222121002212111111111111000011111a10011011
1111111111111111101011101111010111111111001101111110111111101011110111111111101111111101110011111110111122121002102222001211122120211111111111110111111a11101111
0P01111111110121110211122222202112211121001110111111111111111111110111110101111110111010110111010111110112111211120121102221212211111221111111011001111a11111111
aaPPPPPPPPPPPPPPPPPPPPPPPPPPPPPPPPPPPPPPPPPPPPPPPPPPPPPPPPPPPPPPPPPPPPPPPPPPPPPPPPPPPPPPPPPPPPPPaaaaaaaabaababbbbbaaabbbbaabbbababababbaaaaaaaaaaaaaaaaa11110111
111111101011112010102201122201212221112211111111111011111101100101101011101111111111111110101111P111111110201012211211212221012011210211101011111111111110101111
111011111011001220221200100011201112221121111111111111111111011110111111111011110111111001011111P110011122212111122122202020112101112001110011111111111001011011
110101111012211121220102122221122221112220111011111111111011111111110111101111011110011110111011P010111120121101122211221120121122111001111111100100111100101111
110111010111121221221020212122110211100112111111111111111011011111111010111111111111110010111101P111111101211121201212012112110021121111111111101011011101111111
111011111101111201011121112101221211221001010111111011011110011011101011111110111010111111111111P111111122122220111111202022010122221121001111010111011011011011
111111111002222111221021111120010012121111111101111111101111011111111101111111111011101001111110P101111101201100121022210011112121221201110111101100111011111101
111011111012211112201011211112212220202122111111011111111111110111111101101011101111111111011111P111101112121212212101020112211211212211111111111111011011111111
221210012112002220122122212101122020211122111101100111011011001011101101111110111011111111101111P101011121101021212110121120022111221121111100111101110111011111
112111012222111221222202222221021121121011111011111111110110110111100111110011111110111101101101P110110121102222212012112111022211111211100101111101111111101000
121120101022222200122102202220021120221222111111101011111111101010011011111111011111101111110111P101111121110220211120000202122212211211011111111101111110110110
121022212011222202122112222222211202121201100110111111101111111111111111011111110101110110111111P110111102101121211211122121211221011211110111110111110111110111
022101201011122102121202102112212122110200111111111111111111111111111111111111111111111110100101P111110120110221111012122112121120211211101011111111111111101110
011222120212202202022002222121212121222110111111111111011111000111100101111110111111110101111110P111111100021022002010121012201210121211100111110110111111011110
122102020021222112211220210210122222221111111110111110110111111011110111111101111010010110111111P111111111010201021022020021210211012112121111111111110101101111
110102210102220222020120222122202211011122111111111101101101111111101111100111100111111111010101P111111111100022112210010011110121102201220111111011111111110111
112122112010221222012200200212221222212110111011110111111111111101111111111011110111110100111111P101110111121121200100221212022111010221211110110011110111101111
aaababaaaaabaabbbbbbbaabaabbababaaabbbaaabaaaaaaaaaaaaaaaaaaaaaaaaaaaaaaaaaaaaaaaaaaaaaaaaaaaaaaaPPPPPaaaaaabbbbaabbababbaabaabbabbbababbbaaaaaaaaaaaaaaaaaaaaaa
221002002221200211102121221222222000221212011100111111001111111111011111111111111111111110101111111111P111101121102021212100101112011211211101111111111111110101
120022212222212122022222202221211012201112111101101111111111111110111111110111111110110111101111111111P101121102011010011001101212012121221111101111111111111111
121121212101121220222212022222222220221212101001111110101111101101010111111101111101111111001001100111P111121101210022022121011111102222111011111011010111111011
211110202112220121120221022212011022221011110111111111111110010101011101011000111100111101011011011100P111110010121110212202001212121120211111110111111111010101
222121122021222210121100102222201121211111011110011100111101101111111111011110111111111111111111111111P110000122002212010212102022002001221101001111111111111101
102211112202222222222101100122112220022112101011011001111111111111111111011110111111101111111111111111P101110212022021112222101022100200211011111111111111111110
221110022201202202011221212220202011112012111111011101110111111011111011111110111111011111111110101100P111120122201212221221012201122221101101110111111111111011
121121121222222202222002120222212202012101110111011011111111111101110110010010101011111001111110111111P011100211122221121111021021100212020011110110111111111111
201101121021020222220001102122202122212112111111110111110111111110111111101111100011111100011110111110P110121201212011122121212101110012111111111111110111111100
122122011212212202220210202201001011002101101111010011110101111111101111111011111111111111111100111111P101112111102100022221101212112111211101111111101101001111
111121010122222022122222200120220212121202011111111101101111111111011011111111111111111001100101111011P011122110121112220202212221212211021101011111111111110110
120211111110222212222202122122211012222110110001111111110111011000110010010000111011111110110111111111P101101112111111020201011121222220210111111111101110111011
222102011111111110201110112112200101101110111111111110111111111010011111111111011011011111111110111101P011111122221122202202111221212222211110110011111111111111
221121221122112122220010122102211111101101111111111111011011001111111001000111011011111110111111111101P011122111211220010221120111101201221110011111001110001111
babababbbbbbbaabaabbbabaaaaaabaaaaaaaaaaaaaaaaaaaabbabbaabbab022101111120222000211111111110111001110aaaPPPPPPPPPPPPPPPPPPPPPPPPPPPPPPPPPPPPPPPPPPPPPPPaaaaaaaaaa
111122212202000222201112022111011010111111111111112110011021b112112021220102221111101111101011111111a1111112112112221221002120001222120111111111101111P110111111
210110111122111212211202211020101111111111111111122222101122a220201101102022200111111111011111101111a1100101220011110100201101220212222110001011011111P110111110
122222102201102200222120221212111101111111110011101020222121b100121022100211022111010101110111100110a1110111120200222210212222001222112222101111111111P111111111
122210221222112210122010021021211111111111111111112201111120b121212011120202121111111111101110111111a1111111221222210122220221122112102112110110011101P111111111
222012110212021110022002212102211111111011110011022212211022a221222102020112111111011111111111110011a0111102121000122211221111110112020121100101111011P111111111
221120201111121222122221212112111111110111111111101021121012b011100010010221210201111101011111110111a111111012212002102abbbbbaaabbbabaaaaaaaaaaaaaaaaaaPaaaaaaaa
111110111011111111111001100111111010111110110111011222011222a120101222111122120110011111111101111011a111011120211122101b1222202222121011111110110101011111111111
111111111101101110100111111010111101111111111101022102101020a202202112102101220101011111111101011111a111111112121220220b1022020210012100220110111011101111111010
111111110110111111111101111110100001101111010111112012102122b021222022122112221211111011110010011111a111111221111201111b2221122122120211201111111010111111111111
111011111111111111011111011111101111110111111111111021111012b221021222102112112111101111111010111111a101111210011012022a0002221211201122010111011111111111111110
111101110011111011101001101101110111110111101111121112111210b022211122210220112011111111000010111110a111111121120111222a0122112121112220211111111110011111111101
111111111111111111110111111111111111111111111111110010020111b210211221212011121011011111111111111111a111011021121210122b1202101201201212021111111011101011111100
111111011010110000011111111111111111111111111110122022200202a200111110122221112101111111111111110111a111100111110111111a1001111111110111011111001111111000011011
011111111111011111111111110111011001101111111100122211120222a202201212111110212111110111101111101001a001010111111010111a1011111011011101111110001111101001101101
101100110011111100011011111111101111111111111101000122202021b022000012121202102011111110111110100010a111110101110111001a1110110110101111111011110111110011001111
110001011111111111111101111011111110111111111111111211121121b222202122221111121110011101110111011111a110111100111111111a1111100001111010111101111111111111111111
111111011001111111000101111111111111111110111111121101121120a012121102021012211111101001111111111111a111111101000111011a1111111101111111001011101111001100111110
111101111111111111111110011101111011111111111111002000211120b200112022120120222011010110111111111101a111100110111110111a0011101111101111010101111111111100111011
001101011111111111110111001111111111011101101111112112011211b200121122112210011110111111111111101111a011111111101111111a1111111111111111110111111110111111110111
111101111110110111111110111101011101111101011111101101111120b211120211111012201211111111111111000011a111111111110111011a1011100111011101111111111111110001010101
111111111111010111011101111101011011100110011111002110221200b020212210220010111211101110011111110111a111111111011111111a0111101111110111111010100111101110101111
111111110001110111011111101111111111111101110011121111212122a110222212211121222111110000111101111111a111001111011111101a1110111111111100110111110100111011111011
110101110111111010111110111011010111111011101111012111102212a221122221110221201201111110101101101110a111111001111111101a1100111110111011111111011111101111110101
011111111111011010111101110111111011111001101111111011221212b101122111121211111011011111101111111001a011011110111111111a1110110011010111110011110111110110000110
111110111110110111110111011111111111110101101111110111222212b111212201202110112211111111111101110011a011111111101111110a0010110011111011110111111011110111001110
101111111110110110110101111111000111111001011011120001211000b212222221111121021111111111011101111111a111011101101111111a1111010100111111110111111011011111111011
111110100101101111111101110101111110101111101011111000212221a222120121100022101011011111111111011101a111111111101111001a1110111111011101001111111111111111101101
011011111111110111111111111010011110101011111111112002211021a212202012212211201101110011101111111111a110111111101110111a1101111111110111111111111111111111111110
010111111101110100101111111111011100111111011100011011020222a111121222112112012111111101111111111111a111011111111011111a1111001110111111111111111101011111111111
100111011111111011101101111111101011111110110111101122122121a122022122022110212210111111101111011111a111111111111111111a1110111101101111111111111110011111110011
111111111111111111111111110111011111011101100111101110111111a111101101011111011111111111110111111101a110111111001011111a1111011101101111001011111111011111101111
101111111111011101011111111111111101001111111111111111111111a100111111011110111101111111111111101111a111101110101111101a1111011111011101111111110000011110011011
101111111111111111111111111101001110111111110110100011111111a111111111111111111011011010111111011101a111101101111111110a1101111111111100001101101111010011110111
111110111111101110110011111111111011010111111111010111011111a111111101110111111111011100110001111111a111111111120112122b1121010220120211112220101111111111110111
011111011011111111110101111111111101101111111101011111111110a111111101110111101100011111111111111111a111011111111102210a1111211112100122111112111011111111101111
101111111111111111111101111111110111011110110011100111111111a100101111111011110010111111111111010111a111111110112112102a1110112110121212011021010111010111111111
111111111110110111111101101110111100111111111010011111101111a111111111101111111111111111101111012122a122122112022012222a0202202110021211111122111111010010110111
111011011110001110101000111111011011011102222212112002211110a120111121101111111101110110110111111222b101212020201110222a1122220200222022210121111110101010011111
110010111011111110000111001111101011111112222111210221020211a112211121001101111111110100101001111210b211222222000122020a1202212111222120122122111100011111011111
101111111110111111011110111111011011110111222021112210221111b021012211211111111111110110010101111201b220202212112202100b0112222012211120122122101111111111111101
111110011111110111111111011010101111111112112200201202212012a120101222011111111011111111111110110110a221110120101120022b0212120210211122212101011111111111010101
111101011111111110111111111101111111011111110220222101021112a121100221120111111011111111010110012011a200221112012222121b2222022110212112202020101011110111111110
111010111011011110110101111111011011111110212002202212100022a201012121211111011111111101111110011220b110101112121202222b2222222021122210211122011111111111101011
111111001101111111111111111111111101111112211200211110022221a211221200010111111111111111110110111210b002112001122222222b0222222121212020111202111110110111111011
111111111000111111111111100111011111111101012211210112011102a111120201121101111111111111010111011020b222210220120122202b2220220101210122021112111010011000111110
111111101101101001111001101011110101101011121212102111221221b221201222011010111111111111111111111121b221212212122101222bbbbabbaaabbaaabaabaabbaaaaaaaaaaaaaaaaaa
111111101111100111101111011011111110111101020022220212011021a222121111011111111101101111001110012122a11121022122100112202120002221220111111201111100111011111110
111010111111111101101001111111100011011111021011020220212121b002102200111101011111111111110011012112b00011212122222222220112222111112222220202100110111111111110
111110111111010101011111111111111111101011012211002102120102a222121122021101111011101110100111102212a02210102212200221222100222212112201212122111111110101111000
111110011100111010110111111011011111101110120121120202122122b122211202111000011111111101011111112011b10002112112202222101221121010120221202111011111101111110011
111111100111110101111100111111110111111110200111212211101212a201122211121101111111111111111111010112b00211111102001221212022212212221122211212111011111101111111
011111110111011000110111110111111111011101112011122122022121b112022212201000101111111111111111111102b01221221201022222200122222021110220011211111110111101111111
110111101111110111011111111111111101010102121210122112220002a211211220011101100110111101111011102212b20100121202102212220221122211211221222222111111011111101101
111111011011111101111011111111111111100112021222122012111222a112002202211110111111011011011110110111a20202212122222022212201220110112101122022111111111111111111
110110110001111111111111101111110101111110120221100221210021b220201012010101111111111011111111012112b11112221222210120212221200202002122211101111111111011111110
011011111111111010111100111111111110111112111212111001221220b221112212221111111111111011111111112011b22212112202222012021000222212112220210122111111001111111110
110111111111111011111111111011111111101000200212121211222111a122101112111110111011111111011111111111b12200120222211022212121212111002221202011111111011111111010
111100111111110111111000011101011000111112002122101120211122a221210212211011110111111011100111110111b11122222212212122111212000121222011021212111111111111111011
010011101111111110110111110101111101110101102110210111121220a122201222211100001111111111101111012111b21001212222101222200222201122221102112111101111111111110111
111011111101010110100111111110111111111111121101001122112202abbaabbaaabaaaaaaaaaaaaaaaaaaaaaaaaabaabb02012222122112120222121112220212100222222010011111011110001
1111001111111111011010111101111101101111122021122211121022111100211102211011111001111110111110112121222121110122100102120222221102120211121002101111011110101111
0001110101101111111111110111001111111111101221110121202021002112222201111111111111010111110111011122210121122122021121021221122220120212210022111111111101111111
1110110111111111101111111111111010111111101211112201002211111122111111121100111111111111111100112220212222210122202222221201211212110211122102011111111111111111
1101111111101111111111111010011011011111102112210221122110222112101222011010001110101011011111102100212221122212002000222122122112112121020210011011110111101111
1010111101001101111110111101110111010011122111020211022111021122220122220101111101100111111011111211102001111022112212110201212101111011011111011101101011111111
0110111110100111111111100111111111111111110211201022212222212100122201121111111100110011111111110122011221210201221121111202022111111111101111101110111101110000
1011111111011111110011111111111101101101120101222212111011020101112201221011110111010000101010111220001101011121112101120121212111110111101110111111111111010111
