14 69
149 71
122 49
126 101
64 67
119 18
56 105
111 104
8 43
26 34

1011111111111111100011111001111100111111011110110100a11100101101111010111111101a1101111111010111111110010101111111111110111001111111111101a111101100111111101101
1111011101101111111111011110111111011111110011110110a11100011111111111110101111a1111111111011111111111111111111111111101111111111101111011a010110101111111110111
0111111101111011110011111111111111100011011111101111a11111111011111001111101011a0001101110110111111111011111101111111111110111111101011111a010011111110110111010
1111111110111001110110111111111111011111101111011111a10111110111001111101111101a1111100110110111111110000002221221220102122102212122020101a110111011011111010111
1111010011111101111100111110011111111101111011111111a01001111111111111111011110a1111111111111111111011111122011112211120011101110212011110a111010111110111111111
1111110111010111111111011011111101111011111111111111a11100110111101111101001110a1111111111101111010010110111221121200022111211111201112011a001101111110111111111
1101111111111101111111010111101111111111110101111111a01101110011110111110111011a1111111011111111101101101201201022112211212022220121001111a010111111111101111111
1111111111111111001101111111101101110111010111111111a11000110101111111111110011a1111100110100111111010112221121022111022112220122211220111a111111110111111110111
1111101111101011101111111001111001111011111111111101a01111101110111110101111111a1111111111111111111111111002021022021022111222121001222011a100111101111100111011
0111101101100111111111110011111111111110101111101101a11101110101111111111111101a1111111111111100010111111011201000112121102120110011122110a111010111101111111011
1110011111001111011011110111111101111110111111110011a11111110111111101110111101a1111111111111110101011111221220011222121222101122001100011a110111111101111110001
1101110111111111101111111010111011111101111111111110a01011111111011111110111011a1111111110110111110011111011122201212201112221012222122111a101010101111010111111
1111110111001001111100111101111111111110111011111111a10101111111111101111111111a1010111110111111111101111202222202021220211222012122110111a100111011111110010011
1011110001110111111011101110100011101111110110110111a11111111001110101111111111a1111110000001111110111111222001222211200212112221122211010a011010011111111111111
1110111101111101111010101110011110001011101111110011a01101111111100111111101111a1111011111111111111110011212121221121212121221202112021111a111101011111010101111
1111111101111101111110111111011111110001111101110101a10011101111111111111111111a0111100001111011111111110102120121222101122120112012222111a101111101111111111111
0111111111111111111110101111111110111011111101111111a11110111111110111110111011a1011111110111011111010112122021000201121110102011211011111a111011111011111000111
1111111010111010111111111111011001110111100111111111a11110111111111110101101111a1011011111111111110111110122101101011212211201110201012011a111011111011111111101
1111011111110111111111001111111101110111111111111111a01110010110111110110101100a1001111111111111110111111221001212022111211001010001121111a101111101110111111111
1111101111121112211012112202100210100121001110110101a00011111111111011111111111a1111101111011111100111012122121111011122121101212222220011a111110010111110111011
1111011001110122221211000120222122002022101010111111a11001110111111001101111101a1101111100101101101010111212210212222110221222021012211011a111100010101111001101
1011010101122111112112221010210220111112211110111111a10111111101110011101111111a1011101111101111001110112221020011202201220220221112112111a110110111111011100111
1111110101110022020120222212122221102212210100111111a11111101111111100111101111a1110111101110111111111012222121111212121121222121122221110a111001101111010111111
1111110101021121122221122112111112122100111110011110a11111101111101111001100111a0111011110111111111111112120222220022110211101122112120111a111111111111011001010
1111111111121201122022112110220121121222121111110111a11111011111111110101011111a1111111011110101111111012022220200212122122212212210212111a110101101111111111111
1111111110101101210112220212111211211021011001101011a10111100111111110011101111a1101111010111011010010112221021212010122102021201022201011a111100111111111111011
1111111110112121121222101122210101002222221111111111a01101111101111111111111111a1111011100111100111011101212111002222102020111212100121111a100111010111111010110
0111110110101221222200221122122111200120221111011111a11111001111111111111111011a0111111101111011111111012202102200002212212200211021201111a000101111101101101111
2012010211122101202212020122221022122112211101111111a10011011111110111111100110a1011111111111111111111110100022102011101110102211222101101a110011111110111011010
1021220211122201021202222110222012110002101111011111a11110011110100101110100100a1111111111111011111111010102021121221112201220222122211111a111111011111111111111
1021122112122212212222212222121012122211111110011111a11111110111111111011111010a1111010110111101101111112222101002121010222110222120111111a111101111111111111111
2120221011212022011202211020002211011221011111111110a11001001110010011100011011a1010011111111111110111111220102111021120112111200122120011a011011011011111101100
0121010120121210212012022222022012121022210001111111a01111101111111111011111111a1110100111111111111111111220122220101211122211120221221111a111011111111011011110
1222201102121222212220220122222112222022211110111111a11110111111111111111011111a1011100101111111110111110211212222112112112120012201102011a110011111101101110101
1212221120121220202022022221111120212212121001011011a11111110011111011011111111a1111111011111101111111110112212022112012011111101100211020a110100110111101110010
1022222212221220202212202211022211102212021111101111a01111101101111111111111010a1110011101110111111111110112120022212122211002210212012122a111111111100110011111
2122200021112212110212200222202122112122111111111011a11110011011111011111011111a1110111011111111111111111012211211111222210212122111121022a101111111111101111011
1122211222212222212202221212222111122201121010010110a11101011011110110111111111a0011111111001111110111111011201201121201112121201110121022a111101110011111100111
2222212212212210222012221210022001212112211011111011a11111100010111111111111011a1111111100100011011111111112120111210222011122221222022122a101101101001111110111
2120122221102201022020012212202222020122120011110101a11001111111111110010011001a1101111110111111110011111112121221201012112101222212011210a111111011111001111111
2222121221222202222021222222212002022011011111011110aaaaaaaaaaaaaaaaaaaaa111111aaaaaaaaaaaaaaaaaaaaaaaaaaaaabbaaaaaabbba211012222220212112a111101111111110111111
211220220012222202010002121110212112022112011101011111111111111111111111a1111111011111111011010111111101110010221202120b022122211112202111a101110111111011111111
210020201112022202221012112202202112202202111111011111111110111111111111a1111111111110011011111111110110111211110101222b122222200212110002a111100110101111111110
122212022012222022221010202122222111122122111111101110101111011111111010a1011111101011110101110111111111111012002221122a012110222211001120a011100111111111111011
bbbbaaaaabaabbbababbbbbbbbaaabaaababbbaaa2111110110001110111111111111111a1111011100111110111111111111111101120222222222b220011202121221212a111111110100111101111
2221201101102212021221222221022020011022a1110101111111101111111111101011a1111111111011111011110111111110111212221122101a112122222102122220a110111111101111101011
0201011102222222212212022211222221110111b0111111011111101111011011110111a1111001111011111111111111011111111111011010101a212212111022022210a011011111011011011111
1201001212022002221222022220012121122211b1111101010111110111111111111111a0101111111111011111111110111101101021122112121b222221122200201021a111110001110111111011
1220102112222212222002002221202211101211a2101101101101111111111110110101a1110111111111111111111111011110101110112110121a201221102011211021a011111111101111111101
2222122021222021222012222222222212022111a2100111100111111011010111110111a0011111111101001011111111110111111121010222221a211220211222020221a111101101111111011111
2212112121121120102111201021101101101110a1111111010111110111101111011101a1101110100111111011011110011111111122112202011b211121222221112211a110111111100101110111
1110211212222221121201120022111001111100a1001011101110011110111011111011a1111111111101011111101110111111110121210102221b021110212120110112a011010111111110111111
1102122122201222012200102021102111111111a1101111122212101112111201110010b1112012101111101110010111111111101201011201222b122200110221121212a111110111110111111111
2112012211102111222011111211012011100111a1111111101212222120122021112222b2121111110101111111110111111101101022110211011b222002221211121112a111011111111111111011
2112122112122201201021210021211100111111a1111111111212122221212020202222b1010211111111101111111111111111111211101112112a101110022202211202a111010111001111111010
0012212112212222111211202121102111111101a1101111011221221121211111012010a1112112101100111101111111111111111112122212010a122221211112220121a111010110001101101011
1220210220212222201212111121021111110101a1001101021112221111122102120122b2211112101111111011111111111111101102201222111b021100121021121201a111111111111111111100
1211121112000201122120121120201111111111a1110111112222122210211222200110b2021110111011111111111111111011110210012221121b112100211201112101a011001111011111111010
0212210120222222111111102002102111111110a0011111101121211120220101022111a0200021111111111111011111101111101110012101221a101022112221122102a111101111111101111111
1111001010111111011111111110010100110111a1111111122011210012120211212120b1021121011111001111101111111110011222122110222b011112112220102011a010000111111111111110
1001111111111111111110111011111110111111a1110111101121210022101200011021b2122111110111101110110111110111111202102210220b212022222202010200a111111101111011101011
0111101111111111111100100111101110011001a1001111111112212211122222000121a0120221110111011111011101111111101222121201110b210110022120211201a111011101111111111111
0011011011111111111111100110110111111111a1111111112122221122102110222220a1122221110111111101110111110101111111211112112a112211210111112101a111111001101111111111
1101111111111110111100110011111111111011a1111101122112212211010112210102a0222122101111111011111111110111001100222111222b010200011021122112a111101110111111110111
1010111010101111111110110111101111101010a1111111101010212011111011112102a1000220111000110111010111011111111221210211000a000102100012110112a101111110101101111110
1001111110101110101111111011110111111111a1110111122222201111102212122122a1002210101101111110010111110111110011111111110a111111101110101111a111011111111111111101
1111101011111010101111110111011011111110a1011111120110121212120022222211a1001110111110111110111111110110111111111111111a011111001111111011a110111111010111110110
1111111111111111111111101110111111110111a1001101102111222200202221112121a2112212111111101111111111011101111111111111111a011111101111011101a110111110110011111111
1111011111111000111111011100101111111110a1110111112200212000221220200011b1221112011111011111110010111111110101011110011a111101111111111111a111100101101010111110
1001111101101111111110011111111101111110a1101011120012222101001201222012a0222022111110111111110111101111111101101111111a011011111111100111a111011111111111110111
1111111100111111011111101111111111111110a1111010022021220121201011202212a2211022111111011111111111011111001111110010111a100111111111111011a111011001111111100100
1111111111110000111111111111110111001111a1111111121222121211112012210211a0221112101111111110111110000111011111101111111a111110011110111111a111101011101110101111
1111111110111111110111100010100111111111a1111101112212021101222202112122a2122112111111101111111101111111111101011110111a111111111111101111a111110111110011011011
1111111111111101110111111111111111111111a1011111111220210022012012202221a1202112110101111000110110110110011010111111111a111101101101011011a010111111111111111101
1111111111110110111111101111111101111000a0001111101110221221222202022202b0021002011111100011111111110001011110110111111a111110011101011101a111001111111111101111
1111111011111101111110011111101111111111a1011101121221222222002222102212b0220200111111101011111111011111111011111111111a011001111111111111a011101100111110101101
1111011111110011111011010011111011101111a1110111121202222121102102212121a1210011111101010111111111011111101110100111110a111111111101101111a001101110101101111111
1111000111111011111001011011111011100100a1111111101211120201111110121121b1112101111111110100111111111010101111111010110a101111010101110101a111111111111011111010
1111011111011101111110110111111101111101a1010111122212221111202111121011a2100111111110011011111011011111111011011111111a110011101011111111a111001011111100111111
0111111011111111110111111111101101010101a1001011012012222100211122012212b1212122111011011001111111001111110111111111111a111111111111111111a111101111111111111111
1110110111011110111111111111111111011111a1101111112222220022211210222211a2122220111110111111111111011111101111111111111a101111111101111111a000110111101011111011
1111111111111111010110111111101111111101a0111111112012211211200110121110b0221101111111111101011101101111111111111011011a111111111011111101a101111111111111100001
1101111110101011011111011101111111110001a0001111111112201121022120210121a2112212011111111101111111111011111101011111111a111011110110111001a111111111111011111111
1111111111111101010111111111111100111111a1110110111111111111111101011111a1111011111110111101011011111101111110101111110a110111110110101111a011101111011011111011
1111101110111111111111111111110111111111a1010111111111011111011111011010a1001110111111111110111111111111011011111011111a111011111111110101a111110111111111101101
1111011111111111111001111111111101101111a1111011111111110101111111110100a0011010110111111111011111111111111111111111111a111101111111011111a011111111011111111111
1001111110101101010101101111111111101111a1111111110011100011011011011110a0110110101011011111110111111101111011111201221a221111100200112212b222111111111111111011
1001101111111111001100111000111100111111a1111101100110111011111111011011a0011111011111111101011111110111101111021001212a221220212221011211a212110111101111111111
0111111011100011111101111111011111110001a1111011000111101111010110111111a0111111111110111111110101111010111111121100112a122220011021101201a110111111101111101101
1011101111111111100101011101011111111110a1111111111101011111101110110010a1111101110111101010111111222122101201102220011b002222022101211101a111110101011111101011
1011111111111111110011011001110111011111a2101111221211222021121022120222a1111111111111100111111002021112110110202122201a121022222221121100a011111011100111011111
0111110111010111111111101111101110001111a2211102210122221112101122122211a1110111111111111110111011200002022001221022221a222220212122111222b011101111110011101011
0101011111101111010111111111011111111110a1122211022120101221122200122121a0111100111110111111101110102210011121012121222a112221211012212221a021111111111010101111
1111110101111111110111110111111011111010a2122110220202122211012110220222a1110111101011111111111102222211021201220022122a200222200201111102a020111100110100111010
1110111101111111111110101111111111111111a2220221020221222222112211210212a1111111111101111111111121222011221110222211222a122222201222212212a211110011111101110111
1100101110111101111111111111011110111111a1211122122111222122212021121121a1111111111111111111111112111222002211200122200a022021211112122212b112111111111010110111
1011111101111111111111111011111111110010a0221201122211110122112002222222a1001111111111110101111100202212001110102222221b120212012111112221a221111111101011010111
1111111011111111111111111011110111110110a2121212211102212202101021022112a0111111001011111011111110112221112111121222022b102210111021221122a202111111111111111111
1111001111110101111111111111111111111111a1211211212111012201111110122022a1111111011111111111111011012221221222112122212b212222210211112222a222111100101111001111
1010111000111111111011100110100111011101a2211210111122111212112122120021a0111101001110111111111122111121222210120221022b122212211122121121a112111111111111111111
1111011111001111111110101011011111100110a1021122102222112201222121012222a1111011110110101111111111022012201110222212222b201222210212111222a201001111101111111111
1111111011110111111010110011011111111111a1202110121000001120212120221211a1111001101111110111011120211200211120121011021b222221210101212021b201110111111110111111
1110111010011100101111011111111101111011a2222112112110022212012122110010a1101111111011111011111101120021122002222122021b222120200112220211b210111110011101011111
1010101111000011110111111110101111111111a2111112211221122211201102121212a1101111111111111111111122102220222110012220022b112212212112122211a120101011101011111101
1011111110111111111111111110111111111110a0211211221022221112011211011202a1111111111111111111111121021101111221122211022b021122221210222002b011101101001101110011
0111111111010110010111111111001111110011a1211122202221201112201201110201a0111111110101111111110112010210121122211212202b011221210120112111b110011110101111111111
1100111110011101000110011111111111111111a2112122020212222211121121121022a1111101111110111001111111121212021012221022022b222002221121101121a122110110111101111101
1111101110110111011111111111011111111001a2001222021221211221122210211121a1111111111111111111111102212210210111122222220b210202212221220201a211101101111011101101
1101110110111110101111101111111111110110a0202122222122212222112111202012a1111001111011111111111122112120221221211222202b222110211210021102b112111110110101011101
0101111011111111001111011111111111111111a0112122011102121001011212121220a1111111100011011111101100121102020120101022120b220212110211001111a122111010001111111111
1110110101111101010011110111101111111011a1102110112201222120002111202212a1111111011111111101111111112202100120120022112b222222110112201112a210111111101111111001
0111111111101111111011111010111011111101a1202222020001122202010111021210a1011011011010011100110101102211110110110011222b220202122111122111a112101100111100011110
1111110110001111111111110111001111110101a1122010011112222011111112222221a0111111101111111110011120122111002112110022102b222122210222012121b200101111111110111010
1111110111101110010010110101100101111111a2201010121112112111120200202110a0000111111111111101111102022220221121102202221b000221001110112002a102111110001101101111
1011111111110110110100110011111111010111a2212120020210120100121111211221a1111011111111111111100020221212112122022222121b222222012212202211a022111111111110110111
1110110111111111111111110111111111111111a2120021120212112211021012221112a1111111001011011001111120120211111022010211122a200211221110121121b011100111111111011011
1010111111111011110101101101111101110111a0121112222211202112012110111122a1001111001111111101111112222222201122121202121b211202200011012220b122101110011011000100
1111111110010111111111001111101111111111a1111010201222210211212121100012a1111111111111111111110121122021222110222122122b120112111111111111a010100001110111001101
0101111001111110111111111111011110010111a2121102222111202120021221222022a1111011011111111111111122122111001201101021022b121220011011111111a111111110101111111011
1111001111111111111110000101111111111111a0220111002222202102202201002101a1111111111010010110111102222221010221211121112a222221211011111111a110111001111101110111
