1 19
151 58
122 49
126 101
64 67
119 18
56 105
111 104
8 43
26 34

11011110110111111110100111111111a1011111111111111101111a1101111111111111111111111111111110110111011001111011110100101111111111111010011a111111111010111110100011
10111111111101111111111111111111a1111010111110110101111a1101110111111001111111001110101111011111111111111111111111010011111111111111101a111110111110011111100111
11111011111110111001011111111111a0111101111000110001111a1111111111111111111100011111111100111110111111111110101101110101111011111111111a110111111100111101110011
11111111111011011101111101111110a1111011101111110111111a1111011111111111111111011111101111011111111101112111012221012111101012122222211a111111111111111101110111
10111111101101111011011011011111a0011111110111101111111a1011111111110111111110110111111001111111111111111221122121112120121120112110121a111100111101101101111111
11111111011111111110111111110111a1011101101111111111111a1110111111111111110110000111111111111101111111111121211122202212120122222122212a100111010110111111011100
11111111111111011101111110111111a1111111111101111110101a1111110111011101110101111111101111010111110101111111222022120211212012212111111a111101111111111111111111
11011101100111011111100011011101a1111110111111101011011a1111110111011110011011101111111111111101111111112102122220211110122211111112122a110010111111111111011101
11111111111110101011011111011111a1111111110111001111011a1111111111111111111111111011111111111111101110010120122212122121112121112021121a111111101111111111011011
10011111111111111011110111100111a1111111111011101101111a1111111111111011111111111111011111111110111011110021021220211211022211121211022a111111101111101111111110
11111101011110110111110111111111a0111111111111011101111a1111111111111011011111010111111111111111101111111201110112001102122101112101212a110111111111101111111111
11111111110111111111011101011101a0111111011111111011100a1001111010111111111100011111111011101101101111111121121122221221201021212001011a111001111110111111111111
10111111111110111111110111101111a0111011111011101111111a1111111111111110111111111111110110111111011111110102022220210212212122022222121a111111011111110101111110
01110110101111111111111111111011a0111111111111111111011a1011111101011001111101100011011111111111111111101102200120202122020202121221111a101111111101110011111010
11111111011111111111111111011111a1011111111001111111111a1110111111111111111101110011111111110111111110112012121211102202221121212111112a110101011111010111111101
11111111111110101111111111001110a1010111110010011111110a1111000101110111111111111111111111111011111111112210102111221102221211010011110a011111111111111111111101
10101111001011011101111111111101a1111110011111111111111a1001011011101111000111101111111111011101110111012120110011111211021222002011001a101001011111110001111111
10111110110111111110101111000110a0100111001011000110011a1011101110111001111010111111111111101111101111112211021110011011222121221102110a011111111111111001011111
11101111111111011011011111111111a1111110100111010111111a1111111111110111101101011111111110011011111110112222111121211222222022212112220a101111110111111111011010
11111111111121120212202201211112b2102101111011111101101a1000111111111111101101111111111101111111111101102211221200121211222222112112002a111011101111111111011101
11011111111122012122000212002101b1211121221001111110110aaaaaaaaaaaaaaaaaaaaaaaaaaaaaaaaaaaaaaaaaaaaaaaaaabaabaabbbabaabbabbaaabaaaaabbaa101001111111111110110111
11111001101202021111001120002210b1111011111111011111001111110111111111110111101101110110111111111111111111210212112000122120212212012101001111001111111111111111
11111111101122210121111212220101a2002222121111111111111110101111111111101111111111111111010111101011111122002212211110202120201102122211111110111001100110111101
11110111111102212211121021220122b1012112201111111111110010111011111111111111100001111111110111111111111102012201221011220221122212022121111111011111110110110101
10111110010220021220022221222222b1212112211111111111101101111111111111010111110011110111111111111111011112122210022120122011112221121211101111011111110111101011
01111100010120212122020011100000a0111101200110101101110101101101111011111011111101110011111110111111111102121220112201111020221021210021011101111111111111101111
10111100111111121202122202102201a1202122111111101111111010111111100101111111111111111111111111011110110110122000022011121111200211120211110111011111111011111100
01111110101121001102101212102111b1202112011111110111111111111111101100011101110111011111111111110111101112112121001112112110121211201121011111111111110001101111
01112121220022022221122202222220b2211101221111111111011001011011111111111011111111010111111111111100101100222210102201222121221222222121111111111111111110110111
20212100122222222221222121222211b2012111121111111111001101111101101111111011101111011111011110001110111121122211011022222211202212222111101110011111111011100111
21121112210222112102012220221021a2122200201111011111111111011111111111011010111111111101111111111111111110202112201222112201121221022211011101111011111111110110
21212212021202021200220110012201a1012112111110111101110111110111111011111110011111111011011110110111001020120220212200111110210111201121111011111111111111111001
22112222121012210021211222022112a0111112020110010101110011101101111111111011111011111100000111101111011101122210220101102010121022111011111111111111111111111111
12112221122201222221022221222101a1221112010011011111010111011101111101111101111101111110111110111111110121210220111201222121022121200121111111111111111111111110
10022012212020020102222202222202a1101102111110011111111111001111011111101111111110111000101100111001111110122011101102222121222122121112021111101011101111011111
12211221201202122222022102222210a2010200111110110111110111011111100011101101111111110110111101111110011111101210122021202212121001012221100111111100011001110111
01202212120222212222222022222201a0201101011111111111101011111010100100111111111011111011110100111011011111111121221102001201120201200112111111110111111111111110
22212202112222221120102020211201a1212011201011110111111110101111010011111011111111111111111111011001010101102121222120122122202112201220121111111111111101111111
12211222220221120022120221222022b1111111021111111111111111110111011010111000111011101111011010111011110011121121122011122212122221111101011111111011101010101001
02221221210222220210012200002120b1111011021111111111111111111110101111111111101111110011111101111010110111101122220100111112201022021201211111010111111001111111
21222121212222200120122020220122b2220101121111111111010001111111101001011111101110110011101011100111111100111001220121112222022122112011011101110100111101111111
02111200021112202212222222220221b1201121121111101110111101001111110111111111011000101111111111111111111101102212211221211021122111210220221001011111111001110110
12211122221202222210222220202200b0012212220111111111010111111111011111101111111111111011111101011110111111121011101010101012112021100020111001110001111111111111
11001222220212200222002022202020b2122111111110011111111111110011111111010111101010111011111111001111101111100222112100222120221102210120211100111111010111111111
00211201222122020120222212220201a0212122211111111111111011111011101010011111011010111111111111110101001111022222002120212002211121202020200111111110111111111111
21212211110220121010122022210111a0121211211111111111111001001101111011110110111011101110011111111110010011112022011211211012120002000112211111111101110111011111
10011121100201020002002222222020a2112111111111011111110111111011111011111011011111110110111011011110011111021120012012121221111122112110021111111111110111110111
12210222011222021212222122020120b0112220220111111101111111111111011110011111110101111110111111101000111111100221112211201220012120112121101111111111111110011011
22212021211112222021021220222222b1122220121011101111111100110011111111011111111111110011110111110011111101021021020022111201111112002122121111111111110101011111
02222012101222112020122002100120a112121111111111111111101111011111101111111111111110101100111110111aaaaaaaabbabbbaababbababaaaaababaaabaabaaaaaaaaaaaaaaaaaaaaaa
11122022211012212002221221221210a101111000110111111001111101111011110001111111011011111110110111110a010111122112221212112011201122212122211011111111111111000110
02222012212220010002111111111101a111111111111111111111111111111111111111000101001111101101011101111a111101121212022020222100111201220220121110111110110110011111
01112120112222111221201212201221a111111111101111112200212121211021202112111220111011111111110111110a011101122022002212101102221212022212211011110111111111111111
22121111020111111122220122220201a111111110111010011202110201220001112022121222221111010111101101111a011101111122200221001102011102222121111110111111111111111110
21101212000102112122200201201221a111111111111110102121212010022212101220022022201110110100110111011a111111111021121020012211010121120101221111111000011101101111
12021022100212222222111212211221a011011111101111111210221212112210221210022221211111011011111111110a001111101212011212120201022110211001211011111011111111110111
02222120220211102022120122011111a111111111001011111212021221112101102221121221121101111101111011110a011110022002111222222112012211102122021111011111011011101110
12120021211202122112012111122101a001011111111111021011212121112221122222210011111111111101101111111a001110120112120121120120111011002121111101111111111110101011
20121121211221122120221121120001a101111111111111111122112212110122022221012212211011111010001111111a111111122021212011221100221012211210121111110111111100001111
00111111111111101111111110111101a110101111011110111211220220120010220211012111221011011111111110010a111101111222111112201112220222222110221111101110101010111011
01111111111111111101101110111011a101111100101111112112112002021222211111021120221100111111111011111a110111122200002221212211211211011111221111001110110111111111
11110010101111111111001111111110a111111111111111122122022220211221201212001202201111001111010001111a011110101220112100021221112211221201100111010111100001111111
11010011010111111111111111111101a111011011111101122221212022221022222112112211211101101101101111110a001111100102112122211111212211120112120111000111111111111111
11101110110111011101111111110111a111110110110111122111222120020021102221112221001101110111111111111a111111122110221110220202011101122211211111101111011111001101
11111111111111111101110110111110a011111110111111121011100222021102111101222022220111101101101111010a001111122111012100112120222012211210101001111110110110110110
01011011111111110110101011101111a111111111111111012011111110212211221001212101221101110111001110101a111111101111111111111111010111110111110111110111101011101101
11101111110111110111111111101111a101111111111011112121112110020101211020221211221111100111011001111a101011101111110011001001111111111111011111111110110011111111
11111111101111101111011101100110a111111010110110112022221120012211221122221220111111111111111111001a101011011011111111011111110011111111111111011111101111101101
10111111110111011111101110011011a110110110111101111101112220222202221220010112111111110111111101111a101111011110111111111111111001100101101101111101110111111111
11111110110101111011110111110111a111011111101111112200011212021102201222212122121111111110111001101aaaaaaaaaaaaaaaaaaaaaaaaaaaaaaaaaaaaaaaaa11011011111010101111
11111100111111110011010111101111a1110011110111111122202101200202111221221200102211011011101111111011001110011111110001101111111110111011001a11111101001111011111
11011111101111111111011111101111a1111110111011101111222012212221120110201021120111111111111110011111110101001011011011101111111011111101110a01011100111111111110
11111101011111111001100111111111a0111110001111101201110222112211100111211022110011110111111010110110011101111001111111110111110111111111111a10111110111011011101
11111101111111011010111110011111a1010100111111111002021111112111121221201212111111111110111111110110111111111001101111111110011001111111111a10111111001111111110
11101101001010111110100101101100a0001111110111011102211012201011211100202011020211111111011111111100101110111011011111111111011011111011001a11111111011111111111
10111111111100111001111111111011a1111111111111111101201121212221101201010120210111111110111110111001100110111011111100110111101111101010011a00110111101001111111
11011110100111111110010101111110a1011110011110111011111000020122212102222200012211111011111101101011011011111111101100101011101111100010110a11111110111011110111
11111111011111111110100111111111a1111111111110011021101002121011210021201120021111111010111010110111110111111111101111111111110111110101111a11111111110111101111
11111011111111101100011100101011a1001111101111101212211111122020202200121110000201110111101111101111111111111000011111111110011110111111011a01101101011111111111
11111111111111111111111111101111aaaaaaaaaaaaaaaaaabab11121220022211021210012011211001111111110111011110111111100111110111101001111010101111a11101111110011011111
1111111011111111111111011111111110111111111111011022b12221212120212101121001010211110011111111111100111111010111110111011111111011101100011a11011111111111101110
1111111111111001110111101111111101111110111111110102b21221112221012220220112212110111101011101111011010110101111111111111011110110011111111a01110011110111110111
1111111111111100111111111101111111111011111111010002a02111202101211212021121010111110111111111111111111111101110101001101100111111001111111a11101111110011111111
1111111111111110111111101111111111100011111111111111a11110110001111110011111000100111101111111011111100011111111011101010110010010111111101a11111110111111111111
0111110111110111111111111110011111111111110111011010a11111010011111111101111111111111111111011110111111111011010100110111110111100101111011a10111111011110111111
1111111111111110111111100111011011111111011001111111a11111111101111111011100011111111010111111010111111100011111111011111001101111111111111a11110101101111111010
1110111111111111001111110111111101010111101101110111a10011111101110111111110101100111111101111111101111011111110122120221101211122112221202a12111110111100111111
0111111111111111110111101111001110111111011111111110a00100110111111111101111111111111111011110110111101101111111200010121011210211212110221b01011101111111001111
1000011111111111111111111110110111111111101111111011a01100111111011111111110111101010010111111111111010111111111111212221002210212122211112a21101111111111111111
0111110111111011111111011111101110111011111101011100a00111111011111111110110111111110111111111012212011212110112102201222222222202210002120bbbaaaaaaaaaaaaaaaaaa
1111001001111111111111111111111101101111111201210212b11212021202022000121110111101111101101111112220120221210211122222112200121110112022112112011111111111111111
0110111011111011110111011100111111111111000100002111a01212100221100110220101101111111111111111111211200212202122220122002222221102121102202122111111111101011111
1101101110011111011111011101101111101011110220220221a21011122201221222211111111100111110011111012011011212221122202212120121012012121012211101111111111110111010
1111111101111111111111111111110110111111121122111221b11021212221211200121110101111111111001111102010212101122112202220221221221122012020112212100111111110110111
1111111111011111101111110111111111111101112112120101a22112201012212121010111111111101111110111101201211111200022112120221021221201122001001111110111011111011111
1111111011101010101110111110001101111110021102202100b11112110121221022110111011111111111111110110121121221121122210222222200222211121111112120111011111011111111
1110111110111110110111111111111101111111120022201020a00212221220102222011101111011001011111011010112220112210012212220022122110101112121201201111011111110101111
0011110011011110111010100111010101111111122222222122a22221112122102122221110011110111111111111111021112120112102222220212012011011212011022001101111110011111111
1011111110111101000101111111111111111111100122110120a12122112222111212121111101111011101101111112221221222012012220202222210212021120212020221011111101111110111
1111110111011111101111111111111111001111111121210012ababbbbbbabaaabbbbaaaaaaaaaaaaaaaaaaaaaaaaaaaaaabbaaabaababbaabaabbbbbbbbababbbaabbaabaaabaaaaaaaaaaa0111111
11111111011011111111011111100111101101111220110102112211100121222220222011111111110101101111101121221112122111022122200121222212121121220022121111111111a1111111
00011011011110111111110111101111111111111110212122121222121210012221111111101111010111011110111112010101111111122212222222222120121020211100201111111001a1111110
11111111111111111000011100110111101111111112112201221111120202122212112111111111111101110111101122121111202220112002202012222122121112011021211111111111a1010111
aaaaaaaaaaaaaaaaaaaaaaaaaaaaaaaaaaaaaaaaaabbabbaaaaabaabbabbabbbbaabababaaaaaaaaaaaaaaaaaaaaaaaabaaba210210111221201022102221220212110220121021111110111a1010110
1100111101111111111011111111110110111010112112121121121010212211210201201111111111111101011111111122a021121200202020222101102122221010022221211110111101a1111011
1111111111111101101010111101111111111111120222122211110200111011212122210111111011110111111111101202b110101102212202221220002222121121122000101100101111a0111111
1111111111110111011011111110111111111011122121001012011211111212200120101011110111111101111011112012a111121111220221202221210022121022212021021101111111a1111011
1011011111011111111111111111111110111111121210221111110212022111112021211111111111111010101111111210a011222102202222222011222202021110122020211011100110a1110110
1111111011001101011100011011110111111011101110100111121011220221202122221111111010101111100100110210b112211121222220212202020121222102112121111011000111a1111111
1010110111111111100110101111011111111101122222122221212201112012102021111111111111110011111111002122b221222121121122122202220221112222111211221111101011a1101110
1111111100111111101111101111101111110111122221012212221021221121211020111111111111011011111100011211b011210101022220212221201222222020122011111111011101a0011010
1100111111110110111111111111110111111111121021210221010122221011211211120111111101111000111011100221a110011122202022221202222211221200110202111111111111a1111001
1111011011111110111111111111011011111111122021111211112212221112211210211111111101110011011011012211a120112122211120222222222112120111120012010110111001a1111111
1101111110111111101111111101111111111111112212211202221121211122112121221111111111111011111111011102a021020212120221222100222210121111101010211110101111a1101111
1111000011101011110100111011111111011001111202022112011121111120211222211101111111101111111100112222a121121210112012000222222221121222020122211111101111a1111110
0111110111111111110101111111111111110111121121111122122210011201011202201110111111111110111100101210a120111101101221211022221222221211111211020001111101a1101111
1111101111100111011111111111111011101011110121010010120111101122111010011001011110101111111101111010a111012112102010021200222222012102122221121011111111a1111110
1011011111110101111111010101001011111011120210112120020010121112122222000011111111101111101111012212b010102121212011011111202121111001110111111111110111a1111101
1111111111111111011110111111111111111111111122122110211121111211111202121011111111011111111101110202a111220101202222221122111211101111111101111111110111a1111111
1001111011111111111010111010011111111100022011212201120212212121110122020011110101111111111101001111b212122220222212112100122201110101110100101111111011a1001110
