153 13
130 109
122 49
126 101
64 67
119 18
56 105
111 104
8 43
26 34

11111111111110111111111101100111111110111a0101111101011001101111111111111111111110101111111111011000111110111111111101111111011111110111101a11111111111111110110
01111011111111110111001111111101111111110a1111111011101111111111111011111011001101111110111101111111111100110101101111011111111101111110111a11111011110111110111
10111111111111111110111111111111111111111a1111101101111101111110111111110100111111001111111111111111111111101101111111111010111111110111111a00111111001110111111
11111101111011111111110011101110110111011a1011011110110101011111101111111111111101111010111111111010111022200121010221101122121122112111111a11111110010100101111
11011111101100101101111011111101111111110a1111111111111100111011101101111111111aaaaaaaaaaaaaaaaaaaaaaaaaaaaabbabbbaaaabbaabaababbbabbbbaaaaa10101111111111011011
11111110101111110101111111111101110111110a1111111011110110010011011111111111111a11100111111010111111011122121221110121102212221211222221111111110111111111111111
11011011111111110111111111110011111111010a1111101111101111111111101111111111010a11101011110110111111011120112021201122211121121212212111101111010111111011011101
11111111111011101110111111101110111111111a1111111101111111111111111110111111110a01111111011111101011111112221212020112220200002120101120110111101101110111111111
11011111110110011111111101111111101111111a1111110111110111111111001110111111011a11111111111111111001101122222201211112121212122011200021111111111111111111101100
01111110111111101111111101010011111101100a1111111111001011111101110011111111100a11011111111100011011101121012122011211202111211022102111011111111101111101101111
11111110111111111111111101111101111110111a0111111111101111101101110111111111100a11111111111111111110111111210210220221112100101111122101101101100111111110010111
11011111111111111111101111011010111111001a1110111010000111001111111100001011110a01111001011001011110111011112121121020111212200212121021011111110111111111111101
10111111101100011111101111101110111111111a1101100111010011111111111110011011111a11111110111111111111101101120111121112012121222112021000110111110111010101111111
11110111111100101111101001111100011111110a1011111111110011101111111111011101111a1111111111111111101011010122212212101212210101220121112110111111111111111P011111
11010101111011111111111111110111001110011a1011110111111111111111111011111101111a11111111111111110111011122122121001112121021101011221220111111111000111110P01111
11011111110110111101011111111111111111111a0111101101110011111111011111111011111a10111111111010111100011120022111021120021222211120111220111111111111111011P01111
11111111001101111111110010111111111111110a1111111110111111111011111011110111111a11111111110111111011111120221100000122111021201011210211001111111111110111P11111
01111110011010111100111111011111100001110a1111101111001110111111111111110010110a01011101101011110111110110210222201112022012021122120210110111011011110001P01111
11111110111011111111111101011111111111110a1011010111010110111111111111101110111a11111110101111111111111112210021111112121221121002122021000010011111101101P11111
aaaaa000011202012122121122212121120011212b1110111101010111110111011010110111111a01111010101111111011111002201211201222211210221201201121111111111001111010P11111
1001a001111122011221112022202012101111112a1110110011011111001110111110111011101a10111111111101111011110121212122212222001211111222120111111011111101011010P10011
0111a111110211021110222211211122021201112a1111010111111011011001111111110111111a11011101111110111111111121111012201211112011221120100211110111111011111101P11110
1110a111111111100122020101121011112211022a1011010111110111111111001111110111111a11111111111110011111111111102210020202220201201112001121110111111111111011P10110
1111a111011201212011202011121222121221121b1111011111111111111111111011101111111a11111101111100111111111112211121001121211112221010120211101111111110011110P11111
1111a011101221012221121100120220121101121a1011110111110110100111101111110011101a1110111111101111101aPPPPPPPPPPPPPPPPPPPPPPPPPPPPPPPPPPPPPPPPPPPPPPPPPPPPPPaaaaaa
1011a111101002011111121221211121121201220b1111011111101111111011011111111111110a0011101111110111110P111001012111210201111122210211122121111101011110111010101111
0110a110101202220220121121121221201211112b1111111110111001111101111101111100111a1111101111001001111P111011211022122121010212110210010011111111011001011011111111
0111a011100011211222111100011111212221221b0111111111111111110111111111111111101a0010111111101110111P110021211221222121022221022002021011111111011011101111101111
1001b212002002222222100121212221121111012a1111100111111111111111111101111111111a1111111111111010101P111110112001220221202112222101101201110000111111110111111011
2202a110221221222221122220101221010222212a1011110001011111111111011111100111111a1111111111111111011P111122212101111101122112002021222201001111111111111111011101
1111b022221022120121002220221221011111101b1110111111011111101111011111111111111a1111111100111110111P101122101122022221112111011021011011111101111111111111111111
2222a221212210021222222221222200220211112a1111111111111111111111111111111111111a0111101110011111010P001112002112221221112011011000002021111100111110011101011110
0212a021111112220221122122221211112122200b0011110111110110110111100111101110111a1111101100111111110P111110221122112211122021122011121210111111010111111111011101
2101a120211022212221210121012110210112110b1111110111111111110101110011111100111a1111111111011111110P111120121201212021112222210122111101111011111110011111111111
1222a101120221202122022022221021122120121a1111111111111111001011111111111111011a1011101011111011011P101111111011212121201102120222220221210101001111111111111111
2222a211010122211002102122122122112212221b1111111011011111111111011111110011100a1001111111011110011P011111121122200002221202210221121021120111111111111111111111
2102a112220212022202121122202122121121022b1111011011110100111111111100111111110a1110111111111011101P111101112121121021202121102212221022121111111110001101111111
2102b112101221210211012222222010011111112b1111111111111111111011111011001110110a1111111011111111111P111111121022221002101202111021112211111111111111111111110110
1211b022021211102022022221222202211002111b1111001101111111001001011111111100111a1111111111101101011P111110110210212111121210121112220221201111111101111001111101
2011a221221222122102222222100102210222220a1110111111001111111011111110011111111a1111011011101101101P101111021211200221020212020210212221121111111111011110101001
1002a122012022222222211222222221221202221a1101011111011111111111111111110111111a1110110011111110100P100011122122121001121122011121211210121111111111111111111011
1111b211211022222011222020122022202010011b1111111111110111111111111011111001111a1111001111111011111P111111111101222200101120121021112021200111111111110101100110
2122a022111222210020122122222101212001211a1111101010111111011101111011111101111a1111010111010100111P101110111120122212210101011011212210211110111111111111110011
1210b122121222222112111222022211111211221a1110111111011110111101111111111110110a0110111111111111111P110111011101220220220212010212110221101111011111111111111111
0102b112122212122222201022102122211110112b1111111111111110111101100011111101111a1101101110010010011P111111011022012221221120112112211102211010011111000011011011
2022b122220222202022020022122212120111111a0111111101110111111111011110111111101a1110111110101011010P100010122122200222120210122210021111211101110111111111101111
1122b111020122222222221210221221121212102a1110111111110111101111010111101010111a0111111001101111101P111011021211212112112112122212111112211110111101101111010011
0121b121211222222120022222222221212022222b1111011111111111111001111111011101111a0110010111111110101P111010112000202221102210111201020120021100001111010111110111
0122a211220022210222112122200222102221011a1101111111101111111110010110011101110a1110110110011111001P111001111021120111121212211010121100011101111011101001110111
2222b001201212212222212002222212211120101b1101101101101111111011111111010111111a1111111111101111011P000011120112221211112222112222211211021111111111111111111110
0112b222011212012011120111122101111111111a1110111111110111011111010111101111110a0101011011110111110P110111112220222010201220121210012122121111011101111110111001
2111a212021121122220012201201211010111111a1100010111111111111001111111111010011a1110011111101101101P110111121211111000202021202121111011211100011111111111111111
1022a120201221111202122012112011101111111a1111111111021120121221212011122210002a1111111011111101011P111110021111202211112120210111122121101111010111111111111111
1112b111120121101112221210120021110011011a0101111212221211021122221122112222011b1111100111111111011P111111100110021010001110110110201220110111111010001011010111
2222a011212101120102211022022201111111111a1110110220101212212122101112102211112b1111011111101101001P111111111020111112122122210101122211221101111111111101111111
0201a211201101202211120122111201111011111a1011111110012212101221121021011222212a1101011111101111111P111111021121221212102201002221112201121101111111011111111111
0110b012222221222212012211101100111111101a1111111111222201211210102100210112011b1101111011111111100P111111012121101202010122021020222111100111101111111111111001
1002a111112021211211011001121201101111111a1101111022021200122111211101001021212b1010001111101101011P110111112022110111210002202100102221211111011111111001111111
2101a121112021012001112212102211110111101a1111110112010112210211202010111012121a1111111101110111011P111110110111201202010122212011212101221111110101111100010111
1110a111111111111111111111101111111111111a1110111122000221121122110011020111121b0101101111111110011P11010102112001022022221102100bbbabbaabaaaaaaaaaaaaaaaaaaaaaa
1111a010111011111100111111111111110101001a1111101220001120222211111212022121010a1101111101111111111P11111012210112121210211012011b211021021111011111111110110111
1101a101111011111011100000001111101101111a1111111112110210212110001022222100011a1011110111111111111P10001101111001111211222002021b221020211101010111111111110111
1111a111010111110101111110111001110111101a1111101120211022110111102222120122220b1110101111111111111P11101110022021101022011221221b001022111111011111110111111111
0000a110101111111110111111111110111111111a1101110021021221111211120011201212222b1111111111111110101P11110110222221111211201100122a002121211111111110011111011100
1110a111111010110111011111110111110011111a1101111011021212101210112010221111111a1111111111111111101P11111110221222011121100012101a221110111100101111101101110111
1111a010111111111111001111111111100011111a1110110222012021011121002101221212221b1111111101111111111P11111010111011111111010011011a000111111011011111111111111101
0101a010101110111111111011101111111111111a1111010221102220102122021112122221111b1110110111110110100P11101111110111110101110101111a111010111011111011111111011111
1011a010011111101111001101111011101011101a1111111010222211111122121212120011212a1111111111110011111P01111111111101011011111111111a111111110111111111111111111111
1111a100111111111000111110111111111111111a1111111222011122110022101021011012111b1101011101111111111P01111111111111101111101110111a110111001111011111011111101111
0111a111101111111000110101101111111011111a1111111222012212002120122201211211222a1111011111111111111P11101111010111111111111111111a111111111100111111111111011111
0111a111111101111111011111110001111101100a0111111222121022222210212121211120112b1111111111111011111P01110111111011111110111111101a111111110011110111011111011011
1111a111111111111111011111011111011111111a1111111221122121020022021200222111101a1110111111110111111P01011100111101101111111011111a111110010111110001111111100011
1010a111111111111111100111110011111111111a0011111120122022012011122010012001021a1111101010111111111P11111011111011010111110111100a110110111111111001111111111101
1110a110010111010111111110111111000110111a1011011111012101011221012222021121211b1100011111101111111P01011111111111111111011111111a111100011111111011111111110111
1110a101111111111001111111111111010111111a1111111012121021210112202022211221211a0111110111111111101P11110111111111111101111111110a111111111111011111111011101010
1111a111111101011110001101111111011011011a1111100212210201112121012212122200210b0110111101111111011P11111111111110111101111111111a011011111101110111110111111111
1110a111111111111111000110111011111011111a1011111222111122202121222121001011212a1110110111111111001P10111011111011101101111111000a111111111111110011011111110111
0111a111111100011011110011111111011111111a1010111111222101100111101202011020002a1111111111111111111P11111101110111111101111111011a111111111111111001010110111011
1110a011100110010110111111111111111011011a1111111221100210110001212121110000212a1111101111110110111P11101110111011111111110111111a100111111111011111111101111011
1111a111111101000111100111111111011111111a1101111212002220011101221020020011121a1111111110111001111P110100111aaaaaaaaaaaaaaaaaaaaa011111011110101110111110111011
1111a011111011111001111111111101110011111aaaaaaaaababaaabaaaab21222110122011112a1111111101111111011P101011001a11111111111110111111011111100111011111010111011111
1011a10101111111011101110111011110101111001111110220220110102a12122111201202100b0111111111111100111P111111010a01010111111111111111111111111110101011101111101110
0111a11101011111011111001010111111111111110111001001122212002a21211122110120101b1101110111111011111P101111110a10111111111111110110111111111111101101101111011110
1111a01111111111111111101110110011111011111110111111110111101a01111101011101101a1110010011111011011P110111100a01101000111111111111101011110111001111101101011111
1111a11111110100111101111111110010111111011001110101101011101a01111111101111111aaaaaaaaaaaaaaaaaaaaP110111111a11110101111111101110111111111101111111100101111001
0110a01100111111011011101111111111101111111111111111101111011a01111001110101101111111010111101011010PPPPP0101a11111111011111100111101010101011111111111110011110
0111a00110111101110101101011101000110111011111110111101001111a0100101110101110110001111111110011011111111PP01a12201221112211122100102111220111001010110111111111
0101a10111111110110011111101101111111111110111110111111111001a011111111111111111111111010111011011111111110PPa01221121121022021022021212211122110101111110111010
1101a11101111111111111101111111111111111111111110111111111111a01111111111011111101110011111011111111011101011P10212022020011212122022101221122111111111111111011
0111a11111010111110111110110101011111111111011111101111111100a11110111111011110111111010111111111001000211221P22200222222111222101110000111112011011111111101101
1011a11111111111111111111011010011111111101111121201122112102a02121202121100010111011111111111110211211211110P10020122212122222222012021112112110111011111111111
0111a11111111101011111101011111110110111112101012210011001121b20222111111111111111111111111101110220112010120P10202222202222221101121111012022111111101011110111
1111a11111011011111111111011111101111111112121210022212121201b12022211121110111011111111111110001021121200222P02220221222222012111012202201220111111010001101111
0111a01100101111011111100010111111001011110122111212111110222a11001211200001111010111110011110100221211022202P22002020022020222021211212211201111111111001111010
1111a11111111111011000111110111111110110111210000221110212111a02222122111111101111011111010101111200221221012P21120202202221221000112101101012110110011010111111
1111a11100101110101111101111111111111111122121212122021101002a01100002111110111111111101110111111200102212112P21001112220221022220121111202202111100110110111111
1111a11011110111111111111001111011101101122202022212211111111b22102202201101111111111111111011111111112212011P12012112122212120202221001111001101111111111111111
0100a11111101010111001111111111101101111121212020211011122221b11211022221111110111011111111110112201201120101P21100212001202212221020011122112111111101111001111
1101a11011111111101111111101011111101111111012222112211210212b11221122110111011111011111101011110012210000220bP1022201102220211201122210110221011101101110010111
1111a01111111001111001101111111101111111121011221022212001022a12210201211111111110100011111110112122120111222abPPPPPPPPPPPPPPPPPPb002102010200111111011101110011
1111a11111111111101011111111011111111111111120021212211220221b2112110221101101111111111111101101100221211201112022022222120212102P221220222220111111111001110111
1111a01111110010011111011111111111111101121010011212212121120b1200210202111111111101101011111111221111121121122102222222022202111P200201020101101010011111111111
0110a11111111110111111111111011111011111022011210000220221222b1202210101111011111111011010011111021010202120110222221202112110220P122122121112011111101011100111
1010a10111110111001111111101111111111011112221111210220102121b2220112120110110111111011100011011112001122222122222212202221022211P121122211111111111011111011111
1100a01010111111011111111111111111101111112121021112120011121b2111111121111110111010010110111111201201121121121212021220222222221P012221222112111111111101111111
0011a10110101111101110011110111111111111120000111110211001011b0111221121011101100111111101111011210122221212121012212221221120212P111110000212111111111010101100
1110a01111110101111111111111111111110111010220121111202111102b2221121002111010111010110111111111112121012121221220222202222021221P111121122122111111111111111111
1010a11111100011101111101101001011111100122211110222212120222a2012101122111111011011100111111011121221121200101022002122210220212P211120121211111111111111111111
0111a11111111110101111111110110111111111010101121102011022211b0211212222110111111011101110111110022001211122112121122122221222212P111022211212011110111111101111
1111a10111111011101111111101111111110110122221112221112122011a1220211202110111111111011111111111121002221221101222202111000120222PP11212112211101110110111110111
1000a11111111111111111111110110111111011112110210120102222121b1111111202111010111111100111101110222121012120111002220222022121002b111222222111110001111111110111
1111a11110110111101110111001111111111101121222211121221221211b1111011221111111110111011001111101222002022221112212222222222110202b122012100211100110111111110111
1111a11111111111111110101110111111110010122001101012011222112b1102112011111111110010010111101111021212212121100222221200122221010a112222211211101111010101110011
1010a01111111111011111011111111111111111011111120012011122001b0222021110111110111011111111111111022212211101202221221212122210122b120222112212111101011111111011
1111a01011111111100011011101111111111110121101221222210010122b0112210111111110111011110111111111221202211121101221200222121220012a100212101201101100111100011111
0111a10000101011111111111111100111110111120200111211021112221b2002221221010011101110011011101011221021002100100221011222022212201b202212011220111111111111011011
0011a11101111011011110011101011110011110012211101101021201222a2122011002111101111111111101101101001211222021122222222222211112020a212212211212111101010111011101
1111a10111010000110010001111111111111111102222120112201101121a1222110121111111110111111110111111012222112122122122211022012120211a111111100111111011110111010111
0100a11111101110110111111110000111111110101201020102220201021a1122010011011111111010111011111111122210210122111202022121011212210a111101011111111101111011111111
1111a11111111110011101111111111111101010102220101122211112010b2220121210111110111111111111111011220001212212101112102212221221111a111111111111111111011101111111
