153 13
130 109
122 49
126 101
64 67
119 18
56 105
111 104
8 43
26 34

010a0011111111111111111110111001111001011011111111111011101101111101111001101101101a101111111011111110a011111111111111111011001111001101110111a11111111101111011
101a1111011011011111111101111111010111101111111110101111111110111101100111011111111a111011111111111111a111111111111111111001111111011011111011a11111101011011111
111a1111000111111111011110111101111111111011111111111101101101011110011110111110111a111110111011111111a111111101011011000100111011111111111011a11001101100001011
111a1111111011101111011001101011111111111111100010001101110111111111111111111111011a110011111110000011a110002221201112201212011201010100101111a11111111111111111
111a1011011110111101101111011111110110111110011101101111110111110111110111101010111a111111111111100010a112221121112022011212012121212121111101a01010011111011011
111a1111001111111110110110001011110111101111110101111001101110111111111110110110111a110011111111111111a101120112100011212222112221112221111111a11111111101101110
011a1111111111110111111111110111011101111111011111101101111111111111111111011111111a111111111111101011a111011102111101020112110111120111111111a11110001111101101
010a1111011100111011111111111101111100011111111111111111111101111011101101110110101a111100111101111101a102222122121221011000012122111121101111a11011111111101111
100a1101011110011111110010111011110111111111111111000111001110111111111011011111111a111111111111111111a101211212220212201000121221211221111011a11011111100011111
111a0111111101111101010111111001111010111011111011101110110111110111011111110011111a111101101111111011a102011111201121201111212210221201101111a11001011011111111
111a1110111111011111110111011110111001011111011111010110111111111110111101011111111a011101111111101111a122222121122220012021002210221021111111a11100111011111111
011a1111011001100111111111010111111111111100111111111111111110101111111111111111101a111010011101011001a111111221010122220121122212110210110011a11111110101011111
111a1110111011111111011101010100101111111111111111111011101110011110101111111110111a110111111011111111a122021212211202112010202012212221111101a01110111110111011
111a1111111110110111110001111101101110101111111111111101111111111101111011110111101a101011111110111111a120102010210221220202011122112210111111a11010PPPPPP111101
111a1111101111101111110111111111011111111010111011110100101111011111111111111110011a111111011110011010a112102121112212111012110001122120010101aPPPPP110011101001
101a0111110111010100001111111111111011010111111111110111100111011111111101101111111a101111111011111011a100210111211101212210001122121221111011P11111111011111011
101a1111111111101111111010111101111111010111111111011111111111111011011111110111011a111111111011011111a111121111002020121021110002221120011110P00111111111111011
111a1111010010111110110111111011111111110001000111101111011111010100111011111110111a111111111111110111a112101121111212112211102220211111111010P11101111111111011
011a0111011010111111001111111111111110111111100010101011111111111101110111110111111a011111111111111111a122212222211221211110112210021111111100P11101110111101110
111a1110011210212121122022002212111211122000110111010111111111111111101111011111111a111101111111111111a111200212222212122111111122121011001001P10111111110111011
111aaaaaaaaaabaaaaaabbabaaabbaabaabbaaababaaaaaaaaaaaaaaaaaaaaaaaaaaaaaaaaaaaaaaaaaa111111011111101100a110011222022211021112210101122110111110P11011011111111111
110110011011220222211011211120110012121122101110111011111111101110111110110111101110011111001111111111a022001222122210012010110212111120011111P01110110001110111
110111111012110012010021222122200221121210110100111011110011111111101101011111111110111111111111111111a010112121012212211122220212221021011111P01101110101111111
101011101110110201120021102022220111211201110011111100011010011111111110100011111110111101110111101101a022012201121210200101221221222111101111P11111111110011101
111111111111100211222202020222022122120201111101111111110111111011001110101111011111111101100111011101a011111010211022210221202120202010111010P11110100111110011
101111111112202121111220001221220201101100111111111111111100001111111010111111101010101011111101111011a111021121112112022002011221211210111111P11110100111111010
111111011101110002122211201222122121201021011111111111111111110111111110111111111110010111111011111111a021201121211111012111201212112110111111P11111111101110111
011110101102202120120101120000120101221111111011011111111111101111111111111111111111111111111111111111a011121021100011110110221222111120011011P10011111111111110
221111222102202221210022212121212210201222100111100111111011111110101111110101110111111111011011101001a112010220111212100122121220022211110111P11111111111111101
111100111112220220122212121222012211022001111110111110011111111011101011110101011101111101111010110111a122120022010112120110212200021021011111P11111111111111010
022221211102210222202221122211222201222022110111111110011011111111111101111100110111111111111011110111a111222221101202112110111112221111101011P01111110111111111
002212120110220110212212202102112211112002111110011111111100110110101101000111110111101101111111111111a110101110221222011121202102122121011111P11111111111111111
201111201222220202202201201020021121202221111111101011101101100101111111111101111111110111111111010011a121211210101112020120101202111201111111P01111011010111110
201220120121101112212222212022212211221220011010111111100110111111111101111010111110110110111011111111a022222212122111011202222012220221110110P11111111101111111
210221102222100212222120222222010222011221011111111011110111111111111111110110111110111111111011011101a101100112212222200110020122010012221110P11010010111111111
222220210112011220222112100122201111201111111001111111111011111111110101011011111111101111111111110101a011110120120221102212220222212022121001P11111011100011011
011110222011121212212212222202212211122211111111110111110111101111011111111011101111011111110111111001a111122021121021101121112020222012021111P11111101011111111
220121121200220012022222120220102221220112111101000111010011111110111111111111101111110001011100111111a111122111101112201122022112122210210110P10111001111111011
121201211222211022200002122220212222222112111111111111111111111001101101011100101011111111111011011110a111021112111110111102212222112201201110P11101111111101111
221212111102102202222202221221111201211110110111011100111101011011111011101011101111110111111111111111a111112111222110112102121021201102211011P11110010101011111
212102202010222222220022122111222221221200101111111111111111101101001100110111111111111110111111111111a111120122211220012202211211112102021111P11011111111010111
201210011211202211220211122211212202110212011111100111101001111111101011101111111111011111111111110111a100121122222212121101220121120211021111P11111111111110111
111201122022220222212101122022010222202212110111101110001101111111101111111111101111111111101111010111a101120212122022110121220222100120121111P11111101101101011
112221011220211222022222212212222110021111111011111010101011101111111111111111001101110110101111111111a110112221222212110022122221112210101011P11110011111101111
211201021222122221222101112222212002112201111111010011111111011110111111111100111111111111111111011001a001112112101202212111121112222012221111P01111110111010011
102111022111221222022022022022220211012112110111111111110111111111011100110111111101101101011010111110a111112212211022200202220101222222111101P11111111111101111
222221022202122212102221222200202111012121111111111110111101101111110111111011111101111111111101011111a010111111112102200210121211201121121111P11111111111111111
222120112212122022002222020201121210202110011101111111111011111111111111111111110111011110101111101111a011001012121011111200120102110001211111P11110100111111001
222020221100222222122221222021211212221121111111010111111001111101111111111101111100111111100101101111a111002011211001211120012121111012100110P11101111111101011
212122221102022220012222222012212212121111111111100011110111110011011101111111110110110100110111101001a110122110221221120021101121111012021011P11111110011101110
211120101022021001111220110010211110111100110010110111010111111101101111110111111011111011111101111111a111102202221020122001112211012111211111P01111011111101110
212120201002111101121112221221200111110111111101111010111010111111111111111110111110110111111110111101a111022221212112212222221002011211221011P11101111110111011
201221122222000212111111012110101010100101111111112101201122210212201020021201121101010111001101011100a111122021222120102221021021111010021101P11111111111111101
110100212022122120101121212112011111011011111101002212100121200001112010112112120111111011111011101111a111111022000211121211101012111121121011P11010011101111111
202111111202100122222212212210211110111111011111110211121222112121122012211112121111100100110101101101a111020220222211220221221222002112201011P10011111111111111
221212111102121011121120112212211001111111111111111122022122122011100111121122201111111111111111100111a011102210212111011011111220202011121111P11111110110110110
012122121212101112220211012112011111111111111110002112122202211222110221121112201111101111101111111101a110122102220021212211101222101221201111P11111011011111111
212110212021221010201101202210011111011111010111020222012212101212222101221101021101101110111111101110a011121202222112211200101220012221221011P11000101111111111
101111222201222122121222222221111110111111111010021122221212101220022210201001201111111111111011011111a011021012112222112112212121222122011111P10111111101111111
111111111111111111110111101110101111111010111011121121021212222220020100011200121011110111111100111111a111110211211112111222011002211122200101P11101101111111111
111101111110101111111011101110110101111011010111020122022210201222011010122102211111101111110111111111aaaaabbbaaababbababaabbabbbabbbabbaaaaaaP01111111111111010
1110111111111111101011101011011110011111011011110121120112121120111201111022122211111111111111111001111111110112201120221122221222011012110111P00011111111101011
0011001111111111101011111111111011111101111111111022111111121221221022111020212011001111101111101111111110122101120202100022220012212011021111P11101100111111111
1111011101111101100111001111101111011101110111011101002212110211021012112111101111111111111011101111111000012221212020110102120101200022011101P11011111111101101
1111111101101111011111101100110111011111111011001022010212011211122011212020120210011111100111111111001101011011102122121212110121111202100111P01101110111111111
1111111011111110111011101101101110111000101111111001122000011202211021122221122011111111111111111110101011111111111101111101111111110011111011P11111111011111111
0111001111111101011101111101111001101110111111011022122211111012122121112220020211011111111111110111111111111111101101110101111111111111111010P01111111110111111
1011110111111001110011110100111111111001001111111101222122111121212112212211212010001110100011011101111111111101111111101111111000011101101011P11111110011010111
aaaaaaaaaaaaaaaaaaaaaaaaaaaaaaaaaaaaaaaaaaaaaaaaabbbbabaababbbababaaabbaaaaabaaaaaaaaaaaaaaaaaaaaaaaaaaaaaaaaaaaaaaaaaaaaaaaaaaaaaaaaaaaaaaaPPaaaaaaaaaaaaaaaaaa
1111110111111101111111011111111111111011111101111111021021201121212121202212100201011111111111010101101111011111111111111111011010001101101P11011110110101011111
1111111110111101000111110011111111101111111011111212211122112121222121211102202210111101101111101111101011001111001111101111111111111011111P10111111111111110111
1011110111001011011011110111111111111001111101111212212122222122112121211022012200111111110101111011111101111110110111111011110111111111111P11111110110001111111
1011111111111100011111111101111111111011111111111212112220210211011120101010120011111100111011010101111111111111111101111010111011110111111P11111111011110110110
1100111101101011011011111111111011101111111011110101111122122020022021112110112201111101111111111111111110100111010111111011011111111110111P11111011111110111011
1111011111011111011111001111111011111111101111111102012120111212021111112002122211110111001111111111111101111111111111111011011111101110111P11111110011111111101
1111111011111011111111110111011111011111011011111222200021202112010112222212210110111110110101111011111111101001111111101011011111111110111P11101111111111111111
1011011010111101111111111101111111111101110111111112221212122122111201011001022111010111111110111110101111101101111111011111111111111111111P11111111111110011111
1101101110111111011111101111111101011111111011111110002111202112111201211211212111110111101011111111111011110011111111001111111010111110110P00111110111010111011
1111100111011111111101111010111100111001111111111122201222211222110120122121212111111110110111111111111111111111010101101110110111111101011P10101111100101111111
1110011111111111111111111111101111111011111100101211012122202212120012210011111011111111111011111111101111111111111011101111111011101111010P01010101111011010100
1111111111111001101111010111111101111111111111111112101211201112112102220102112111111101101100111111110111111010110111101011011001010110111P11111010011011111111
011101101111011111111110111011111110101111101011121212121122222211221212222111221101111110111111111101111111111111111111000001011011111111P011110101111111111110
111111110110101111101001111011111111111111111101121000112022222200120222111121211110111111101110100111111111111111101111101101110111110110P100111101111111111110
00111111110011101011111010111110111111110100101110001111100011111110111111011111011111011111011111111110111111111111011101011111111011110P0111111110110111001101
11111111111111111111111110111111011111110110111101111111101111101101011111111111111110101101110111110001111011001011101111111111110110011P1011111111001001111111
11111111011111111110101111111111011101110110111111011110111111111101111111110111010111111111111101110101011111111111111111111101111111010P1111011011111111110111
10011111011101101111111011111011100011111110011110111111111110110111111111110111101111111000111111111111111110111022112001011012122021102P2212111111101111111101
11101101111101110101111011101011111010101111111111011111101011111111101111110111110111111010111111101111111111122112021222212112002022112P1111111111110111111111
1011101011111101111110010111111111111101111011100111111110111011111111110011110111110111110111111111011110110111211210220112122111110210P22021111111111111101001
101110111111110111111110111101111101111111111111011111101011111101111011111111111111111111111011112021101212220222020212222222000001210P221221101111111110101101
1111111111110011111111101101101011111100121121111000102122212212221221121111111101110110111111111221002021221121102121022202021202111122P12121111011111111111111
aaaaaaaaaaaaaaaaaaaaaaaaaaaaaaaaaaaaaaaaababaaabababaaabbbabababaabbbbbbaaaaaaaaaaaaaaaaaaaaaaaabbabbbabbaabbbabbbaabbbbbabbaabbbbbaababPababaaaaaaaaaaaaaaaaaaa
1111111101111111111011111111111111101000112122012222110011021212111021121111110111001101111111112201222221221202120122122222212121212122P12012111010111111111111
1110101110111101111101111110011111011101011012202122102121120002222211020111111111111111111110111222100220102100202222202222222221222220P22112100001101100111101
1111010111001111111101101111111101111111121110211001222112222222021112021110001101111111110101111021221111212111011222212222122011121212P22212101111111111111111
111111011011110110111110110111111111001012022021222211010111101101102112110011101111011101111111021022222111222020122221212220200011212P011222110001100011011111
11100011111111111011111111101000111110111200202102211200221021222202222210101011111110011110101110211212122001001201212100122212212222P2101210110110011111111111
11111101011010101111111110101111111111100012222101112112211021121122211211110101101101101101001120121011011222122200212012022220120210P0222100111111111111011111
111111110111111111111001111101111110101112112021220021012002111112101121110011111110110001100011002200111220112221101121220101222210120P000222011101111111111011
111101111010111111101111111111111111110100020200121111221211101022011022111011111100011110110011102211122101201122222022202220212111222P101211101111110110011110
0111101101111110000011111111101111110111110121111122220201221122022112100100111111111111111111112121212220212100221102121211112122221122P20112111111111111101100
111111111111111111111010111111101101111111121222111022022021102102212221111101011111111111111111220111212200221222222220220202122220112P022022110111111111111111
111011111111100101110111111101111011111111121200222112201122021121220111111110110111101101101110221221200121022222222222122012212020200P222120111111010111111111
10111111111110111111100111111111011011011020012112111101210101121122011211101111111011111110100002110120121222122022221202222012221000P0012121111111111111111011
11111111111111111111011100111111101111111211112211210211211221200121122111110111111110111111111122221202011111112202222222202022101110P0200112111011110111101101
1111111111110111111101110101111111111001100122021210111111211120022112011101111111111111111111100210121002011211122221210121221221220P22111220101111111000111111
111111011111111101110001101011101111111112012222022212012111202110122210111100111111111010111111120112102121121112011022221222221010P111222111100111111101001111
11111111011101111101111111111111010111010110112222022110211121221110222011011101111111111111011122102210011001122221122220200212022P1002022220011111111111110111
11010111010101101011111111111110100111101102012021020221122211221011001110111110111011100011111112210000120212121220022220122122120P0211120220110011110001101010
0111110001110111111111011111001010111011112222111111011202212012120222211111111111101111100011112202122020212011212200211022222111P10211020201110111111101110111
1111111111111111110111111111111011010011112101001120102222122221112211221110111111111011011111112122012021200012222022121211222110011201120202111111111111111110
0100111111111101111111110111001111110111122121222211212011202210221222010111111111111100010110112021111221021202221121222122022202220122022212111111111111110011
1111111111101110011011101011011111111110121110212222122211111221122221211111110111011111110101110210012211212012201122222102211111100220221012110111111111111111
1111111011110111010101111111011110111111011212111011222122122121202121211111111111101001111111111020212211112020220100121120121111212120212201011000100110111111
1111111111111101111110111110101111111111121220121012001111102121212012221011011111110100111110111121111111220102222010202222122102012202221210111100011111111111
1011110111111111011011111111111101111111120111102211101121121000221122011010101111101101111011110112201121101102020222212202221011111122110012111111011110111111
1011111111011111111101111011111101111111111112122111122220222221211112221101111111111101111111111212122021120022212222212022212010001122122111111111011111011110
1110100111011111110111000101111111111111111100110221201122111022121120111101110111101011101011110111222112112211212201102201222011111111101111011111111111101110
1111111101111111111111111111111111111101002121122022111111221120121112001110111110111111010111112111211211102212210122221212202101001111111111111001111011111111
1111011111001111111111111101111111101110112111210122002101101212101121111111010111110111101111001121210222110102112102112022212110111110111110111111110011111111
