49 18
89 103
122 49
126 101
64 67
119 18
56 105
111 104
8 43
26 34

1111111000111110111111111011100111111101a011110110110101111011111011a1111111111111111101a011111010111111101111111101110011111111001a1110111101110111111111110111
0101111111001011111110011110110100111101a011111001111001110111111100a1111111110111101110a111111011111111011111111010110110101111010a1111111010111110111111111111
1111001111111111001111111111111110111011a101111111111101111111111110a1111110111111111101a011111111011111100111111111111111101011011a1011010111110111011011111101
1010111111101011110111111100110101111110a101111111110111111101110111a1111110111111111001a011011101011111110111100021220210212220122a1211110111111111111100101110
1111111111101110111111111111111111101111a111111111111111111111011111a1111111111111111111a101111111101101021121022112211101112000012b2210011111111111101111011111
1111101111101111101111110110111011111111a111101111111111011101111001a1111111111111101111a110111011101011211211202121120220122121202b1011111111111111101111011111
1111111111010111111110010001011011111111a111111111111011111111111111a1011011000111111111a111111111111111220222212112211201111121111a2211111111111100010011110111
1110111111111111011011111011011111111101a100101111111111101101111111a1101011111101111111a100111110111111212121112000110201121120121a1211111011110011111110111111
1101111011111111111111011111111111111101a111011011111111111111111111a0100111111111110101a111100111111111221121101201111212221221212b2110111011111111101011111110
1111111111111111111011111111111111100111a011011111111010011111101010a1101111111111001101a110110101111111220222210022011112101220210b1111111101101111111001111111
1110011111000111101100011011111111011110a111111111110011111111111111a0101101111111111111a111111111111010212220122021110122121211010b0011101111111111111111111111
1111101111110101111101101111111111110111a111111011111111001111110001a1111111001111100101a011101111111111222202111221212021211011111a1111101111110111111111101111
1101101101001011111111111101111111111111a110111000010111111111011011a1101111101110110001a111101101011110012201122021012112111111211b1201101010111011110111110001
1011110111010101011111111111111111111110a111110011111111010101111111a1110101111111111010a101111101111011122222220110122022211101012b1120111100111011011111111101
1111111111100111101011101110111110110110a111110111111011111110111101a1111011110111111111a100100111110011011112222102121110112122102a1211111111111100111110101111
1011101011111111111011111011111010110011a011100101111111110111110111a1111110101111111111a011101011011110202101002222212221122112201a2201111011011111111111101111
0111111101110001111111111111101111010101a111011101110110110111111111a1101111111111001111a101101011111111122021112222110022221012111b2221111111110111111110111101
1111111011011101111011111111111111110111a111111111101111110101111110a1101110101011111111a111111110110100201212122211110020111121212a2111110110111010111010110111
1111111111111011110111100111110111111011a011111111101101111011100011a1111111001111101111a111111101111000111120110111022011211222211a1221111111101111111111111111
1111111101101020112212201012222211222022b011111101111011101111111110a1111111110111111101a110111111011101221012022212221212101221211a0011101011110011111010111111
1111110101122222220202221210210121122101a211111110111100101101100111a0111011111111011111a111110110111111110001210011112101011201001a1220101011111110010110011110
1110110111121111210112122002111121102122a110111111111110111010111111a1111111111110111001a111111110101111210201122221212211111212221a1001011111110111111101101111
1101111111112122012101212222111021122221a111110111011111111011111001a1111110011011111111a011111111110111121202001201122120111101222a2020111111001111001011101111
0111111111101021122112120110011010200122b011111111111111111111001011a1111110111111110100a111101111111011210112212211012222102211221b1200111111111011111111111111
0011111101112111222012212212212110212222a201011100111110101011111111a1111111111001111101a001111101111011122012011022012111212111201a0221001111111011111111111111
1111111011101121112211211211200220220210b011011110111111111111101101a1110111100111100010a101111111111111120111001122202121212121202b2121111011111101111111100110
1111110110111122011112222111201100222212b101111111110111111111110011a1000111111011111101a001110111101111121022111202121020112111212b2211101111001111011100111101
1111111111102211212112001121011212210110a111100110111011110111111111a0011101111010111111a111111111111111110112112020220111011120221a2011101111111101111111110011
2211022121020012111222220221022121110211a111010111111111111111101011a0011111011111110111a101110011111110012011010212202122111120210b1221101101100011111001111111
0122221221122201222011222212012212201222b011101110111101110111111111a1111110011111111110a101010110101111202222222022010122120110211b2211111101111101111111001111
0200011221012222102022012202221212120211b111111110110111111110011011a1111111110111101111a111010111111101012210011122112220011212221a0221011111010111111101101101
1212211102110222200202120022210222111201a211111011111110111110110111a0111111111001111111a011110011111111200010122201201102121022121b2211111111111111101100011101
2012201212222010221120221212222111120012a101111011111111111111101111a1111111111101111011a010111101011111010112122112211101121121022b1201110111111001100011111111
1210010222201222222222222112121211012222a111111110111111111111011111a1111111111111111111a011100110010001112121022211112020211121222b2121100011111111111101011111
1102112212120221112202201002222012222121b111101101111111111110111101a1110111011111111111a110101111111101110001010221112220212222121b0212220111101111111111101010
0011001102120221222220112221022221210121a211001111111111111111101101a1111111111111011111a111110111111100111121121111202212212221101b1221010001111111111111111011
2212201112222222222222022210120221112212a211111110111111101111111111a1110111110011111101a111110111110111111200002101121211110221211a0121221111110111010111111101
0221101221020022122021020102210101221222b210111111111111111111110111a1111101011011011111a111111100110111011222010002021201122122122a1100010010101111101111111111
2112221201020020200202211110121122202202b111111111110111101111111101a1001111100111111111a110111111111111111221210111212212221122110b2122201010111101101110011011
0110121120202122222212202222112221222200b111110101111101110111111010a1101111111100111101a101110111111011111022122122120221221221112b2102001111111110110111111111
1202111210220022221212222220022202122211b211101111111110100111111111a1010011111111101111a10aaaaaaaaaaaaaaaaaaabbbbbbaaaaaaaabaaaabbb0201211011110111111110010111
0011000122122111110102122201202112222011a110111111000111101111110110a1110111111010101111a11a01111101101110111202212101122222021121112121011111111111111111001111
0122111222222222222221222101212222120011a111111110111111101010101111a0011111111101110010a10a11111110000111112212002212110211021211011212101111111101111101110111
2200221102102012022222221122222111120002a211111001111111111111111111a1110011101111111111a11a11111111111111120212022112101110200002121010201100011111010110111110
1112202222112212022221110022011111121110b111011001111111111110001111a1110110111011111111a01a11101111111110102010201120011021120210112122221111001101101110111111
1102111201121220011222201222222002121221a111111101111111101011111111a0111111111111111111a11a11111111111011102011201122121122121112211212221101011101111111011111
1110101101122221210022010120211112112221b210111011101111111111111111a1111111001111111101a00a11111101111011121121001210211022211122212121101111111111011110111110
0212212211122221222222221222202002210020b111110111111101101111001111a1100110111011111111a11a11110110111111101122121012211112111112221111121100101111110110110111
2002101020222210202221212020222012121100a101111110111111111111011111a1100101011111110111a01a11111111111011121221111110021101210121102100211111001111011110101111
2011222212112102201222202220122111211110a011110011111111100110111111a1111100100111111111a11a11011111111110111110221222220122212212012110211111001110011110111111
1112212111012122000121212102221111011111a111011111111111111111010110a1111110110110101111a10a11100101101111102212201222102112112222112200221011111011111101001011
1122121101110111121222011112211110110111a011111111111111011111101011a1111111101111111111a11a11111100111001111212022122122111021221121112201110110111101001110111
2102221122122121120021112211111001111111a111111110222011022222210122a1121122101001011111a11a11010001111111101121222122212110111221222221121111111111111111111011
1201221112122102120120002222121111111100a111111112122221112121222211b2111112010011111111a01a11011111101111021122122210101110101122012210211001110111010111111111
1112221112121022001112102212222111101110a110110111121122011210221022b2220121110111111111a11a01001111101110102122121222112021212120121122211101111111111011110111
2010201121211201202121121100212111111110a111111111100011211121112222b2121201110110110111a01a11111111111111102122221220221022222202112111000101111110111011110111
1222222221101202210222012110121111111111a011111112211211211111212110a2210201021211011111a01a11101001011111101210021021212111022121111111021010101011111011111111
1202212211211222211202221110112111101111a011011112210210112122212201b2120101122201111111a11a11011011011001012222012212102020122221120222211011111001011011111111
2212122212222220001112122110111111011001a111110011122011110110010020b2211222111211001111a10a11010111110111122211210212101001211201022220021101111100011110101111
1111110011111111110101101101111100111111a111111012112120120212102211a1122211022101111111a11a11111111111111abbabbbababbabbbbaabbbabbbbbbbabaaaaaaaaaaaaaaaaaaaaaa
1111110111011111111111011011111111011111a101111012210221210201120020abbbbbbbbbbaaaaaaaaaa10a11111111110011a12122112212112111221102220210211111111011110110111111
1111111101011110111101101100111111111111a11101111021122220220201212011012212012210111111110a11110110100111a11112121122211120210012202212011001110111101111111111
1111101001101110111111011111111111111111a11111111121101121212211212220022202202110010011011a11110111111111a11122110021122212021101020010101111110101111101011111
1001110111111111111101111011111001111110a11111111121012202210212222202211122211010011111111a10111111111111a12021010211112121010112121101201111111111111111101111
1011110111011011011011111011111001110111a01011111121102202202202111220111101120111111110110a11111111111110a11112200110120111010112111102211111110111110110111111
0110111101111101101110110111010111111111a01011111010102021121222020021112212201211111110111a00111101110111a00101111110111111111101110110011110111111111110111011
aaaaaaaaaaaaaaaaaaaaa1101111111111111111a01101111122210212212012121112211121210011011101001a11101111111110a11111111010011111110011101111101011101111011111110101
11011111111011111111a1111111111101100011a01101111100022100101011112010210212112011100111011a11011111111011a00101111101101011011101111111111111110011111111101111
01101111100101101011a1011011111011110111a11101110022111100121112201220200122202211111100110a11011111010111a11111110110111010111011110110001111111111111011110111
11111000101111110011a1011011111110101110a11100101121112011110202222022112122212111110111101a10111101011111a11111101100111101010011001111111101111111011111111111
10111111011111110010a1111101110010101011a11111110202111211112202102201211101211111011011111a11111111111101a01001111111011111101101111111011111011101101111110111
11111011111100111101a0011011111111110010a10011011212112222111211120221022122112001111111111a11011101010111a11111111111111110111111101101101111101111111101101011
00110111101111011001a1100011101011111111a01101001112020121012222111012120122211111111111111a11011111010111a01101010111111111111111011110111110110101111101101011
11000001111111101111a1111111111101111111a11101111121222102121021220002212212101011111111101a01110111111011a11101111111010111101111111101111101110110010110111011
01111110111111110111a1111111101111111111a11110100201021110211212211210112021021111011111110a11111101101111a01101101111010111010111110011111111111111111111011111
11111101111110111110a0100111111010010100a01111111112111202010201202211121102211211111111110a11011111011111a01111111111011111111100111111111011111011111101111011
11111111111111101111a1111110010111111111a11111111222221112202201102112202202222011110011111a00011011110111a11111101111111111111010100011011111111111111111110111
11010101001111011111a1111101100111111101a11010111120020101222120212021112111122211111111110a10111111001011a01011110101101011011111111111110111111101111111100111
01011111111011111101a0111101111111111111a11110111201000222011212120122211211221111101110111a11111010101101a11111110111110000111110111101001111110110111111111110
01111101111111111011a0111111110111111101a11110100201112102020000102222221021112211111111111a11111101101111a11001111111111101101111011111101111000111011111110111
11110111111110111010a1111111101111111111a11111111200122222121222011012221222011110111100111a11111111111101a11100111111110100101101101111111010011010111011001110
11111110111110110100a1111111110011111111a01111111020120212222202020022211212212211111111111a11110001111011a11010101011011100011111101111111011011101111011111110
01101001110011111011a1111111101111111111a11011011221122212211122110022100122121200101001011a00111111011011a11110101111100111111010110111111010111111101111011111
11111111111100111011a1000011011111111111a11111111010011111100010011101011111101100101101111a11011111111111a11111101111011100110111111111011110111111111101111111
11111111111011111111a0111110001111111111a11110011100111111111111111111110111101101111010010a11101101110111a11110011110110111111111111011111111111101110111001011
11111011110111111110a1111110111010011111a01100110111011011111111111111111111111110111011101a10111010111110a11111101011011101101111101110111110111100111111110111
00011011111100111111a1010111010111010011a10111110011111011111101010111111111111111111111111a11011101110100a01111221200122220121212020001102000111011011110101101
11111101100101010110a0111111111101010111a11111111111011111011011111101110001111100101111011a10111101110111a11111212122101111220221012122112112111111111111010111
11111100111101111110a1111101110011111111a11110101111111111111011101110111111111110110110111a01111010111111a01011221222022221122012111210220221110111101111111000
11111111111111111011a1111111011111100011a11011111101100111001101111100111011100101110101111a11010011101211a22222212222200202212022120201010110110111011101111101
01001111011111111110a1111111111111110111a12120011102122120212222110012101101111111011111100a11000012112021a21012222001221201212021110101111221100101011111111101
11111110111111111111a0001111111110111111a11121111121121121211221012212121111011011001110101a11112121002020a22022222121112120220221211210110221101111111011100001
11111101101111111011a1011111111111011110a21211221201200212121210221102100111111111111101110a11012212202212a11222011211202221100220221222221220111111101011011111
10110111001011100100a0111111110111011111a00112212020102202112221112122010111111101111111010a11011122210112b01120102222212222020210212112222012111111101110111011
10110111111111111111a1011001111111111111a10022112221122121222100012220121110100111011110011a11111210000112a21222112222020202212121101110011212111111100011110101
01111011111011111110a1111110111111101111a10101212112212201222112212012200001111001111111011a11110012011201a02022222002002202222220110222211111011101000111111111
10111001101110011110a1111011111100111110a11112222222201010020220120012201100110110110111111a11111112111120a10011222221220222022022112121202002011011011111011111
11011110111111101101a0111101101111110111a12111121101112100021200221222001110101011111111101a10111001102210a12122222222212222120121010102112011101101111111111101
01111111111111111111a1111101111011111111a22222122000022202010101222202221111101001111101111a11112220011221a00221200220112220222121221211201210010111101001111111
11101111111111111100a0101111010111111011a12011221012112121021222102212011110111111111110011a11111021121102babaabbbbbbbbbbbbbbab122100022100100011101111011011011
01111011101110111101a1111101111111111010a1222220201bbabaabaaababbbbabbbaaaaaaaaaaaaaaaaaaaaa1111212010220102112221202202022220b101122122201211111011101110110011
10011111111011111111a1110111111111111011a2222102212b10201011112111221010001111010111111101111101112101021001122222002220222022b022122012101220101111011111000111
11111011111110111111a1110111001111100011a1211112122b01212121101211220210111101111111111111111111211022112201012210201122222222b012112202112222111111111111111011
10111011001110111111a1111111111111001110a1001222211b20221121010201222221111111011111110111111111122221212112112202120122220222b221001011112222100011111111001101
11010111111011111111a0100111111101111111a2110112201b02000211221212212111111111101111111101101111210211111122002102220210222220a121021222211111100111111111110111
11111111111111110111a0111111100110111111a2002021002b22121120100011122000110110111101110111001110221122221021201212112200222122b212111120211012111111110011100011
11101110111001111101aaaaaaaaaaaaaaaaaaaaa1112001001a22111220202220101222111111111111111111111101211010021010222202212222220120b122010010121012001110111111110111
011111111011111110111111111111110011011112222011222a12012222221112022121111011101111111101111111221010000212210202021002220021a112111112122021111101111101011111
100101111100110111111111111111110110100102100022110a20200212120121021112111101011010110110100011020201212202120002222122212022b210222021122102111100001111111111
110111010110111101111111111111111111111012211021102b20222011222011222111110110111110111111111111201111022211211022222220000200b210111110000122111111101111011111
111110111110111111110011111101111111010111020000120a12012111210122212112111111111111100011111111121211220220022221002222222012b120110121100120010111111111110111
011100111011111101111111111111111111111110001210122b01220212102222101110111101110111111111110111222111021012020220122222220212a112111120212111111111111111111111
110000101010111011110111001110111111111111102202022b01222222122021222211110111101111111011111111200111021112222121202220102212b221222221112121111111111111001111
110101111111010101101111111111111111111111012111112a12211210011111122211111101111001111011110111111110221100101002212022222021b122212211211121111111111111111111
100111110111111111110111111111111111101112202011212b21212211222222202211111111110110101010101111120110200120212022101122202202b201201221222120111111111111101111
101111111111011111111111110111111111111112120221021a21221201121201110111110111101111101111110111101211222122122210222022222222b112121110201112011001111111111111
010101111111001110111011111111111100111112211100021b00220122221211221120111111111011011011110110111211012012110222221022222222b100102220201201101111110010111111
111111111111111111111101111110111011111111002120011a11121212201211221022111111011111011111110111001212120122102121100212212120b100111110111011111111111101110100
111111111111111110111101010111111111101111112110122b11211111222101222211111111111101111111111101012020101211210200112212021212b111111111011110111110010111111111
011111100000111011111111101101100111101011011221212b02102012212220212000010011111111111111111101211102102222112221221210201102a011111111110111011111111111101111
