5 70
150 79
122 49
126 101
64 67
119 18
56 105
111 104
8 43
26 34

0011101101111111110111101111111101101011111111010110010011111111110111111100110001011111101110111111100111111010111111110011111111111011001111111111110110111110
0011111010110111111111010001101111111011111111111111101111111111111101111111010111110011101111111111111110111110110111110111110101111011011001111111101101110111
1111111111110111011111001101011011111110111101110111110011110111101111111111011111010111111111111110111111111111101001111010111011011111101111110110111111101011
0111011101110011001111011011111010010111011111111101101101101101111110111101101111111111111111001011001122202212202100220021002012111221101110111011111110111111
1100110111100011001111111101110111111110111111111111111101111110111101111010101111011111101110111110101112121012211022211121202122212111011101011110011111110101
1111111111111100110101011011111010111111110001101111111111100111011111110111100111111111111110111111111121012120120212121002212222102111110111111101111111110011
1111111111101101110111111111110011110111111111011110101111111111111111101111111110101110111110110111111100211222220121120002120222121110111111111111110111111011
11101101111111000101111110111111011111011111111000110111111aaaaaaaaaaaaaaaaaaaaaaaaaaaaaaaaaaaaaaaaaaaaabbaaabaaaabbaaabababbbabbabbabaaaaaaaaaaaaaaaaaaaaaaaaaa
11111111111101111111111111011101111011110111100111011110111a1010011110110111111110101111111111000111001122121021211011011221020111212210111111101111010111111110
11111011001111111111111111111111111110111111101110111110111a0101110011111111101111010101101101101011111101102212110202201121102212222111111111110111011111111111
10101111110111101111101110111111110111101011101111111100110a1111111011101111111100111111111111100101010112012211122020222022121112220011011001111011111111111111
11001101111110101111111111111001111101110111111011111101110a1111101100111111110111110101111110101111111011211002222201021022022221122211000111011111011101011011
11111101111111111111111110100110000111111110001111111111111a0111011011111101110111111110110101011100011120211222211111222101111211100011111111011111111011110111
11011111010111011111111111111111011011110110111100011011111a1111101111111111110001111111111111001111001121210222111222112221102222202121111110111011110001110101
11101111111011111111111111111111111100101111101110101110110a1101011111011101110101011011111110111111110011220011101110222021101110001221111111101111111110111100
11011101111111101101111111111111110110111111011110111111111a1111111111101111111011111110111111110110111122021112112110210011200222102211101011011111111111111111
11111110001000011001110111011110110110110110111111111111111a0110111111111111111111101011111111111111001102022201022122112210212021121121011011111100011111110111
10110100111111111111011111100011111111111111111110111001011a1001111111110111110110011011111001111111111122221102202201011120100002222221011111011011101111110111
10011111111111110011011111101110111101111010111001111110110a0011011111011111110011111001111111111110111100002102211220122010112221211121111111100111011011110111
00111111111122121222101011121112111220102111110111111111111a0011100111111101100011001111111101111111101111221222220122222201221222122020111110111111111110111111
11111110111121212122112012112222120112011111011110111011011a1111111111111101110111110111111111111011111112100002021212211022100211101001111111111111111111111111
11111101111022122220221201102022211222221011111111110101111a1111101110110011110101111001011011111110111102210102211002112201010011121021111111011100111111011111
11011111111022120122222111220220100212111201010011111111111a1111111011010101011111111011110110111110111111222110122000102102211121211110001001011111111001011111
11110111111201211101211122112101220101210201111111111111111a0111111110111111111011011111111111111101111122202221111211102102102111000221111100111011111111101111
00111111111202111122112212212011112012212211001111110101111a1110110111110010111111101111111111111111010121110222111222112002212112221210111111111011111110111011
11111111101221100021211111012211101120210101111111111110010a1111110000111111001111000111101001111001111111220111111011111200101122221121111111111011110101111111
10101111011111221202222210121222111221022011110100111111111a1111101111110111111111110110111111101101111020120212211112011022220211122011111110101111100111010110
aaaaaaaaaaabaaabbbaabaababbbababaaabbbaaaaaaaaaaaaaaaaaaaaaa1011111111111011111111011100110111111011110110212210122200010112021122011011011111110001111101110111
1112111202210212022222202222220222110220210111101111011011011111111111111011011111111110111111111111111122011211111110002100211110110101110001110001111111111111
1012221202201020220122122200021212121220121110100111111111110111111111111010111111111111110111111100111111221221122211111101101111010221111011111111100111111111
1110101211022202222122222202011211221101111010101111011111110110111111111110111110010110111111111011011102121002210222202122201021111211111111111111010111011111
0112121211202002121102222120002120202011101111101011111111111111001111110011111111111011110110110110110021121110112101110121211112102110111111101100110111111110
1122010200022020020212122121122211021102211111111111010101011011111111101111111011111111100001110111111101101221211010212212122001012101111110111111101111101111
2201201200122221201000011212202122201120101111111111101110101110011111110101111101111101111011111011011100202200002221211110001221212220110011011110111111111110
1111120121121002221222222222002221121112011011111111111111111111110111011111111111111111111010110111111111122002122020221122021202112112210111110011111111111111
1121111210000102222110220222202211220201121111111110110111111111101101110111110111110111110011111111111111111211020010222111012221000112211110111011110111111111
2111201221211201210220212222020021222021110111111111011011011001111111011111101111110110110111111111111111001121012112022222010102202122211011111011111110111110
0120211110220222220222221101022122100220011111111111101111101110110101111111111101111111101111100011111110102001211212112212101101210112221111111001111111111111
1111212111122022222202110220102020212222221110101101111111111101111011101101010111111111110001111111101110102021210222111221111022211211201111110110011111110111
1002202121210202222221022022102021020122001110111011001101111010011101111101101011011111111110110001101111012120120211122210100102202222111111110111110110110110
2220110221222202222121020120012021012022110111111001111011101110111111101011111111110111001101110001111011122201112121021020002212222111211111001111111101101001
2212222012222022202222112222221200121010201100111111111111001101101111100101111111111111001100111101111111121111010101122212212111211122120101001110110111101111
aaabaabbbabbbbabbbbbababbbbbabbbbaaaababbaaaaaaaaaaaaaaaaaaaa101011100011011111111101101111110111101111101110210120020102112201212122222101111100110101111011111
111101101110120020100102220222011211012111111111110111111011a101111111111111110111111111111111111111111101111212221211012111121222210101201110011110111010111011
112112011112222100212212102201111022200222111100111111001111a011011111111111111111111110111110111111111111111221101022200211012210211111211111111111111101110111
202111202102210202012022222002202121112112001101111110110111a111111001111101101011111110111110010110111011122111110021220112021211110112111111011110111111111011
221122122122222220212211111222220102202001111111111100110011a110001110001111111111110111101111111101010011122122210121201010021102112121211110101111001111111111
112122112120222220212020122210021111100111100111111011111111a001111000111111111101110111011111111101010101101021122211121022220201111221111111111110111111011111
021010122101122212202202211221212120122110111111111110110100a111111101111110101111110011111111011110111110112121002200122102101112212111221010111111111111111110
010112100210000202221121022222202121212120111111111111111111a111101111101101111111011110111111111011111110112012212200211212110221112201201010111110111111111111
111212222221011211221222102112111111110110011111111100101011a111110010111111101101111111011111111011111111010101211021111221212211022002211111111111111111111101
201122122012121012222012121102001101111110111111111111111111a100011111111110111111101111011110111011101111121222211210222220121221111110111110111001101111101111
212202111022010012111210121121101111110111111111111021111122b201011121220222021211111111001111110111110111111022210201211120012102122012001101110111111101111101
220222121011022201111202112212111111011011011111122121112212a211111012111121222211011101100101011111101111112121111112122220112121011211221111110011111101111111
212111122122221200112222111122111101011111011111120011111001b101112222011012221111011011111110111111111111102120110200121222202122111122021111110110111111110111
120121211200022212212011102201001111110111110111111212201211b202212101121222222111101110011101111100110111110221220101210022122211211120101111111111110011100111
022111101222112221011122111212211111111111011111122112222001b122211012112121011201101111111000111101110111122010220212221202121202211022111111110111011111011110
202201222220110122110212221122011111111111010111110020021210a101210011211011102211110111111111001111101110120001210220122221111112121102201111111101111011110111
202012101012220121220021221221111101111100110111121011202212b021212112200202112001111111111110011011111111120220212122100120211210211122101010011110111111110111
001110111101111110111011110111010110111011110111012111221112a011122020212121100001100111101001111111001111122222221111110122122122210212201111110111101111111010
111101111011011101111110100111111011111111111111110122010212b220211120211222021210001111110111111111110010112212122122111210112211222201211100011001010011011011
111100111110101001111101011111011111010111110111100121102011b120120222111112201210101101111111111111111111021101022112212110121012120222211111110111011100111010
111101011111100101111111111111101111101011111111112021201121abaaabbababaabaabbbaaaaaaaaaaaaaaaaaaaaaaaaaaaaabababbabbbbbbbabaababbabbabbabaaaaaaaaaaaaaaaaaaaaaa
1111111001011001101011111111101111100111110111111001102112220121112122112221102011111111110010110011111111112121100012212120201022122021221111111111001111111011
1110111111111111011111111111111111111111111111111022202201122112012121122220220001111111111100111011111010112101121221122120220021221211221111111010101011111111
0111110111111111011101001111111001101111111111100211220221222011022120121102121110111010111111111111111111111011111111101010110101111001111101111110111110111111
1101111110110011111110111111111111101011111100111021221102112120212121202200211211101111111111111111111010110110110111111111101111111111111010110001011111111111
1101101110111111111111011111011111010101111001111110012120221221122112022022102001111111111111111111101111111001111110101001111111111110011011110111111111101111
1101111110010111001011111111111111110111100111011221011111121221021012222212121111110111111011111111111111111111011111111111111111110111111101111111111111100001
1111111111111100110011111011111111111101111110111211212111212122111112212012222211101110101111110111110011111011111111101111111111111111111111111001101111111110
11101P1111111011101110111111100111011111011101110211221120111000120110022110211210111001111111110001111111101111111110111111110111111111111111111111011111111111
aaaaaaPPPPPPPPPPPPPPPPPPPPPPPPPPPPPPPPPPPPPPPPPPPPPPPPPPPPPPPPPPPPPPPPPPPPPPPPPPPPPPPPPPPPPPPPPPPPPPPPPPPPPPPPPPPPPPPPPPa110011111110111110111111111110111111110
111011101111110101110101111011111111011111111111121201221111111001011120111212211000010011110011011111001000110110011111P010011110111011111011111111111111111100
110111011111111100111101111111011001111101110011120022111212010012120211220122211111110101010111010110111101101110011110P110110110111110001101111100111101111111
111110110011111101110011110101111111001111110111102212211022222211211201011210221111010111011010110101010101110110111111P111110111111011101011110110110111111011
101101011110110001111111111111111111111111111111121201202111121212212112112021121100111111110111111111111011111101111111P101111110110111111111011101000111101111
111111111011110010110111101110111111111010111111111112201011221221212202201222211111101111101011100010111101111110111110P111101101111111111111100111111111111101
111011111111111101111000111011001001111111111110100111011122202000111210202220111110011110110111011110110111111111111111P111101101111111111011100010111111111110
101101111011111111011100111110011110001111111101120120102211112222122200220011001111111101011001101101111111111110110111P111110111111111010111111111111111110111
101011111101111111111111111111111111101111111111112221212211222221111211212122221111100100110001101111101111111111110010P11111011111101111111011110001P111100111
110111101111111111110010110011111111111111111111000100212220202112022021000001120111111011111011111111111111111111111111P1111111111110011111100111111P1111111111
111101111011111111111011011111111111111111111101101211212221210100000211022002221111111110110010101101111011111101111101P1111001111011111111111110110P1111111011
011011101011111111111111111011111101111111110111122211221012112112212101002102001001010111111111100101111011011011111100P1111010110110110111111111110P1101101101
111110111111111011111011111110111011011111010111101111101111101111111111101111111111011111111111101111101011111111101111P0111011111111101101111011010P1011001111
111111111111011110111111100111111011111010110010110101111110110100110001011111110111111111101111111111101111111110111111P010111111110111100111011101P01011110111
111111111110111111111001111100101110101110111110111111101100111111111111101111011111111011101111101101101010110111111011P111010000111111111010111111P10111101111
111111111111111011111011011111011111111111111100011111111011111111111100111101111111111111111101011011111111111011222222P222201112220220001111110111P01111000111
111110001011101111111111111110111111111111111111010111111111011101101111101010111101011111111111111011111111110122200221P212121022201212221111111110P11111111111
011111111110111101111111111101111011110101111111111111111110111010110101011111110011011111101111101111111011011202200120P11211102211212120022210101P111110111110
011111111101101100011111111110101110111011101110111011101111001110111110011011110011111111101111122121121121120001220220P22221211211212211212111110P111100011011
011111110011111111111011111111111011011111211122122211101211112211221212111101011011110101111111222212211011222201222222P0202200122201121122221111P0001011010111
111101111111111111110100111111111111111100220121122212111012022102102111111111111100101011110111001212110100222221222021aPPPPPPPPPPPPPPPPPPPPPPPPPaaaaaaaaaaaaaa
1111111101111111111111101111111101111111111022112121010101121111220012201111001001111011111011111121120202111012122222210022022202221102111111110110001110101011
aaaaaaaaaaaaaaaaaaaaaaaaaaaaaaaaaaaaaaaaababaaaaababbaaaaabab110111221221111111111011011111011111102102200221222211020210211221111111012022201011111011111111111
101011011011111111101111111111111001111111010100221220122121a110021111111101111010111110010111112112122121111222221122222212212120222002012211111111011111101110
111111111011111111010111111111111010111112222111121121222222b122122022111111111111111111110011112221111120101012120122011221222212011210211111111111001111011111
111111111111111011101011101101111111110111121111220121202101b002221012011001110111001110111001111111100112120112220122002010022202221210111112101101111100111101
011011111110111110111111101110011101101111121011201111122121a220001112121111110110001101010011102121101102121021122022201001222011100221111121111111111101010101
111111111111101111111111011111111101111112222101102211011101a222222121221111111011110111110111111021101111220000112222022222200221001110212012011110111110111111
011111111111011111111111111111101111000111222111211101021020b022111011111111101011101011111111011221111211221112202112221222222120201220221212111111011111111111
111111110001111111110111101111101111101012022111102221110111a101120221101010110111111111101010001010222221111022222212211222222101221121110221111111101111111111
111011111101110111011101111011101011111112212112211202121022b221212112020011011100110111111011112022111022112222212202222202210111001020200101111111111011111101
111111111111011010110111111111111111110000110202122201122202b000221201221110011111010011111111111122210111222212200012222221222200201112211111111011110111110111
110111011111101001110111111111010011110111022221122221002011b221210211221110111111111010001111101212101221112111011222212220102111212122221010101111111111111011
111111110111110111011111111111111110111111021120110121112022a120220100201111011111101111111111102212020200112202201221102022221012121112112121011111111011001111
111111111011111011111010111111101111111111202112121221011211a120110102011011110110111100111111011022111111112202222010222222101022101021122012110100111100011111
110111111111111111111111011011111101111111012212222200122100a222201111020111011111111110111111111210100111211120210221020222011020111120222000110111111111111110
111111111111001111111011101011111111111111202022120021100201a021201122111011011111101111111011112102022210022201122022211112221101211120202120111111101101111111
111100111111111011101111111100111111111111121201221111221222b011222211220011111100111010111111011221122112121102212211120220021102220122110112111111101111110010
011111110111111101111111111111011101111110111111121201010220a122122022221111110011110111111001111101222211112112102201020220122112112002111222101110111111111100
111111111101111111111001111011111111110012210022112201211122a120101220101011111111101111111111101122211122110122222222222002211020221121122011111111111101111011
110111111111110111011110111110101101111012010021112022222011a121102212121111111111111011111111010101220222112111002222121121111111222100122101110111001011111111
011110101011110011111111110111111011011112112121111021101112b222211202201111111111111011111011012221211122121222112121201222220102210122111201011011100111011011
aaaaaaaaaaaaaaaaaaaaaaaaaaaaaaaaaaaaaaaaaabababaabbaabbaabaaa212100111121011101101111011110111110021111202201200111202121020201100200220221101111100111100111111
1110110111101010011110101111110000111011112222022201220022200221222201221111101011111111110111112122102121122012001221220122021111222220102112111111110001110111
1111111010111110111111111111111110101111100112210121200121211221120120021001111111111110111111000021122212222112222220212202022122120121211011100111001111111110
1110101111111110111101110111110111011011111111112211222020111012102021101111111111111101111111002021112001201212222212120220220120022221022110110111110010111101
1111111111011111111110111111000110101011112112211212202112221211111121221111111111111010111111112212211100122212011212111210112111111101110111111011010110111111
1101101111111111101111111111111111111011100201221221121211121021120211011101111110111101111111111210111212201211100210001101100101001111111101011111111101111101
1101110101111101110101111110110110110111112020110222202221111021121122221110111111101111111111001220100122120111112112011012122010110011110111110111111111111011
