14 69
149 71
122 49
126 101
64 67
119 18
56 105
111 104
8 43
26 34

1111111111011111111101111110110101111110111101111111111111111111111111101111111001111011110101111111a1111111111111111011111111111101111111010111100aa11111111111
1111110110101111110111110011010111111111110111100111011111101111111101111111110111100011101111111110a1011111111111111111111111001111101111111101011aa01101111111
1110011111111101001111111111111111111010110111101111111001110111111111111111111001001101110011011111a0111011111111111011111111011011111110110101110aa11111101001
1101111111111111011111111111111110011111111110111101111011101101011111111111111111101110011111001110a1100102221112222221222120211100112100001111101aa11111111110
aaaaaaaaaaaaaaaaaaaaaaaaaaaaaaaaaaaaaaaaaaaaaaaaaaaaaaaaaaaaaaaaaaaaaaaaaaaaaaaaaaaaaaaaaaaaaaaaaaaaa0112012111110021100221221111110020111011110111aa11111111110
101111111011011100100111011111111111011111111111111101111110111111111111101111100111011110101110111101111221110122100022211121200011121111111101101aa11111111111
111111111110101111101111110010111101111111111111101111011110111110111111111110111101111101111110011111111202221202122112111100111122021110111101110aa11001011101
111111110101111111111111110011111111011111111111111011111111111011111111111111011111110111011110101111102102111111002011202100112110110111111101000aa11111011101
111010111010011111101111111111100111011111011111111111111111110111011110111110111111011111101110110111010221100112221112112122122221110111111101100aa11111110101
111111101101101111111011101011111110111111100111111111111101110101111011111011111011011110011011111110102021012111221222221121112111111111011111111aa11111011111
111111011111111111110111111101111110011111101101011111010111111111101111111101111101110101111111111101011021100102002221202121222210210101111111110aa11111101111
101111111110111011101111111110111010001101111111111101111101111101111111011101111110111110111011111111011210201221121121022122122211011111011111101aa01111111111
001111101111111101111110010011011111110011111111011111011000101011111011110111111001111000111111111111102210112121100122121202102212011111010111111aa01111111111
110110111110001110111001101111111111111111011111111000111110101111111111110111111111010111111101110011111220210111100112002111221112212001001111111aa10111110111
011011111100001011111101111111011011100101011101110111111011111011111111011111001111101111111011111111111100220122212212102111011111011110111010011aa11101011011
111101110111111111111110111011110011111111111111011111111111111011111110111111111011111111111111100111012101212012012021222212110211202111110111111aa11111111011
011111011111011001111111111111011111100011010110111111111111111011111111111110111111101111111110101111112222122020102001112101121122012010111111011aa11110111111
111101111111111111111111111001111111101101111011110111101101110101110110101110111111001111001011111110111110121112202122221222112110122111111111101aa11111111101
111011111111111111111111111011111011111101100110111111011111111111111001011111110011101111100011110110110021012001212001122102222202210111111111011aa11101111111
111100101012222202212111211200111221012120101011111101111111101111110111011111111101111111110111110111112001201222202111021221210221222111011101111aa10110111111
1001001111120200112022211110212122121221121100011101110011010011110aPPPPPPPPPPPPPPPPPPPPPPPPPPPPPPPPPPPPPPPPPPPPPPPPPPPPPPPPPPPPPPPPPPPPPPPPPPPPPPPPa11001100110
1111011101102210101221201221122001222012000010110111111111011110010P11101010111110111011111111111111101120012112222112021011011002221111111110111110P11101111010
1010110011122212022112122122112122122111120111011111111011111111011P11101011111111110110111111111011011111222001211211122121202111010220000111111111P11111111111
1111111110122111112001100210112122201101221011111111101111111111110P11111010111111110111101111101111111102220112101121120012102221210121111111111111P11111001111
1111111101102112211212110021122021011221121111111101101000111111011P10111110111111111110110111111111010011121011212120121201010212212121111111111111P11010111111
1111110110112001220212112220122121211222221111111110111111110111111P11111111111001111010111111101111111120120020110121211100021210122121101111101110P10111111111
1011111111122212202110022202211120122120201111011011111111110111110P10110101111111101110111111111111101112021212110222120201201121111121010111101111P10111110010
1111111101122211111201112101012212101112121101111101110101101111111P11111011101111111111111111111011100122222122222012022222222112211021011111111111P11101111111
2110202022121020220122210212022111111120111111111111110111111111111P11101011101111010001111111111111110110110020210102112212112121122021111111110011P11001111111
0212100202122222222212212220222222201211100010101111111111101011110P11101111111111011111111011111100111101221111011110112222222211010111011111111001P11011111110
1221210001222122202222012222222221102202221010111101110111110111111P11110111110111111111110111100111111122221120211100212122111020211221110111111010P11011111111
1221122002121122220120222022120000021121021111111111111101101101111P11101110011111111111111111011111101121121012202011121112011110012121111111111111P01110101111
1121112222112202212222012122022121210101101111111110111100011010101P11101111111111101111111111010101001100010112211111100121212110201021100111111011P11011111110
1201220121221222021211222220020211112200021111100110111101011111010P01111110111111011101101001111101000102110021000212222112122011022111101010011111P11110011111
1011221221222222221212211120202220222012121011111111101110111111111P01111111101001011111111010111111111111100211212101120120002211202112210101110101P11110011111
1210112212202002222022221222220022221211100010111111111111111101111P11111111100011100111101101011111011111011010220011120110110222121100111100110001P11111110110
0221122201222211222222010201202101221212201110011110011010111011111P11101011111111111101111111101111111011111021122120222121202220212220201110111001P01111011010
1122011121101202112222221022222221101111111011111110111111101111011P11111111111111011110111011111110111100021222111110222222222112110021221110110111P11111111011
1111102112122022022222222110200211010202211110101111111110011111011P11111111010111111111101110111111010111010011122221210011111112221212221011101111P11111111011
2222221221020100002202222222222212200222111011111111111111110110101P11111111111111111111101111011011001111101112111002211221211120202120201111111111P11001111101
1111112220202222210121222122212222120121100111111010111110111001011P11111111101100100101101111100101110110000101110011122022221211111211020110111111P11101111110
1120110022112112211012201211220222122112221111111111111110111111111P11111011111001110001110111011111110111110012220221220022002100212202210111011111P10011101010
1220121211100210220202222222202011012122021101111101110001111101111P11111110111110111111111101111100011101101212211201201111101221121222221001111011P01111101011
1121202121012220002222222002222122021110111111001111111011011111011P11111111111111111101111111011111101011022100111011222222210212222121021110111111P11110101111
2212112101212212222222120102220210220112101101011110110111111111111P01101101111110111001111111101110110110112122002111111112211211120222101100111111P00111111111
2011120212121022210222221112221020110112111010111110011111110101101P11111110111111011110111111111111011111120122010221122121222022122200211111111111P11111111011
2212202112220112222222122212220110020110210110111111111111111110011P11011111110111000100111001110111111111100022022211111110122220212002121111111110P11111110111
1210122210121111022112122202201021111101001111101010010110111110111P10111111110111011011111110110100011111122221121222010112101121121220010110111110P10110110111
2221011210110112220020122102212101111101120111101110111110101110111P10111111111111111011000111111101101010111202111012112211110211120011111111111011P11011111110
1001111020122120200122221220202001122110221110111111101111110101110P10111001110111101111111101110110101101012012111122211210111112121221121110110111P00101011111
2201121111222222201110112022221111011110111111011101101111011110110P11111101101011111111010101111111011110110112121011201011111021220121120111111111P01111111010
1121221222111211221002122211211111111111111111111010111110111010111P11010111011011111111111111111011001110122120212221212222211202200222111111010111P11110111111
0121002111101212111010212101112110111111011001110221210220102211211P00222221211101111101111111101110111010110221121121020012212112221202221111111111P11011101111
1020111012121222211121112112000111001001011111111112000211111112212P22101221211011011101111111111011111111122120122111212121211101202112111111111110P10011101111
0102102222112002111222212111112110110101111111110212111212211121011P12221101121111111111100100111111010111111222110122120221110221212022221101011111P11111011111
1021111111212211102221121221122110111111111111111212102102221022210P11201220021211110111101111111010011111120102111101110112021210011221211100111101P11011111111
2211121111212222121210111202021111101111001111001011110111021112112P12211010122210111010111001110011000100112120201122211200111222011212111111111001P11111111110
2112122100210120212212100001111111111101011111010202011122211122212P10110121112011111111111011011011111111100222012220101021122222021121221111111011P11111011011
1122020001212012210222211121000111010110011111111000101201212111210P01112220210110101101111111111111010111122202011111112212222022212211220111110111P11100111111
1110111011110111010101011111101011110111111111001211001102221121122P20020222222211111111111101111101011110112221212112211101212121122211121011101111P10110011111
aaaaaaaaaaaaaaaaaaaaaaPPPPPPPPPPPPPPPPPPPPPPPPPPPPPPPPPPPPPPPPPPPPPb01112112120111101101110101111111111111020020212212121112222112121220201110110111P11111111100
111110111111011111111P111111110111101111110111111122102221011111201012022011222110111101111111101101111111120201211221201201102222120210001110111110P11111111111
aaaaaaaaaaaaaaaaaaaaP001111111111101111110001101100102201212bbababaabbbaabbbaaabaaaaaaaaaaaaaaaaaaaaa01111120021211012121222002211201102021111111011P10110111100
11111011011111111111P101010111011110110111111011122210220211b202111120021222220110110111111111110111a11101112012000201222211020112212212211101111101P11111010111
11011111111111101111P111111111111011111001111111111201221122a121111020121122112100011111101111111111a11111000110011201101212220020202100111111111111P11110111111
11111010110111111011P111110101111111111111001111111211010201b020220011212120120111101111111101101111a01111110110101111011111011101111100011010111011P10111111111
11111111101111011110P111111111001011111111011111121011221211a211022222100211012011111111011111111101a01100111111111001011111011111111101010101011111P10111111110
10010111011111111101P110111101111111111110110111110011210021a122111110122221111201110010111111111111a01111111101011011100111111101101101111111111011P10110001111
10111100011111101101P111011100110111100110111111122101202222b221021211222122121211111101111111110111a11111111111011101111011101101011111111110011111P11111111111
01111000111111PPPPPPa011111110111111111101010111122212110222a201201010021212222101111111001001110111a11110110111101111111111101111010111111101111110P11111110100
11100110111100111111a000101010111111111101111110112201120222a012021022121002022211101111111111110111a11111111111111111111111011101111111101111100110P11011001111
01111111101111111111a111011111110111111111111111112212202202a122120212210120111111011101011101101111a11011111110011101111011101011111101111010111101aP1111111110
01111110011111111111a111111111111111111111110101102220101012b210122022002122220011111110010110111110a11111111111110111110111110111111101111111111010a11111111011
00011111111111111111a110111110111111011111111111102121112222a110222112212202112110011111111111101100a11111100111111111111111011111111111011111011111a01110110110
11011111011111011111a111110000111011111110011101111122220211b212111121021222212110110111110011101011a11000111111101111111111110111110110101100111111a11111111110
01101110101101011011a111111101101111110111111011101222221120a011012112011222220111011101111111011110a11111111111111111101111111111110111111111111111a11001101111
10101111011110111011a111110101101111111111111111112112221222a220102111101011221211111110111111111111a11110111111111111110110101101111001111111101011a11011111010
11111110101111101001a110110111010110011111101110120120112222a102122222121110012111111011101111110111a11110111101111111111111111000111111111111010100a10110101110
10011011110111011110a111111111111111100110011011010122222012a021211111111111102211111111111011101101a11111111110101011011111111111111011111111010101a00111110111
11011101111101111011a111111010111011110111111111122211111120a121101011112120121211111011100110111110a101011111111101110101110101aaaaaaaaaaaaaaaaaaaaa11011010111
11111101001010110101a011111110111001111111100111021122212112b211121200022221112011111111111111011111a111111111111111111101110111a1111011111100100101111111111111
11111101011111011111a111111111111011101011101100002222212111a121110102210111121001101011110101111011a100111111101111111110111111a1111101111111111001110111100101
11111111001111111010aaaaaaaaaaaaaaaaaaaaaaaaaaaaaaabbbabaaaab021222222121121010011101111111111111111a101110101110000111111011111a1111110111011111101101111111111
1101111101100111011101111111101101110111110111000111111111111111111111011111111111111111010110110101a011011111111111111111101111a1110010111111111111111111111111
1101111111111001111111011011011111111111111110101101110001111110101011111101111101110101010111111111a111111110111111111101111111a1111111101111101111011111111111
1111101111110111111111111111111111010000111111111111111111111011111111110111111100010111101011111011a110111111110110110010111111a1111110111111111111011100111111
1111111111111111110111011111111111111101111001111110110111110110111111111111111101101011111101111111a110111101120210221221020221a1001212220111101111111111111111
1101111001111111011111111110011110011111011111001111100111111110101110111110111110110110111111110111a111111111010001121011201201a2212220211121111111111111111111
0011111111111111000101111111110100101011110101100111111110111111101111111111010111110110111111011011a011011101122221211122222012a1211010212221101111111101110110
0101111110111011111110111111111011111101110101111111110111110111001011111110111011000001110110011110a120212002122201221212202222a0221021111201111010001101111111
1110101100111111111111110101100111101111121001000202112121111101222120201101001011111001110000111211b110221212201220022202221022a2201211001001111011111011111110
1111111100011100111111111011001001111111121122122120202200010112212112200111111111101111111100112210b012111012221101112222222111b1202222221221101011011111111111
1111011011110111111111111011110111111111112110012001012111121220211210110001110111001111010011111220b222111211222012002010221212b1210210101122010111101111010001
1111111111111101011110111101101110111010121101122112202122222122120222111111111111111111111111101121a220110202202110122020222222b2002020212020111101011100111011
0111101111111111111111111111010101101111122110110122012220221221122221200111101110111111011111111210b110212211111022222202112221a1011012211212001001011111111100
1111001110110111011101101111111011111001112221211221201102021210101102220111111111111111011111111021a011021212212220222101220211a1101112111121010111111101111101
0111101011110001111111011110111111111111002222201122112120222211122121221001111110101111111101111212a101111021222202212122220211b1010111011211010111111111101111
0110111101111111011011111110101111101111102212222121222011102012211020211111111111111011111111102221a020202112021121222201220220b1210010112111111100111001110111
1111001111011011110111111111011101111111111122121002221201011022221021100111001111111111011111112101b200201002222222222222120101a1121122112101111111111111111111
1010111101101111101001011011111010111111000011212221210212211111101012001111111111111111101111011212b0201202aababbabbabbbabbbbaba1120212122101111111110111111111
0111111111111101010111111111111110111111102201012221120211102112211202200111101111111110111101111221a1100112b022012220122021020110012201111110111101111011111111
1111011111101111111110111001111110110111111101212211222020212200212211121011101111011111111011111211b0120212a222201201222202220202122112210121011111111101111111
1101111111111111101111111111011011111111122101200022211122221202202220121101111111111101011110110211b0001221a222122220212220222201111212012121111101111010111001
0011111100111000101111111110011000001100120012222122112221121121022221220001000111101101101111012210a1200211a211112221112110212220201111112212111010010111111111
0111111011100011111111011111011111111011122022110101121122222111122122200101111001101110011000012111a2000222b220122010010022022100201122221121111101110111100011
0111110111111110111111011111111111001001111012101212110101001102120011101111111111111101111111012202b2012012b122222122020222001202011211021012101011111011111111
1110111100111110110011100011111111111111111122212212112020121202222111211111111111110111111101102220b0102212a122212112012001022111212120122122111111101111101110
1101111110111101111011110110111110111111101222120211011001110010120022221111110011110110111101101222a0211112b222022222122202012221211212110201110101111110110100
1111111110111101111011111110111111111111111200211201122100122212221210011101100101101111111110101211b1121102b220222210022220222221100120020202111110111110111111
1111111111111011101101111111111101111111101112212212111120212221220012221110001110110001111011111002a2021211a011222220120221100222120121201211001111111111111101
1111111111111111111100110111111111011111002002220201220110200111222101121111111110110111101101111121a2011120a221202220120120202020110221120120101111111111111111
0110011111001111011111111111001011101111121202220210121221222221211111021111111111111111110101111222b1221202a110220220220222122220101021221121111111111111111011
1111111111101101111111101110111101101111111210212111111101222100020212211111111011011111111111112211b0211112b021220222122022221101002221211010011111111111101111
1011111111111111110110101110111111101111122012201120222221112122100112211111111111111111111111112120b1122111b100122220002222122212110210210222111101011111111011
1111111011111111111111010111000111101111101211221222101212221112001111210110111111111110010011111012b2221211a212222221122222212122202211101112110011111111110010
0111101111111110111101111111111110111111102221100102120211011002212222121100111110111011111111111202a1122111b022222222212221212012202221122201011010111100101111
1001111101111011101111111110111111111111111121220221122011022001221021210111111111010111111111111212b1100120a220222222222222010221010121212121111011101110110111
0111111111111101111011111011111101111100011222202111102111012212112221211111111111111111111111012121b2120101b210210021212212202011111111011111111111110010100111
1101110011010111111111110111111101111111122111122001221012222111122102020010110111110011100111112121b0122211a212021201022202120111101111101110111111111100101011
1111101110111001111111111111111111111111021112202020210120211221210022211111111111011101111101112012b1001121a111222212212111201111111111001110011111111111111111
