153 13
130 109
122 49
126 101
64 67
119 18
56 105
111 104
8 43
26 34

110111110011110011111111111101111010111111111110101111110010010011a110111111111110110111111001111111111011111111111111111110111101111110011111101111100110110111
101011100111111001111011111101111100111011001101111101101001111111a111111111111101111011111110110111111110110110011111111111011011110111111111111111101011011101
101101111111100011111111011011111111111111110111011110111111110111a111011110111100101111101011111011101111111111111101100110111010111111011011110010101101111011
101111111111111111101111111111110111111111010011111111110111111111a000110101110101111110101110101011111111102211202101012111221201212010001110111010001111101111
111111111110011101000010111101111011110111110111111110111101111110a111101111011110111111111111111101111101210221112112202111112222222111110111111111110001101111
010101111111111111111111110110110111111111101111011111110111110101a110111111111111111011011111011111111120112120012101201211201201121010111111110111101011110111
110111111111111101111010111011101101111011011111011110111111111111a010101110001111111110111010110111111002120020012121110212120202221011011111111110011111111111
111111100111111011110110111101110111111001111110101111010111111101a100111111111111111011101101101111101011112212212221010220221121000121101111110111111111111111
110111101111011110111111110101011111111111111111110010111101110011a111101011011110111111111110111111011000110021101102011122011100112210101111111100111111101111
111111010111111111110111010111010101011110011101111110111111011110a101111111101011111011111111111101100112110222020122202211210202111121101111011110111110110111
101111001001111111111111111010111011111111100111011100111111111111a111111111111111111111101110111001111122121201221121110221021212121111111011111111110111111111
100110111101101111111100011111101111111111100110111110111111011111a111110111111111101111111110111111110101211100021022121122202011211221111111111111111110110111
111010101110011111110101110110110111111101110011100111111010101111a011111011111110101111111111101111110111022201201222111110212012212211111111111011111110101110
111011101111011111111101111111111111111111111111101110111111011111a111110011001111101110111111111111111111202112012101112211210110220121111101111111111011111111
110111111111111010111111111111111010101101100111001101111101111111a111111110101111101111111110111111111120112102201121120001020221111120011110010101110011111111
110011111011111001111111111101011111111111111111110110101111111110a011111111101111011001110111110011111112112222210202211110101201112210111111101111111110110111
111111010101001111111111101111111110111111111100010111011111111111a111111111111111111110111101110111aaaaabaaabbaabbbbbabb210200002212211111110101101111111111111
110111101011111111101111111111111111101110111011111111111111110011a100101011111110100011111101101111a1112212110112122110b212221212100121101111011111111111110111
110011111111101111011111101111101011111111111010111111111111110111a110100111110101011111101011110111a1111022222111211211a110112211122201110111010110111111011101
101101011011222020222120100122112111211010101111111110111110111111a000110111101111101101111111011111a1110111222201102120b11112112211221aaaaaaaaaaaaaaaaaaaaaaaaa
111110110101021100112022010011111202111202111110111110001111111101a111011000111110011110111110111110a1012221102221022202a02210021211210a010011111001111001101111
111101101111120220222211222112201112202101111011111111110111110111a111111110101101111111110111011111a1110002212122201221a22011201121102a110110011111011101111101
111111110102012010111001200121011212001211111110011110101011111110a111111111111111111101111111111111a1012212210122221222a11122021201202a110110110111111111010110
111111111101222010200200210210210122221021111011111101111110010111a111011111111111111110111111111111a1011210121020210121a21211111220112a101111111111111111011111
111101011010121012221110112221100211122021111101111111111110111011a101001110011011110001111111111111a1110020201211221121a20102210122212a111001111110111111111111
101111111012210102202201122122110121010111111111111101111011100111a111111111101111111111111111110101a1112102121111112212b01221110220102a111111111111111111101111
110111111112111101021210102201111120200121111111111111100001110111a011111111111111111111111111111111a0111011212222102022a02101210202222a101111111100110111110011
011111111111202110212210221211110110122111101011111011111101111111a111101111010101111110111111101111a1012210112102110212b00022201222212a110001111111111111111111
102022210202121020122222120210211222222201111111111011111011111111a011111011011011110010100011010011a1012112000111012021a11112111112122a101110111011111111111011
222102002122122122222222200102201111121212001011111011111110111110a111111111011111111111111111111101a1102200111220021110a22201121211122a111111110111111111111110
101001111102120202202011200220120202121212110101110111111111111111a111111110111011101111111101110111a1012202111121002221a11120122120212a110111111111110111111001
201211222010222120221202220220202121202220110111111110111111111101a111110111111111111111110100011111a1111120021222222120a11120120210222a111111110111111111111111
012021211112222112221212001211220212201202010111110010010110111101a111110111111001110110101111101111a1112122010211002121a12222111012121a011011011110111011101111
201111202221222200022112212100201210200122101111111011101011111111a011111111011011011111111111111110a1112011112120020112b22201020011011a100111111111111001011110
202022222012120222022222200201221022000110110111101111111110110111a111111111100100110110110111111110a1111101102102102211a02211202022201a111100111011101111110011
111110211112222220122102220222121111221111111111101111111111111111a111111111111111100101011101110110a1111011111022120211a20212100122211a021110111110111111111011
210211112012222122202120212222001220222101111111111001001011011110a110100111110111011111111111111100a1111110202110201121b20100022222212b201011111110111110001001
000211021100120212222222222210212122211212111101111101101111110001a011101011100001111111111100111100a1101112202112011111a21021021100221a021111111111111000110111
002101112202201222210120200022002110220002111110111101001111001111a011101110101110101011111011110001a1111112222111102111b12012112122210b221110111101111011011111
112122012202220212202222220002012102112121111111111111011100111111a101101101011111111011101110111101a1111012220222102201a01021021210211a211101111111110011111110
bbaabbbbbbbabbaababbbabbbbbbbabbabbabbbaabaaaaaaaaaaaaaaaaaaaaaaaaa111111111000111011000111111101111a1111111121201121121b21221102121202a111111100011111111111111
0022002120102200202220222220202112100012011110111111111101111001111111111111111111111111111101111110a1111112111221201212b12122122211210b221011111110111110110101
2121220202112122222212121222102212212112201111111111111111111111111111001111111001111101111111010001a1110012220020221100a01021220212120b211111101110111010010111
1111111022012101222212211220220212112110101101111101111111110111110110111101010101111110111110110101a0000110012111112211b21020222111222b121110111111011110111111
2211112210022222122110200022221121121122201111011111101011011111011111111101110011111111110110101111a1011111111112211111a12121221112011b111111111010111101010111
0122002202021200121220212212122211121112211110111101011111111111111110101111111110101111110101111111a1111110122222120111a20121201221222a111100011110111011111001
2220121211101020021221200222220002111221211101110111111101011111111101111110101110011011111101110111a1111112111202021212a21010121122121a111111110111011101111111
0010110222220222021121220102222111222210211010011110111111111111111111111111111011111110111011111111a1111101220210212011b01121102201122b211111101010111111111111
0022201110222221020112212122210221022221111111011111111111111001011001111111110111111111101110110111a1111110202200212201a22111212102012a201101111111111011111010
2111111201112022022222222221211222121022111101110110001100111100011111101111011011111011011111101111a1111011201111001211a11202211021101a011111110111111011111101
0102112212011002200121120220222110101111110110111111111111111111111011111111110101111111101111111111a1100102220111012122b21121210112102a211011111100111111110011
0212212010222101211001121112112111110111101001110111111111111111111111111101111001110001111111110111a0011112121112212010a11211122120022b200111110110111011111111
1200211122202202201212122111212111011011111111111200212220221212212112122011120111001011110111111111a1111111121110201011a21211220220121a111111100011111111010111
1201112022101121110111121121021011111111111101111222222102221111201222002110022101101111110111110111a0011002121221221211a12102222212020a111111111111001111111111
0121201021122111211011122122221111111111111101111202220112221112221201101212212200011111111111101111a1101110012100211002a11221202212102a020001010101101111111110
1021211111201121110011211212222011110101111111111011010111211112222122012110211101011110011111111111a0111012112110221201b02010110211102a021111001101001111011111
baabaabbabbaaaababaaaababababbbaaaaaaaaaaaaaaaaaabbbbabaabbaababaabaaaaabbabbbbaaaaaaaaaaaaaaaaaaaaaa1111002222211011012b22211122210021b221110111111111111101110
122222110112121011221111121221210011111111111111111002112121102001201112020220201111101111011101111000011101121222112220a12112122210002a101101110111111100101101
220212011012122012211022212021211101111111110111101001222212111122122000201121110110111110101111111111111111221121112122a10220122021101a001111111111111011001111
aaaaaaaaaaaaaaaaaaaaaaaaaaaaaaaaaaaaaaaaaaaa1101012102202120121222222212021212021111110110111111101111111112220101221120b02222112012221a220111110111100111111101
1111111100001111101101011111111111111101011a1111121111212222222001002220111220221111111111101111101010111111111102222011a20120021012202a200111111111111101111001
1111101110101000111111111011110111111111111a0110112101220112220201211102202112121111011111011111111111101011001122201111b02210110012112b111101111001111111111111
1011101011111111111111111111111111011101111a1110101121221121122121212121211111011111111101011101111101111010221121202120a01212221121101b201011111100110011111101
0001111111111111011110110011111111110111101a1111120101211222210112001212121201111011111111111110111110111111210201020021b12121021112202b111111111011111011111111
1111101111111111011011011111111111101110111a1111022121102111211212002012012011211111011110111111111101101112101121202122a12112112011200b120111111111111111011111
1011111111110111111011111011111111101011111a1111111121121210111101202000222121211101111011110010111111011111111111111111a10111111111111a111101111101111111111111
1111111100011111111111110011011111111111111a1111120110100122221020102211110121121111111110111110111110110111110111111101a01111111110111a011011110111111011111111
1110111101011111100110111110111111011011111a1111120021112121210000010011222100100111111111110111011111110111101011111111a11101111111111a110111010101110110011111
1111111111111011100111111111110001111011111a1111121222122112112002112101121111201101111101011111110111110111111111011101a01011111101111a011111111101110111111111
1101111111110110111111111011111111010110111a1101112111112012202120221120102121101111101011101111111111111111101111110011a11111111101111a110111101111111110111100
1110111111111110110111011010111111100101111a0110112021020210120101210111212121121111001111101111111011100111001001001111a10111111011110a111100111111111111111100
1111111101111010101110010111011001001011101a1111112101201002010102201212122100111011111111110011111011111001111010010111a11011110101101a111111111111111010101011
1111101110111111011111111001011111111111111a1011121001010222122222220111122210011111111011111011101011111111110111111111a11011110111011a111101101111011111110101
1110111011101111111101111111111111111101110a1111102221221210200121011220221010111111011010111111111111111011101011111111a11101110101111a110111111111111011110011
1010011110101111111101110111111111111111011a1111121120110211221120212212220012010111110111110010110111011111110011110101a11100101000111a111111111111110111111111
1111011111101101111011110111011101111101011a1111121201112122201110011100111002121111111111111110111111011111111111011111a11011111111110a110100111111011111110001
1111111111110111111001011110011111111011111a1101121122121001211012221101210011021011111110001111101111111111111111100111a11111110111110a111111110111110111110111
0110011111011101111111011111011111111111110a1111110212212121202111022222212022221011110111111110110111111110111111111111a10100011111101a101101011011111111111001
0111011111101111111011110010011011101111111a1111112121122221221212221021220211121111111111001110110111111011111111110111a11111110111110a101101111011111011111111
1111110111110011111011110110101011101101011a1101122102210100212222211011211220111111111111111111110101111111111111110111a11101111111111a111011101111111111011101
0111100101111011111111111111111010101101111a1101111022120212122120221120122212121100111111111011010101001011111111111111a11101111110011a111110111001111011111101
1011110110100111111111111100111110011111111a0110002202120221122222112222212210110111011110110111111010010101111111111110a10110011111111a101101111111111011110110
0111111101110111010111111100101110111111011a1111120122212110001102211221120020201011111101111101110111111011111111111111a11101111101101a100111111111111011111101
1011110111111001111010010101111110010010110a1111101110111111111111101100111011111110110111111111111111111111101111111110a11011000111111a111111111101101101111111
0111011101110111001111111111110111111011100a0111111111111011111111111111111111110011111110111110100111111101111111111111a10101111111111a111111101110111011111111
1111111111110001011111111110110111111001110a1111110111111111101011011110011111111101110111101100111111011111110001110110a10001110111111a110010101111111011111101
1110011011001101111101101101110111110011111a1110111111111111111101111110111111110101011111011011110110111111110211221120b21221112202202a121002111111111111111111
0111111111010011111111101010110111111100111a1111110111111001111110111110111111111111110011000111110111111101011222211100a21122222012222a101101001111101111111111
1111111101111111001111110111011101100101111a1010111011111101111111011111111111011011000110111111011111110111111201121122b02121201221021a122122111111100110011111
0011011110110111011111111110111011111111101a1111111111100111011111111111011111110111111001010011102211111212112212222022b11122122222221b110112111111001111111101
0001111001111111011111101111010111110110122a1212222102122202222021201221111101010111111101111100012201220211111222022212b22122210001122a212202111011111111101101
1110100110111111101001101111001011111111112b0112011112021122221222112020001110111111111111111110102221011202102022202122b12221222211211a220121111111011101011111
1111011011111111111111111110111101011101110b0100122201112111110220112211111111101111111111011101201122202112202212222222b22222222121211b012011111111111111110111
1111111110111111101110110111101110111011122a2211121122220100220111202122011110111111001111110111222011012011221202222220b22022001210221a222122111111111011111111
1111111111101111111110111101011111101111112a0111112221211221122221211202111111110101110111110011212211120111122021222122b02102221021221a210022111111111111111101
1111111101011010100110110111111011111110102a0220222100121011010201121020011101110111011110111001221121211221212202221122b21112202101212b111112111110011110111111
0111111011011111101101110111111111111011121a0111120120022222100021121120110111111111110011111111202112212010202221200222a22212210002211b101221101111001111110111
1111101111110110111111111111111111111111122b1110120102111202212210221110110100011001111011111011212022222220221221100222b22022011221212a211212011011111111111111
1111011111111111111011011101111101101011020a2211122012211211121101121022110111111111110111011110012021112212121220220202b21110102122121b210121111111110111111111
0111111111111011111011101111111111101101100b2112001120211211112210112010110101111011111110111101021122121221122012022212a22202212002110a111212011111011111111101
1011101011111111111111111111111100111111021b2111121122022110210220221111011110111111010110110110121022112120122122021211b10112110212102b110020111111100111111111
1101111011110101111101111111111101111111111a0112122210221112021212112210111111101111111101101111110021111221111022020202b11221211111210b122010111111111011010111
1111011111110011101111111111100111100111100b2211201120012212111122122222111111111100110111111011121002122121001022222222a22222202110111b011212001111111001011111
1111111111110111011011110111111010111101021b2020122211101122222212022111111110001101111111111011210201101022221222120201a22111022112121a120222101111011111011011
1111101101111110111110110110111111011110022b2022211011201221022010110221111011111111010111111001211112101222111222012211b02022222122222a210221010110111111101101
1101101111111111111100111111111111111111122a1221212122121112021121211211000011111110111111111011211210222222022220110021b12220220211212a102121111101111101011011
1111110011111111111010111001110111111111121b1201100001011020101112121120111101111111111110101010121121210212212222022222b22211012111001a211100001111110111011110
1011100111011111111111111111010110111110111b2121021212222001121222011211111011111110101111011111002022111221011222222012b12210221101220a201222111111110101111111
0110111111011111011110111011111111111100111b0122101202222212211111102001111111110111011111110111112102222101022022122220b01120012221021a201212110111100111111111
1111101111001101111101111010111111111111101b1222111222110102220110122212110111110101101111100001121121002121001222010221a22212000121110a012120111111101111010111
1100011111110111110101111111111010111111122a1121101121210012221220122121111111111110111110111111210121200011120222212220b21222212211211a222120011110111111100011
1111111111101111111111101000011101111011012b1021102210122212202022211222001111111111111101100111201222022001211202221221a02212000021120a100012111101111101101111
1110111110111111101111111111111100111111101a2120222211122011210222011120101111111111011110011101222011210022011022202120b21222220201121b210110101111111111011111
1111111111111101111101111010110001011101120a2211021200122122101222112202111110111011111111111111222122212212021220212002b22202010210022b101222110111101110010001
1111011111001110110101101111111101101111012a1222122110011002111112021122001110111100111101011111120122102200012012012221b21222201211212a221212111101001010111111
1110111111101110110000011111011110110011121b1112122001120220211221221022111011111111101111011110011221122201112212222022b02112222122012b200212111110111111111110
1111111111111110111111111011100111101111122b1220111101002111211121111210111100101011101011111111122222021111121222222221b22222022222212a211122111111100111011101
0011101111111111111110111111111101011111102a2122212011122222211220210112111110100011111101111111022022010111010221020112a12001211111111a111111111111111111111110
1111010111111111111101111110111001101011121b0212221211212102121021121122111011110111110111111100010222220101110222121211b10221211101011a111111110111110101111001
1111111010111111101111111111111111010011102a1202002222212021111212220211011111101011111101100111111222121201111111112121a11221110111111a110111101111110110110110
