84 2
70 104
122 49
126 101
64 67
119 18
56 105
111 104
8 43
26 34

11111111111111111110111111010111110111111111101111111a110101001101101111111111111011111111111111001111110111111111111101111111010111111011111111010111111a111001
11110111111011100101111111010001001111111111110110101a111010100111011111111111101111111111111111011111110111111001111101111001111011110111111111111111111a011110
10111101111011111100111110011011101111111011100000111a111011111111101011101111111101P10111111101111001111101010111111111111111111110110011101111111111011a111111
11101111111011111100101111110111111011001110011111111a111111110101111111111111111011P11111111111111111112022211011011221102120122112221111011011011101011a011111
01111101111111111111111111010111111111111111111111111a01111111111011111011110111111P010110111111111111111122120212202212001122012210122110110111111011111a011111
11001101111001111011110111111101011101111101111010111a11111101111111111110111111111P111111111111111110112022202011120211010012111212121100111011111001101a101110
11111001111111111011010111111111111111110111110101101a0011011101111110001111100110P0111111110111101111111121201012221121101211221011111100110110001111111a111101
11100111111111111011111010110110111111111110111111011a011111111111111001110011110P00111011111101110111010121212101102011111010212102011111111111111111111a111111
11111111010101011011111100011110101111011111011110111a011111111110101110111111101P11111111111111101111001122211021222222122110112201202111111111111101101a111011
10101111111001101111110111111111111111010111111111101a011111110110100011111111111P11111111111101111111111212221101101212111021110121221111111011001101011a111101
11011101111111111111001101110011111110111111111110111a101110111111101101100000111P11010001111110111101111222101210122111210221021221211111111110101111111a111111
01111111111011111111011110001000110101011111110011111a11011111110110111111110011P011100111011111111111101121012201202221121121100222102111000111010011111a011011
11111111111101111111011111111111101110111011111111101a1111110111111111111111111P0111111111101111111111112210110011111110120112211201102011101110111111101a011111
11111011111111011111011010110101111111011111110111111a1100011111111111111110111P1111001101011111111110112101112101202211222211102011020111111111111110101a111101
01110111111111111111111011011111111111011111111010111a111111111111010111111101P01111001111111111111101010111001101002121121202112220122111111101110111111a110101
11100101111110101101100111110111101011111111001110111a111111011010111110101111P00111101111111111111111111001212200112221120211111211111110101111011111111a111110
11111111111101110111101111111010111101101101111111111a010011111000011111111111P11111111111011011111101001211212220202111122021212211021011110011101011111a111110
11101101101110101101111011111111111110001101111011111a111010110111111111011111P11111101111111111101011111022010000211222200122112211201111011111111111010a111100
11111111101101111101011111110110111101111111111111111a111111111111011110101111P11001111001110111111100011212220111121211212122222112200011111111011111111a111111
01111011111212210102111122222101220112122111111000110a111111110111111111101010P01110111010111111111110012102221212021122101112111222122110111011111111001a111111
11111101111220010121010102122122111111122011111111111aaaaaaaaaaaaPPPPPPPPPPPPPaaaaaaaaaaaaaaaaaaaaaaaaaaababaaabbbabbaababbbbaaaaabbaa2011011101110011111a100011
1110001111010102201111201021110221110122211100101111100111111111P11111111110011101111111110111110011101010221121222022110100222220121b1111111111100101111a111111
1010111111100122102210020121122220221212211111111111011111110111P11111111111111111111010110110110111111012201111112021101021112021012a2011111100111111110a011101
0101111101022200110112102221222121222110110111111111011111111111P10111001111111011111101101111101111111101221112210111121200021022022b2111110111111111110a011101
1111100101121102121112011011022201111111201001011111111101111111P11111110111110011111111111111111111101121212211112001121121001210100a1011011111111101011a111101
1111001101121001011211121112212121111211101111001111011111110011P00101111100011111111111111101110110101010122111022122112221001112222b1100011111001111111a111110
1111100111112210010211101220101021112212111100111101110111111011P11111010111111011101111111111101011011121221010221112222210112122112a2111001101111100001a111011
1001111111012111000202022221221122022222121011110100010100111111P11111111111111111111101111111110111111122121212011222222121012211022a0001011011111111111a101111
2121201211221020122202112212220112212011121110111011111111110101P01111111011001111110110011111101111110100112022112202112121221212111b1010011011111011100a011111
1122221012201221202222020212220102101000121111100011011111111010P11110111110011101101101111111010111011011100222202111110222111122220b1111111111111011010a111111
211212122112121001222022120000221221211222010111111111111101111P011111110110111001111111111111111011101121020220102111221121222101001b0111010111111110111a011111
211011012121221221122122222122011212121211111001101111110111111P111010111101011011001111111110010101101112111122220121111101122101211a1101001111111111111a101111
212110112020202122001010220221210012112022111111111111111111000P110111111111100110111111101111110101111111200022022221212011002212112b2110001100110011111a011110
112220102120022222202222021212210121112121111111001111111101101P110111111110111101101111111110111101101111122021011212110111111111012a1111000110111111110a111111
21120221220212222222011212011120121212101111111111100110011111P0111111111111110111111110111111110111111110121102121110020212212222122b2211111101111011111a011010
01021111211211222222012010212000211022222011111011111111111111P1110110111101110011110101111111011111111111001101021112221111202122011b2020110110111111111a111111
00102100122202022201222221222210221110020101111001111111111110P1111110111111111111111111111101101110101110102112110212112120222022122a2220101111010100111a111111
12112100110122101012211120000001221202020201011111111111111111P1111111110001101011111011110101111111111111111111002100112211201102111b1222101110111101011a101111
1212012110122212122022212200202210101121211101111111111111111P01111111111111011111111111011011101011111111100002110121111222021222202b0111111011110111111a111010
2022212120202122222220202222222222111220121101101111111110011P10111100110111101001111111111111111011101001102111111122122122112220222b1211101011111111111a011010
1112220102022122222222222212020102221101010100111111111110111P11101010101111111111011111111011101100011111120122112221100112212211121bbbabaaaaaaaaaaaaaaaa111111
2221100111122210220010220012222121202122121111110001011111111P01011101101111111101011011111101101011101111110121222211112002211212100021121111111111110111101011
210211211102221200120022222022121011020222101111111111111010P011111011011111110111111011111111000100011101002211121211222121021111220212221110111111011111110111
210011211202202222222222212202010201212200111110101111111101P010111111101111101011010110111111111111111111111200220120012121112112211211021111100111101111111111
bbaaaabbaabbabbbbbbbababbbbbbbbaababaaabaaaaaaaaaaaaaaaaaaaaP111110111111011111011111111111110111110111101122201011222221112211102112210111011111111110111111111
212011002220222122202102200122211101111111101101011011001111P110110011111111101111111011111111101111010111112022022221102221210010112222121111111110011111111111
112221012002221200012222211102212112212110110110011111111110P011101110110111111000011001111001100111011111102022200111102111211220221211211111110011010111111011
222221011112222022122222221120122201212101111111111111111111P111001111111101111101110111111111111111011111121210120021122012221222222211111101111101111111100111
212122211212222101220212222122101122021002111111101111111110P111100011111111111111101111011011111111111111121112101210201212011220111221121101110111011111111100
200002102202211222221120022200112101121211011111101101111111P111110110011111100111111111110111011001111111001000200012012022211211012021101001111111110011101111
212020111211211110112122201011211111011111001110110111111011P111111011111111001101101111101111111111111111111021122010201111002102211112111111111111111110101100
221201111212021122112212111211111011101111111111011111111111P111101111101111111110111011110110111110000111112011212202100021211121210011011111111011101111010111
111122200221112020021221102011211011111111111011001021212101P202011111000222212111111111110111111111111001102002112211101112211220222022121010011001010111111111
111222122221122121010111112220011111000101111111102221110210P001201110210000022011111110110111111101111111020122111202111001112221112110201101011111100111011111
121122021221101201222222211201100111101011111110022202110100P110102121021212011011110111111111101101110111102021210210201221202112211220121111110000101110011111
220122201121120101102212202211211101111111110111110121110200P220221000101221101210101111111111101110111111112021221111010121111210100222121111111111111110101111
212121102110222221112120121112011111111110111111111120201112P122001122221222211111111011111101111100101111112011210212220111110112220112211110101111110111111111
122022111112120112111110121201211100111111011110121122011212P222100212221211100211011111100111111111101111112210111212112210102120211112110111000111011010111101
212102122002121211212122101221011111101101111001102212111202P222212120202101101011111111111111111111011011121111212120112101102222112121211111101111011110111100
111111001111111110110111110111111111110110111101101100021121P221221211212221200110111001111111101000111111122112110221112020012221212221011111110010111101101111
110111111111111101111011111111111011110111001011121111021212P021222221101211201111110111101011111110111010112222112020210111112112102220120101011000101011011101
111111110101111111001111101111111011111111100011122111222201P221222120020212202110111111101111111011111111120112210210200011211211120201210110111111110111111110
111111101101111111011111110111010111101011110001112112111112P110021221222221111011101111110111111110101101112102102210011211121212201210221111111011101110101111
111111111111101111111111010101101111111111111101112222121200P211220210021211222011101101110111110101111010102212120221122102122021211210111011111011000111011111
aaaaaaaaaaaaaaaaaaaaa111111011110111011111111111002221110121P112111212112002012211111011110111111111111111111220021212022121020222222222021010110110011111111101
11101011111101001001a111111111111111111111111100112202212102P212201122001002221111111111111111100011111111111111011001111111111111111001101011111111111110111101
01111111111111111001a111111111011101111110110111122222122221P111220212022011200211110111111111111101110011111111111111101111111011110101111111110101111010110111
01110111110100010100a111110011011101101111111011111111211211P201122222012200221111101111011110011101111111111111011101111110101111101110111101111101111101101111
11111111111110101011a011111111111100101111111011002020100221P111011122102210121201111011111101111111111111110101111111111011111111100110101111001111111111101110
10111101011101101111a011011111111011100110111110121011102112P201101221201001020201101110111011111111111010111111010011011110111111111111111111101101111000111100
11110110111111111111a111110011101111101110111111111211022002P111221222111222012101111111111111011111111010110111010101111111110111011110101110100111111011111101
10010011111111111111a010110100111011110110111110111112220221P202112122010201111210110111101111110101111011101111010011011111111111110111011111111111111111111111
11110110111111111111a011111111111111011111110101022221111112P020201020111121012211011111111111100100111111111111011111001001101101110110011110111111111111101111
11111101110111111101a111110111111111011110111111120212111000P222111112111110222111110010111110111111111110111111101111111111111111100111001101111111011111111101
11111111111110111011a111111011110111100011101111122202111111P122121012221012220211111010011111110111101111110111111111111011111111110101011011111110011111110101
11110011111111011111a011111111111011111011110101112221222221P221110120210221110201111111011111111110111110101111100111011111011110111101001110101111111110111101
11111111111111111111a011111001010111011111110111112111021212P120022100211012222211111111111110111111111111100101110111111111011111111111111011011101101101111111
11011100111111011111a111011101111111111111111111122120201222P101120010121122210110011111111101111101011001000111011111001011110111111111110100101101110111001111
10111001111110111011a111111111011011111111111011122021112012P202112221101002122111110010011111111110111111111001111111101011011011111111111101011111101111111110
11111111011111111111a101101001101111101100111111021121200021P11212221112121202111111111111aaaaaaaaaaaaaaaaaaaaaaaaaaaaaaaaaaaaaaaaa11111111010111011111100101111
11101111011111110111a111011110111110111111101001110102021022P11122112202202212011101010111a011111010111111011110111011101101111111a10101111111101001111010111111
11100110111111101111a111101111111111000111001001121111111022P21022021012221121101111101111a011111111111111010110011010111010111110a11111110111101000100101101011
01111111101101111111a111111111101100111111011011112121020211P10202022011122201221111110011a111110111001011111101101111111010111111a11011111101111011011011011011
11111111110111011111a111111011111011111111111111101111111101P11111111111011101110101111111a111111011110111111111101111111111110011a01011111111011111101111011111
11111111110110101011aaaaaaaaaaaaaaaaaaaaaaaaaaaaaaaaaaaaaaaaP10001110101111111110111111101a011111111111111110111101111101111111100a10110110111111111111010101111
1111101111111110101111110110010101001011101001011011101100111P1110111110011001111010111111a010111111111111111111111110111011111111a11111111001110111111111101111
11111110111111111110111110111111111111010110111110111111111110P110111011100011111111110111a111110111111011111111111101211021221221a02211222200111011011111111101
10110101111011111111111011100011111110100111111001111111111111P111110011111111100110111111a111111111111111101111212212102112212202a21001001021111111111011101111
10111111001111111101111110110010111111011011110101110100111101P101111101111111111111111111a111110111110111101110110012120120202222b22112101200111111000101011101
111101100101011111011111011101111011111110111011111110011111111P01111111110111011111001110a011112121210221022112220222002201222120b12111221121111111111000010101
1111011111111111110111111011010111111011121202121211211121000100P2022202101111111101111111a111011122211220110012212021210222111210b22210120120111111111101111101
10111110111111111111011101111111111111111110111011021112221222202P012102111111101110010111a101111221221001222122222022101222022212b22211110111110111111110100011
111111111101110011111111100111111011011012102110121210211222211201P11122011001111111110111a111012012201211121101122222210222202111b11212101111101111111111111101
1101111011101111101111111110001011010100120222111012201121211011222P0122110101111111111111a111101210121201122102022012222122222112a12111211022111111110110111111
0111111111101111011011111011111111111101010212120221111201121111021P2100111100111011111110a010111111101201102112202222022222102101a12211010111100111111010100101
1101101110110111101101011001110111110011112122111120210101121200212P1122111110111011111111a011111211110101002211222222121222202221a22212111222111111101111111110
1011111111011011111111111110110111011111111212112001120120110112202P1222111111111011111111a001110212111101111112222122202220020210b22122212121111111000001111111
1001111110101111111111111111111101110110021210222122021200100002112P2202111101011011111111a111112211122102120202220210222222220211b22210022121110111011011100111
1111111111111111111111111111111110001000122102221020110210100121012P2222101111111111110111a111112222222210012101222220120220221110b02000211212111011111011111011
10111111101111101010111101111010100111111121111210bbabbabbabbaaaabaaPabaaaaaaaaaaaaaaaaaaaa111011211221212111110221022012222121210baababaaaabbaaaaaaaaaaaaaaaaaa
11111111110110101111111111111111111111111012112220b212012211222122022P201111111111101111111111111102110212222121222021222222001122121210101111101111111111111001
11111001111101100101111111011110100011011122021111b1020201121112120022P10101101101111100101111101120211010111222222202221211002220122220120112111101111000011111
11111111101111101111001111011101001011110202001212b2112021222202222211P21011110111011111111101112100201211210012022222221202222122122211212111111011111101111011
11111111111101111111011110001111111011111200211202b2221121121120101112P11111010101111011001111111212221021021222212222022220202022222222212212111110111101111111
11011111111101101111110111111111111110101012212012a0121211222112111221P21111111111011011111011112122011100101021222022002021222021221112221102110011110110110011
10111111111111111110111101111111111111111012021211b2111022100121200222110011101111110111111111111221121111021220212222220212022122020120122210101110110111101111
11010111111111111111111111110011011011111121010211b0112000021222121120211111011110111111010111111120011110112222210022221212222121222102120111001111101011111111
11111111111101011111111011110111111011111102112001b2020102112212220102221111111111111111111111111002021120222100221211122222220220120211211012111111101111101101
11111110111101111111111111101011101011111120011211a2221111120000012101001111110110111111111111110002222220022112111120221021112211020212012212111111101111101111
11101111011110011011101111011110100111011210211221a1111212112121221120220011101100110111111111110102202021221220022122122120220110010101220122010011111111111111
00111111010111111101101111100111001110110112221221b0220121112022211021201011101110111111111111000211110010220012210220201220220121122121121011111101101010111111
11101111110101011111001111111010111111111022211120a1010122110201110220111111100111110111011001112112211122101011212210121002222102221211200202101111111101111101
11011111111010101111111101111010111101100221112122a1221111220221221122110001111111111110111111111011221021101212022210222221112222002110222202001111111101111011
11111110111111011010111011110111010111110012211212b12212221baaaabbabbbbbaaaaaaaaaaaaaaaaaaaaaaaaabbbabbaabbbbbababbabbbababbbababaaabbababaaabaaaaaaaaaaaaaaaaaa
01111100011110110111111110111101111111011102222011b00002210a2201201012000011100101101111111101111011111002202221222112001202212102120111221212101111011110110111
10011101111111011101111101111110111111111102000020a11121112b0121211021221111111111111110111100112112221020201212221222212022001121220122121120001111111111110111
11111011101111011110011111111111111110111210210121b22112022a2221012220020110111111111111011001112102112011012122212122220122221011111221101012111111110101001001
11011111111011110111111111111111111101111220010220b22001012a1221202120221101111111111110111011101000002220110211212211022022211111111111110111111111111111111001
11110111111110101110111110111111111100110112021222a00112210b1121201111221111110111110111101011111002121112011022012122121222222001101111111111011111100111111011
11100111110110011111110111111111110010101100212122b11210212a1111110122000110101110111111111011100122121212201221200112211121212011110011111111110111111110110111
