1 14
39 106
122 49
126 101
64 67
119 18
56 105
111 104
8 43
26 34

1001111100011111110111111110111011111001101101111111011111101111111011110111111111110110110011111111a1111011111011110110111101110111111a101111111111101111111110
1111110111111111111011111111111111111111101101111111101011111111101101111101101010101001111010110111a1111100110011110100111111101111011a110111101111001100011100
0011011111111111111111111111111110011111111111111111011111010111011111110111111111101111011110011100a1110110111111111101001111011111111a111011011011111100111111
0111110100111111101111111111110111011111111110001111111111011111101101110111111010111011111101111110a1112102212221121011001002222120111a111111101111101110110101
1111111011111111110110111111011111111101011011111011011110011111111111111111111101111001111111110111a1112111102102212211221222112221211a001111111010111011111011
1111111101111011011101111011111011011011110101111111111111111111111111010111111011101101110111010111a1102122201122202211210112122121201a011111111111101111001111
0001011101111000111011111110101111111101111101111111101110111110011111111111101111101111111101110010a1111221121122120221100111110122112a101011011111011111101110
0110111111000101101111111111111111110111110111111111111110110010001101000010110100101111111111111110a0112022112220111120112100202121121a111111111001111110011111
1101111111110111010101101111111011111111111101111111101101111110111101111111111010011111111001011111a1110112211211210121101111112012221a101111111111101111110110
1101111111101111101001111111111111111111101111111111111111110011101101101110101101111111111111100010a0001201011200111112100110200022222a111111111111011011110101
0111110111111000111110010101111101111111101011101111111110101110011111011101100110111111111111011111a1111102211101121202112110022121012a111111111111011110110001
1110111110111111111100111111100111111110111111010110100111110011101111011011111100111100111111111011a0111002111011212100221010122221222a101010011101111111110111
1111111101111111111011101110101111111111111111101111101111111111011111111100110101111011111111111111a0111022110012121021210110102210211a011011011101111111111111
1111111101111011111111110111111101010110111011111001111111011110111010111101101111011111111001001111a1101220122121011012112121211100021a111111101011111011111011
0111111001100111111111110011111111110111101101111110111111111110101111110011101111001001110111011111a1111201210211220110211122121122100a010111100110111111111110
1111111101101111001010111011111111111111000101011011011110101111111010111001111111111111101110111111a0012111122021222212112102111112111a111111111111101111101111
1101111110111111111111110001111101111001110101111111101111111111111111111111111010011111111101111111a1112002200122122102201211120120111a111111110111111111111010
0111011111011101101110010111101111111111110110101111111100011010011011111110111111111011001111111111a0101211211121111211211210212102220a101011111101111111011010
1101111110111111110011111111111010010111110101100110110111011111001110111011101111111110111111111110a1112012212221111211120022120121122a110111101011011111110111
1101111101120222211000122211121111101211101111111111001111111111100011111011111111011001101111111110a1110211212002000221211022212202011a101111101101101110101000
1110101111120200120101101222212210000111110101111101111111111110111111111111111110101110111111110011a11001200211111bbbbabbbababbbbbbabba111111111110111011111111
1011101111111202202012122220221021211202200101110111011111011111111111101111111101111110111011011110a11120100121021a21122112121122111221010111111101001111111111
1111110011112122122210122022111020201011120011011101101111101101111111111110001111111111011110011111a00121102120020b11001111101211201220111101111111101011111111
1111101110111021112112121011122121112110211111111011010111011111110111111111011111110111111111111011a11120211121111b22111221201210220121111110001111111101101111
1111111101110102202221122022210101201202211101111110111001101101101111010111111101101111111111011110a11122202212121a22111122220221221211011000101011101111110101
1111000111121211021110022100120022120121011110011011111111011000110111100011110101110111110110101110a11100021121102b22221211121121102101010111011110111011111111
1111111111122121210002121211212111221121121111111111111111010111111111101111011111111110111111111001a11122002121111b12122211101220012120001110111111110111010110
aaaaaaaaaaaaabaabbbabbbaaaababbbbaababaabaaaaaaaaaaaaaaaaaaaaaaaaaaaaaaaaaaaaaaaaaaaaaaaaaaaaaaaaaaaa11101121211110a02111120212202211020101101101001111111111111
babbbaababbabbababbbbbbbabbbababbbabaaaab21111011011111010011111111111111010101110111111111111111110111111012210021a11022110212111121211110111111111111101111011
2220221110121000212100212212202201212222b01000111101111110100111111110111110100110111111111101110111111121102222220a12111121011112211221111101011001110111111111
2121221002220222200121212222210221111120b01011101110011110111110110110111101111101111011111111010110110110001112221a01212022112222101100111111101111101111111011
2022201122122121022221222210222111211220a21111011111111111111111011111101101111111111111111011110111111101111121021b20120120212022202111111101111111111110111010
0212210202211222222110221102020102121201b21110111111011010101111110111011101100101111111110111111110111102212112211a21201121121122211020111111011001111101101111
2122120112222111222212221222200210210102b11111111111111111110111110100111110101011111111011111001110111012212211220b11021221011002121221111011111011111111111111
1222202022222221112012222022021102212022b10111011110111011110111111111110111111111011011110010101110110111121121222a02101112011222212002101111111110111110111011
2210121222222102122200002221222122112121a21111111111111100111111101101111100111111110010111111111110111110121020212b22111210121221122212121111111111111101111011
2202122201101122222112220220210101100220b01101111110111001110111110011111101001111101101001111111101111111120122022b11212211111021221012121111111101011011111111
1100200222220222221222020221221210100110b01110111111011011111111111111111111111011111111101111001101110111121221020b01202101020211211110221111100101011111011111
2100200101110220020121112122202110011111b11001111100011101011111111101011111111111110100011101111111111011022112210a01222022111221220021211111101111111011111011
0002111011222220222102202222222222210112b11100111011011100001000111011111110111111101111110101110110101101111221220a02111002110202201121100011111011111110111110
2112222101220021022020112220021222120110b11101111111111111111111011111111101111111111010111111101010001111120122102b22112212101122112021011111111111111101111110
0001122111200221000222012220020012201110a10110111111110111111111111010101111111110111111111100100111101111102001010a21012211120121112101021111111101110111111101
2012202022011202122221121212111121222110b21111111011111011111011011111111111111101011111111011111111101011101121101b20021120121022120112121111111111101111111011
2121110221021212222222222102220112102102b11111110111111111111011011111101111111111101010111111111110111101102110211a12212122122122222212200101111111111011101101
1221222211120221001102212010012100120211a00011111111111110111101101011001111101101111010111111111101110101021210112b12122122220202212121011111101111111111110111
2211021022120201222220220212000211222221b11011111111110011101101111001110111111111110011110111111011100110111110121a21200001221122122110121111111011111111101011
2121101011021222212212212010212200022211b21111101111111110111111100111111011100110111111111110010100110101110011102b22101210121021120121111111111011101101011111
0202111210210220102112221220220000112111b10110011001011111110111101111101111111111101111111011111111111111021020202a00202221012110211111121111101111011111111111
2221212222022122102021222200220211122220b21111111011111110111111111001011111111111001111111111111111100001101221122b22002020122121011112111111111111111111101111
2021021222222212012021120212222222011011b11111001110001111111111111111111100101111111011111110111001101101112102220b21012012011111021221101110111110111101001111
1201110001211111112111202122111110011111a00101111111111101101110011111011111111111111001111111110111111111110221021b22111101002201122012221111111101111111111010
2212221121210112221122112112121110111101a11001011011111110111111111101111111101111110111101011011101101010110122211b22212121101111200201221111111011111111111111
1012212211102122220120001122110111111111a11101111220122112120012212122210111011211101001110111101111110111011122201b22121122221211222221220011101111111111011111
1220000102011212221222211111112111110111a11111111021122122021021210021100122202211001011000011111001111111122002122a11212022122222120021111111111111011111011111
1210221211220211112212210220022111001111a11111101122222102021211212122011212102211101111110110111111111111110121121b00221121221112202222221101101111111111111111
0212202121011022102200101222011001011110a11011110112122020220222212002022110120210111111111110011110111111121121222b00221121210102001102221110111010111101111011
1010201121011121111210202122121110111110a11110100210202121220120210221222011011110111011001111110111111111122002220b22112122221222102211011101111111111110011111
1210211011121122221002222112112111110011a11100111011222212021222012122211222101011111111011111001111101111111101211a01002221212211122012221011111101011101101011
2120110222211112001122120122100111111111a10111111112212212101222212100202021221001111110111011111110111110122110101b22122222122112102221201111101111101010111111
1110111111010101111111111011101111111110a01111111210211201212122210121211112121111101111111111100111010010012111011a21bbabbbbbbababbbabbbaaaaaaaaaaaaaaaaaaaaaaa
0111111111101110111101011111111110011110a11111011222112111211210011202211202021201111101111111111101110111100011102a02b22222102200202011121111111111111111111111
0111111111111111111011101111111111111111a11101011111111211011112201210221211201011111111111101111011111011011212022b21b10202212221212210221111011111111111111111
1111101111011001111011101111111011111111a01101011111122200121101212122212222002010111111011101011111111111121200101a12b21222121211220120221111111101100111111101
1111111111101110101111111111011011111111a11111111202102211112212002222212211112211000111111110110111111011011100122b22a22120101220121222010011111111111111101110
1111111110011101111111111111011011111111a11111111202210221222012212222211121021110111111111011110111111111020111110b12b12121000110101001201101110101111101111110
1110011111111100111100111111111111101110a11110111211121200222021110210221012221111111011111111111101010111111101101a11a10111111011111111111111111101110111011111
1101100110111101111101111111011111111111a11011111011220111220121102221111212201011011011111011011111111010111111110a11a11101110101111111101110011110111111110101
1111011101111111111011101111111111111111a11011111122221212122121202000211101201001101011111110111001111111111011111a11a11111101111111111101111111110110111111110
0111111111111101101101111011111100111111a10011110221121122011011211012221112212211011111011001001001111110100101111a11a01111111111100111011101111111111011111010
1011111111110110111101111111111111111101a11111110111121021210011211212200001221111111110111101011111111101111011111a11a11111111111111110110111111111111111111111
1110000101100010110111111111111110111101a11111110112010010212111011121102102122111111010101111111111111111111111111a11a11111111111111111001011111101101111100011
1111111000111011111111100110101011101111a11101111211202122021222211020000121121210111111111111101011011111111111111a10a11111111001010111110101111111110111110011
1110111111111111111011111111110111111111a01111111111121211121212200121212122211011110101111111111111101111111111111a10a11001110111111111111101111111011111111101
0111011110111011110111111011011111110011a01111011111212120111221112221100211221211011111111100101101111111111111111a01a11011111111101111111111111101011011101111
1110111101101110111111111111111111111011a11110111112212102202022121222222211002211001110111111010111111111111111101a01a10001101100101111100111111000111101110111
1111111111101011111110111111111111101011a11110101201220012011022112121211021211111111011111101111111111111100110111a11a11111011111111011100110110111011111100101
1010111111111011111111011110101111011111a01111101102211112210012221021111122200101101111011111011101111110111111110a10a01110111111111111111111111101101101111111
0101101110111111101111111110011110110011a11110110111112111202101120210211211220211111001111011100111001111101111111a01a11010111001101111111111101010001110111111
0000111111111101111011011111101111111110a11110101022111220102120210111202110200111111111100111001001111111011111110a01a11111101101111111011101111110111111111011
1001111011011111111111111111011101111111a11110101211201111111210121210220112210011100101111111111111111111001111111a11a10111110110111101111111111111011111111111
1011110111010111111111100111111111111111a11111111222102221112221212222011112002111101111011001111110101110101101111a01a11110111110111110011111110111111101111011
1111111111111111111111110101111110111111a11111100222112201221112200210201121112211111110101011101111111110111101111a11a11101111101111111010101111001111111011010
1111011111101111111101111011111111111111a11111111210111211021222011212122221122110111111001011111111111110111101101a11a11110011111101111101111111111110110011111
1111111010110111111111111110111111100001a11110101111111111011110111111111111111110111101010101111011011111111101111a11a11111010111110110111111010001111101111110
1111111111111100111110111111110111011111a11111110110011101000111111111111101011111111111111111110111111111111101011a11a11111101100111111111001111111101111110111
1111101111111111011110111100001111110001a11011111111110111111011111111110111111111010011100001110110111111111111010a10a10111110111111111111111001111011111111111
1111111111110101011111111101111110010111a11010111001111000111011011011001111111110111111100011111111111111111111121b12a22022211022220111110112001001111110111111
1010111011111111111111111111111010101011a10110111001011011111111101111111011111110111110111001001011110111001111211a11a22211112110211102210211111110111111111111
1101111011111110111011101111111110111011a10111111111101111000111111111110011111111100110111111111110111000111110120a12a02202102121120202221012111111011111111101
1111110111111111111111111101111111110011a11110111111101110111011101110111101111100011111111111112122221221121122222b02a12202220212212220221202111110001011011111
1111111111111111111111110111111000011111a21110112212121111221202110101121111110011111110011111111222122212120122022b20a11121221110120211122101111111111111111111
1110110111111111101111111111100111111101a10202221111212222101210212111111111111111111111101110112212211001122002202b02b22220222101122220121210110110101111111011
0010101111111011001111101111111111111101a02122111111221221122121122021111111111110010101111111101221121121200211221b02b12020220111112121121201111110111011100000
0111111111011011111110111111111111110111a11111010111121112211122112202121111111111110110101101112212011221222221012b10a20122202021221022221002110101001111011111
1111110010111010111110111110111110011111a11210210210212120222212102221000001111111011111011111111121212212222211201b22b21220212012220212220021111110100100111011
1111111011111010101111111111011101111111a21110102012211001101102201222011111011010111111111111112121221022111102221b12b22002022212102212020122101111111011101111
1011111100101101101111011111001111111111a12121212120210122120001210110201011111111111101001111110211022112222102222b02b12102221010212212012221110101110111111010
1111111011111100101111011001100111111111a22101210120121211222220011212201101111010011111111111012222111122222211202b12b22110222221001221112122111111111101111111
1011110111101111111101111110101011111111a12211122222121222220222110221221101101111111110011110012221120002110011222b12b02022120001111120111222111111111111101111
1111111110111101010101111111110111111011a12100120211212021212202200222211111111110111100101111102220210211011101021b22b10022122122011111001222111110111011100111
1101111110111111111011111111111111111011a21222112212021211210210101220100011111111110111111110012220111110102222220b22b02220122202121120121220111111101101001101
1110101111011111001101111011100111111111a10100010202202220121212100122221110111111111111101101101211121000111022222b00a02120122010212212121101111111110111110110
0111011111001010111101011010111100110111a22212201001012212111101221201101011011111111111101101102112212022122021020b01b21221212211222110221020111111110111110011
1010011111111111110111011010110111011111a01221012221202211111111110101211111111001011100111101111202221212222010202b20a21222222222111022221111111111110111011111
1111111111101111100110011111011111010111a22001110112210221212222211222001101100111101111110111010110011012120221210a22b21221002102222212020221111011111111111111
1101111011001101111111011101011110111111a12122101121112200111122212121120101111111111111111111111102111110111122021a11b02220122021021020210100011011111111111111
0001110110110111111011111111010011111101a21021002021011200011102212001111101110101111101101111012212212211222122210b12b21201121210222121101222111111111111111111
1111011111111111011010111110110101101111a10121021211122220222121222211111111111011111111101101012121121010221202012b00b20222011122110111212101010011110011110110
0111111111111011011101111001111110111011a10211222111202020201012211201220101101111101111001011111111211220202212101b22b22222021011122212211201111111111111111011
1111110001111101111011101010111011101000a12022110211102201221101112211121111111111101011111111111222211011211202002b20b20222202111221210112121111110111111111111
1011110111111111011111100111011110110011a00000111111222221011211220111101110101111111111111111102200022122211112122b10a12220022100210011211112111101110101110111
1110111111011111111111111101011001111110a01122212021211210111121101110211111110110110111011011101121221222211221122b22a22202122220210110201021111011011011111110
1111111011111111111111111111101111111111a12212211112120211011121111122111011111011110111010001100222221202112212122b12b22021202212122220211012011111111011110111
1111110011111111111111011101101111011110a22222021220211220201112112012111111111110111001111011010222222221112221010b21b12021122122020110122200111011111111111010
0011011111111111111110111100011111111110a11021111112021022201211122012011110111111111111110111110121102211011011222b21b22121220221212022121111011011111011011101
1111111011111111111111111011011111111111a11221112111010012022112211011210011111111111101011111111101010022212101202a02a11011200211001201120111110111111111111111
1111101101111111101111011101101010111101a11221112021221201222212001100201011111000111111011110111122202220201110020a21b21220222101122121002220111111111110111111
1101111111101011111011111101111111011101a22222111212222221211112120202101111001010010001111111112101121212222202100b10b20111201111110001101111111011111111111100
1011111000011100111101111111100110111110a11200211221220222201211112122211110111110111111110011112011211111112200121a02b20212112111111111111110111001111110110101
1101011101111111101110111111111011111111a02200022102011221210201112222121111111110111011110110111222222210011212221b21b01221200111111111111111110111111110111111
