2 5
135 107
122 49
126 101
64 67
119 18
56 105
111 104
8 43
26 34
11111111111011111111100111111010011a101111001101011111101100111111a11111110a111111111101101111111111111111111111011111011001011111110011011111111011111111111010
10111110101111111111111111110111011a111111011111011011111100111011a11111010a110111111111111110001111111111011111111111111101111111011111011110111111011110111111
11110101111111101011011011101111100a101111110111111001111100011101a11011100a111110111110101111101011101111111110101110111111110111111111111111001111011111101111
10101101101111110111111010011111111a101111111111110011111111100111a01111110a101101110101111110111111111111100120012210102120111121111111111111111111101011101011
01111111110111101111010011100011111a110111111101101111111110011101a10101110a111110111110111101110010111110210121122222122121211011011221101100101101111010111110
11PPP011111101111101111110110100001a011101111110001110111111011011a11110111a011010101111100111110101101112111121122112102011112112112211111110111111111111010101
01111P01111110111111101111111110111a011110111111011111111111110111a11110111a100111111010110111111101100121210221111111011210112121220011111101111111110101111110
011111PP001111111111011101011111111a011111111111110111101111101110a11111111a101111101111011111111111111111122100100001021011122121221211111111101111111101010011
01111101PPPPPPP01111011111110111111a101010000011111111111011110111a11101110a011101111111111111001111111111110111221221111122221022020121110111111111111111111111
011111110010101PPPPPPPP011111111110a111111111011111111101100111101a00111110a111011111111011101111111001121221101202010101112221010001211101111111111111101011111
10111111011101111110011PP0111110011a111111011110011101111111110101a01101111a111011001100111111110111110121101021110122221122221212222111110111110110110111111111
1100111111111110000110111PPPPPPPPPPa111111111111001011111111111111a10110001a100001001100100111101111111121110002111121110212210210220201110101011101101110011111
11111011001001111101111111101110101P111111011111101111111111111111a11111111a101011111110111111010101011122222112020210111002000011021111111111111110101011111111
11110111111111111111111001111111100P111011111111011110011111001111a11100111a111101110111110111110111111111101212122101222001122121112001101111111001101101111100
11110111011111111111101101111110111P101011101111110110111111110101a10111111a011111110010111110110011111122022211122111111010121202122111111011111100111111101111
11111111011110111111111110010011001P110101011110110111111110011100a11100110a110010001110111011110111111122221111000200122020210020121211101111011111111111111111
11111111110101001110111111111011111P111011111111000111111111111110a10101111a111110010101111111011011111121211221002122221222112121111001001010010111011110111111
11111011101101111001111111111111011aPPPP00011110110011111101111111a11111111a110110110100011100111101111010111222020101111212221212001111011100110110001111101111
11111010111111111111111111001111111a1101P0111111101111111001111111a11111111a011111000111111011111100111112222220210202001211012102102021100101111110111001111100
10111101111111112110021211121002221b12011PPPP011110111110011111110a11110011a011111011111110111110011011122121111020002211122120011111111111111101100111101011011
11001101010221002221202021011022022a111221111Paaaaaaaaaaaaaaaaaaaaa10111111aaaaaaaaaaaaaaaaaaaaa1101111022222110021102202121012102122121101111111110100111101111
10110111111020222201211222121112111a0210210111P111110101101110111011111111101110101111110111111a1110111101210221121122122122222111221020111111111101111111101111
11111101101202101111020110111122012a2222211111P111110111001111111111101011111111111011111111011a1111111121121202110121021221221112212210111111111111111100111111
11111110111022112112202210210122121b1020120011P111111111111011111110110111110111111101111111111a1011110022122111212120121022012221222100110010110111011111010111
11111101100021211122210121021122210a0021221111P111111111111010110111111010011111111111111111101a1101011121112200202222201201212201201121111101011111110110111110
11110111101111212222010012001222010b0211121111P000111111111010111001111111110011010111111111111a1111101120220021001102211221022022201010111110111101110111111111
11101111011022121221222022222002212b0021221011P111011110111110111111111011101010011101111101111a1011111112122011222122101211011210210121111111001101111011110100
11111101101212211222222100221212210a2120120111P001111111111010111100011110001111111101111110100a1101001121002112222202101112211011210211110111010011111111111101
20012022212021212022221122222121221b2120221110P111111111111111110011110111111111111100111010111a1111111121202122221222022012202112001221011011111011010110111111
00111111021201222221202202220221211a2111011111P111111111111111101111111101111101101111111111111a1111111122112121210212102101102222111100111111101110111011111101
01222122212012222201220221222202221b2210121111P111011110111111101111101101111111101111110110101a1111111011122102121022211222120010120211111110011111111101011111
11211022000222221122221202112221021b1201221011P111010001111111010111111111111111111111111111111a1111011112121110100102101221120001121121111111111111111111111111
02120110011222222220000102111221021b0202011111P111101111111111101101011011111111111101111111101a1011111122221221111221212022211202210221111101111011001111111111
12211022212202202202222122210221012a1011221011P001011110111001111111111110110110111011001111111a0110011110120102022022120211102012211211110101111101001111111011
21210202010202122222222222222021121a0210121111P101101110011111011011111101101111010011111111111a1111110011012101200020112121221222121221021111101011111011001111
10101000121222022121000222110010121a1122121111P001010111111101010101011101101111111011111111111a1111101110120221121222112020002010121220211110111011011111110011
01012212202222210212212212221200112b2111221111P001111100111001111011111111111111111011111100111a1101111111111021210211222100000201211002120011111111111110111111
22112220210222220121220212220021120a1011220111P111111011111111100011111011111111111111111010111a1111111111112021220210021111211212201010110101111111111111101111
22220211211212212022200120222221222b1102211110P101111011101011101111111100111101111111111111100a1111111011010210111021122112222001211210201111011111111111101000
01022122011102022202111021221122111a1122001111P111111101110011011011110110101111010111111111101a1111001110112222112001202111022121221202211111111111111111111111
21122200211112022220122222212111121a1122211101P110111111011111111110100111111110011111111111111a1111111101121221101111210101111202112221221101111111111111110101
22221011211222002222022222221222101a1211221111P110111111100000111110111111101111111101011111111a1101011110111011121020202011212002112112201111101111111101100111
11222122201122022202020211012211002b2201221111P011011101111111111001110110111111000101111101110a1111011101111012212220211111100101001001011111111101111111011111
11022022122220112002102220201220002b2201110001P101101100101101111011111010101111011101111111110a0111110111022120101202201102120101020222201110111011011001111011
01122001121020200111202212222121211a2220211111P111011111010111111110011101100111111111111011111a1101111111102202202222121022212211121120211111111111111111111110
11020021112022222222220221222212120b2111111111P111111001111011111001111011111111001111110110111a1110110111122211111221222122021011201111211101111111111011101011
20011222122202222222221102122201112b1021221111P110110111100111111111111010111111011111111110110a0111111111111122122211222011000122111021201111011111111111101110
01121011222022221021220020222222222b1222121111P111111111101111111011011111111111111101011111010a0111011111021121222021222111200002200210121110011100111111111111
21221212212202222200222122000201212b2022101111P111111011101110111111110101011011101111111111111a1111111011121010211212122022101101122002120011111111101111111001
11120022212222212120222020120222012a1012110111P111111111111011111111111101111101111111111111111a1111111011002220112122121112112102212222221111011011111011110111
12202100012200202211111010121120101a1011111101P111011111111111111110101100111111110111011111111a1001111111122101111010221201021201021122221111111110111111011111
11020122211212220120201211022021111a1111011101P101110101111011011111111111111110110010111111001a1101111110001222111021122122212201121012111110111111111111110001
12212100121221211122111000101011110a1110110011P011210211002121111221021211221222011111011111100a1111111111111021112210112102122001120221201110100111111100111111
12222222200012022012122210111011111a1011111001P111122022021120111000221011212122101111111101100a0011111110111002122222212012021122012102001111101100111101101111
21101211211220111211111222220220111a1110111110P112220211221221002010001202202211110011011101111a0111111111010211221212121211121102102101111111111110101101110010
22201021022201121021000120022210101a1101111110P112222211022112211022212222220110111111111111010a1101111101111101021112210101002112211200211111111111111001111111
20121112012221222212222111222211111a1111010111P110200122121210111121221211222022101111111111111a1010101111012112222120222211212200212222121111111000110111101111
10221111222000012210221112212101111a1101111011P011222122201021112221222222111122111111111011111a1111111011112220112221212211221211122022121110111111110110110111
01210112002012211010221020101220110a1011101111P112211221212201221202222222221211111111011111111a0111101110122011020121121201222121220202221101111111111111111111
11010110111011111110111111111111111a1111111111P102011111222121021111211121111212111111111111111a1011100111122022112211011211222022222022011011101101011111111101
111011110111111aaaaaaaaaaaaaaaaaaaaa0111111111P112012210121112111220112111111110111111111001111aaaaaaaaaaaaaabaaaabbbaaaaabaaabbaabbabaaaaaaaaaaaaaaaaaaaaaa1101
111111110111011a101111101111111111101111111111P012112222121222211111211112211211111111111110110111111010111210022220112001201211202111121101111111111111111a1101
111111010111101a011111111101001110001111011110P111120100102201201112112100021101111111010111111111011111111221001211212021201220211121110011111111001101110a1110
101101111111111a101111111010011111011110101111P110121011110211121112102021221120111011111011111100101111110120211110020122222020122111222211101110111111111a1111
111111111100101a101111111111110111101111111111P110212220110122221111121212120211111111111001111111110011111121102212110112121110221001111201111110111111010a0011
111111011111111a111110111111111101110111110111P112202110211020220121120102100120101101010110111111111001111111111110011111101111110110110111111111111111001a0110
110111111111110a111100111111111101001111010110P111012010222112211201102220111012110111111110111110111011111111111101101010011111011101111011010111110110101a1111
111110101111111a011111100111111111111111011010P101222102101222120011011100221022110111111111011011000001101111100111011101111110111111111111111011111101111a0111
000111111111110a010111111111111111011111111111P111012022111102122112221010211222111111111111001111111111111111000011111101111010111111111111111111101111111a0111
011011111011111a111111111100011111111111110111P011112201120201022122211202111012110111011111111010111101111111101101001111101101111101111111111110111111110a1111
111111111110111a111110011111111111110100110111P000101210112211122021220211122202101111111110111111111101111110111111110111101111111101110110101111011101111a1011
110111100111111a111011111110010011100011011011P111222002222210000022201122111110011111111111110001111011101011100111110111111111101110010110011111111111111a0110
111111110011010a111011011101111111111110101011P112102012121111122011111012111012111111111111011111100110111101111011011011111111111011111111111111011101111a1010
111111011001011a111011111111110111110111110101P002122021202101221111120212222212101000101110111011101111111110111111011111111111011111101111101101101111011a0111
010011111101011a111111101111011110111011111100P112221121212002012110121002022021101011111101111111101101111111011101111111101111111111111111111111111111101a0111
110111110111100a110011111111110111111111111011P111011221020112111211122121100211010111111111111011111110111111111110111111111111010111111111001101101110110a1111
110011111111111a011110111011111111111111111000P112211122120120101221122211112121101111111111110011111111111011111110110111110111011011111100111110110110101a1100
111111011010111a111111111111110111011111111011P112221202211012210012221101111212111101011101100111111110111111011111111111111111110111111011110110011111111a1011
011101011001101a111111111111111101101111111111P110210202222210012211011022212011111111111111110111101101011111111111111110111111011011011101001011011001111a1101
111001111011110a110110111011111111011111111111P110211022220021101210211212120121111111111110101111110111111111110111110111111110111001010111111111011101101a1110
111110111101111a111001111111011011011110111111P101211122221100122202000122112222111111111111111011111111101001101111101111111111111101111111011111111011000aaaaa
010110110111111a111011111111101100110111101011P10111012212222112012121201012000201111111011111111110111111111101111111101111111111111110111101111111101111101111
111111101011111a111101111011111111111101100000P11221111211121102022111022220220111111111111101101111100111111111011111111111111110111011111111111111111111111011
111111111110111a110111110111010111111111110111P11111111111111011111111111110110110111110111111110111111011111011111110111111101111111011101111111101101110111010
101101110011101a111111110101111110110010111111P11111110011111111011011101111110111111011111001010111011001111011101111110111101100101110111011011111111111100111
111011110111111a010001111101111111101110111101P11101011101111111111110111111111101011110110010101111111111001101111100111100111011011001101111101111001110111010
101101111111011a111111110111111111110011111101P11010111011101111101111111111000111110111001111111101101111111100220101222201211222102112022011011101111111111111
101111111111101a111111011111111111011010101110P01101011111111101011111110111110111111111010110011101111111110102010012112202100121112221011211111101011111011101
111111110110101a100100111111001111111101000001P11110111111001110PPPPPP001111011011110111111110111110111110001001210211011022122221120200202001111111101111011111
111110111111111a101111111101111111110111011011aPPPPPPPPPPPPPPPPP011101PP1111111111111111011111111022111122012222222121222212222022210112210021111111111011111011
111111110001111a101010111111011110010110111120a2012212022101122111022120P110111110010101111001111121112122112112212020221222221010012101020212011111100101110111
100111111101111a111111111111101110111110110122a1212012211122210112120212P110111011111011111111112022122120212122222020210102202011211022212212111111111110111001
110111011111111a011101111111111111111111121122a2221122121220112112020120P111101100001110101011100222221121110122121020222022220121210110221211111110110111111110
110010100111110a111111111111110101111111001212a1222102202202002120222021P011011001111111111111112211210211121121212112112022210121121220122122110001111101110100
011011011011111a111011111111011111011101101110b21212101121001110020011021P11011111101111111111111202212222200222221122220022222120121221201210111110101111101101
111111111111111a111110111111111111111111010210a112121112102220100111200211P1011111111100110111111121222122111212212210022220212012200212221221111110111101101111
111110111011101a110111101110111101110111112012a2200222120220222111222121011P110011100010110111112222222120222112222212201220022212212010110102011000101011100110
110011111111111a111111001111011111111111101211b11111221111122022211022001110P11111111011111011101101120212120212121022022202012202210200001211111111111111111101
111011111110111a111011110111111100111001101012b010021112111210102212112111110P1101101111111110102002221112222202022201112212122212022121001112010111111101001111
111111111011111a101111111001111011111101112200b110101220022211112211001111111aPPPPPPPPPPPPPPPPPPPPPPPPPPPPPPPPPPPPPPPPPPPPPPPPPPPPPPPPPPPbbaaaaaaaaaaaaaaaaaaaaa
110101111111111a111111101111011111111110111212a221120210222221211221222210110a11111011110101111111020222220212222220221122022211110200021P2120111111111111110111
111110111111111a111110101111111111100110111111b120200222010102102010121111101a11111111011110010110101211221020122220011022212212222021122P2122111111111111101101
111111111111011a101111110111110101111111122220a210112002222202212200010211111a11011111101111101121222122200221111120121222002212222102221P0001011111111001111111
111110111101111a111011111011111111110111111212b120020011110112002211211000111a10111111111011011110220220221102222220112020222212221220221P2121101101111011011111
011100111111011a011111011111001111101110021101b122222222021221112211221210111a00111101111101101112122102211212022202112022202020102122221P2110101100101100111111
110110111111111a110101111101011011100110121211a212212221121210211200112011111a11111011111111110121011002211000200211222120102112220011122P0012110111111011111010
011110011100111a011111011111101101111111000110b222022111012112211212121211111a11011011101111110102111222122022212012121202202200112220222P1212111110111111111111
111111111101111a101111110101111111101011021021a220022120111112120121220211111a111011111111111110111112121122012222021222222222222202211PP12221011000011110010110
111001110011111a111101111111111110101111110121a111010101121120012111222101011a1101100111101111112112122102111211200221202221211212101220121112010101111011100001
010001111111101a111111011111111111111110022211a111211111001012120211221010111a0111111111111111110220222111102110221222222121020002121121212010111111110101011011
111101101111111a011111110101111011111101112012a121212011210221021022202211111a1111001111111110111122121122211112222221221222021111012212212202110110111101111111
111100101111011a001111111011111101101111121211b211022122120211111210111101111a1111101111011011101221202121211112012222212222222101021022221122111111110101001111
100011111111101a110101111111111111111000111111a021112010201211221121020211111a1111100011111111111211102201111221222012212222111122112122122122111111111111111111
111111111011101a111111111111111111110101111010a110122120221122022212212111101a1111110111111111111100102222021112222202212102120222202201012111111110111111111111
111111110110111a111000111110111101001010021011b112220101022212221222102011101a0100101111111111112112222221010111222212002221022101111021122102111111011111111110
101101101111001a111010100111111111011110022122b112212210212212012112221011111a1111110111111111011220202121112211220121012002221210120122011212101111110101111101
011111011111100a111111111101111111011011111210a211222222201122200110112111010a1111111011111111110000112222120222221221021211201022110121211020110111111101111101
111111011110111a111101111111110111100010112112a221222020212122021212012211111a1100100111011111112121220122021122221211211211011111111011101011111111110101111000
110011011111010a111111111111110111100100110122a102122022221112220102111111101a1111011010111000112122010222111110120121102210122110111111111011101011110111011111
111100011111111a111111111101111111101110011021a222122021110111222101022011100a1111011110111101102212012211211211212122121021110111111100111111111011111111111111
