154 76
1 82
122 49
126 101
64 67
119 18
56 105
111 104
8 43
26 34

1110011101110011111100110111110110010111101111101011111a10110110111111111010111011011111100111101101111011111011111011101101111011010111111111111110111011111111
1111011111101111111111111010110111101110111011110111111a11111101111100011110110111110111111101111110111101110101111111100011011010010110111111111111111111110111
1111111111111111111010110111100010111011110100111001010a11111011111111101111111100111101101111010110100110111110101111010111101111111111110111011011101111111101
1111111111101111011101111101011111111110111101101011001a01010111011101010111101111101011011101111110111012012212012022112112102122022221011110110111011101111110
1111001110111011111111011111111111110111110110110110111a11100111111111011111110011101101111111101100111100201101111220211100101211111121111110111111111111110111
1111111111111111110111111011110111100011001111101111101a10111011101111101111111100111111011110111111101112221212222210211120022222211101111101010011111011011011
1111100001111111110110100011111111110011010111110110111a00110111111110011111111111111111101111011101111022020120202001110120211201220211110010111111111111110011
0111101111110011111111111101111111111111111011101011011a11111111001111101110110101111000010111101110111102202222112102221012121112211221111111111101111111011111
1111010111111111111110100101111110111111111111111101111a01111111111111111111011111100111111111111011111101111022112122121101101120212100110100111010101011111010
1111101111011111111011111111101111111111111011011111011a111101011101111111110101aaaaaaaaaaaaaaaaaaaaaaaabbaabbaaaaabbbbbbbaabbbaaababbaaaaaaaaaaaaaaaaaaaaaaaaaa
1110111111111111111100111011111110111110011111111111101a111011111101101011111101a1111110111010111111111120111122202211121222012022221220111110111111111101111010
1110101111110111111101111101111111111010111111111111111a110110111111101111110111a0111111011001011111111022220100021220121221222120011221111111111001110111111110
1111101111111111101101111111111111110111111111111101111a011111011101111101011111a0111101100001110111011112222212212020110221220221221211111111111001111111111111
1111111111111011101001110111111111111101110110111101110a001111110110111111101111a0101111011110111111011122111021210102012221201112001111111111111111110101111111
1111111101001011110101100011111011011101111111011011110a001101111111111111111101a1111110111011001111011112221201111122022010220111112210101111111111100101111101
0011111111111101110110101111111101111111100101111111111a101111011111111111101011a0111111111101111111111122021112222121211211221122121011101111101111111011111111
0101011111000101111101111111100110011111101101011111101a101111101111011011110111a1111111011101111111111121022112112211212101201122010121100111110011111010111111
1111111101101111001111101111111110111111100111111101011a110111110111111111111111a1011111111111111100110111220221100122121122112221210001001111110001111111111111
0111111101111011111111011111111001010111111111111111111a001101111111011101111111a0111101111101110110110111210211021101202222212121201211011111111111110111011101
1101111110002122120112101221010112122220120010011111101a101110110111111111111101a1111111111111111010111112111222011221111122122122121201011111010011111111111101
1111111001122221101121121121201112122202111111110111011aaaaaaaaaaaaaaaaaaaaa1111a0111110111101101111101010110111122001010221011222101211111011011101011111011101
111111111111221122121211221101011221121121110111111111111110111101110010101a1101a1111111110111111110010101111111112011211221121121220221011100111111111011101111
111110111010121112200221200001222212121121111111111011111111111111101111111a1111a1111111110111111101011011212100112202222212122222122111111111110001111101111011
001011011112222112122121102212212211122200101111111111111111111111101010101a1101a1111111110011110011111012121021122121221122012212011111011111111111111111111111
111011110110111112112201201212110011212110111111011110111111011111111001111a1011a1110110110111111111111002212221112210112122011222121211111110111111111111111111
111111111012200212221111222222122021211021110111101110111111111110110101111a0111a1011011111111011101011122210121211012210222102211111110111111111011011111110101
011111101102022211210211220122222202110121110010110111111110111110111111111a0111a0101100011111111100111111011111221102001211110111212121111101101111111111111111
111001011110202211021010221022012221011102111101011111111111101011011011111a1111a1111111011111101101111122201111121122112211121102212111111111011011111110100001
212212122120021222222220220120212122012011111111111111111111101111111101111a0111a1111111011011111111111112121121222011100222112122112121101111111011101100111111
011101122211112122222111222021102022212001101011111111111111111011111111111a1110a1111111111011111111111122211012112002222111101211222120110111110101111111010100
122121212102222112220212022222220221010111110111111110111111111110111011101a1111a1111011110101110110101111222012212122221122020212121211011111110111001111111111
220121022021121220100020222212221202011111011111111100111111111001111111111a1011a1111101010111011111011010212101122201202222220020121221110111111111111110111111
212220012111022221221202222211220100220111111011111101111110111110101111101a1111a1101011111111110111111112202221011111110201122222000011001100111111111111111111
221101220102222122002021211222110201121112111101111111101111110111111111111a0111a1110011111111001111111100220112001201122120011021122220110011111011111101110110
221011122012220221222212022212112121112012111111111011111111111111110111111a1000a0011111111011111111101011111101111012201100111122220222221110111111111111111111
211120220102122211222102222212101111102021111110011010111110101111111001101a1100a1101111111011101111010110110111021110220102200222111222011aaaaaaaaaaaaaaaaaaaaa
012100212012101202222121122200111110110221111111111111111011101101110101101a1111a1101001111111011110000111102212210122211101210211022111101a11111000111011111101
122121122221222220222221220222112001121210110011111111111111101101010111110a1111a1101111111101011111111111121122212102120121221122111111021a01011000111111011010
222112111121121002220122222002111212201001111111111011011111101011111111111a1011a1101111111011000111111101101211100221222121212122101211011a10110011111111111111
012122222202122012121220202222210120111211110111110111011011111111110111111a1111a1001110111100111111011111012122112221101012202222021221000a11111011110011111111
abbaaaabaaaaabaabbbbbbbbbbbababbaaaabbbabbaaaaaaaaaaaaaaaaaaaaaaaaaaaaaaaaaa1011a1011011101111111111111111011121101112121211102111122220211a11111111111011101110
11112011012011211212212201202222200210222111000011101111111111101110110110111111a1110101111111111101110101122122120012211211202211012102111a11111101111101011110
01111220202120002212001001210020211000122111111011100111011111111111101110111111a1100111111101010111111111111022212222201221120102222022121a11110111110111011111
20212121010212121022022212222222122110112211110111111101111011011111111110111011a0111111011111110111111111102010122222121222101121111222111a10111010011110111011
11210220210120212112222222222010122212112111011111111110011111011111111111101111a1100111111111111101100111111111022101201202012220000110101a01111111111001111101
12010120121021120222202220022002221122020111111101111011101101111010111111111111a1111111111111111111011111122120111111022121122022110110211a11111111111011111001
22022121102221202222222100012020122112102211111111110111110110111000011111111111a0111111111101011011111110112012220201201212111211000220211a11111111111111111010
22002221111122222221212222000221102100122110111111111101111011101111011101111111a1111111011111011111111111121102201220201111110112022102221a11111101101111111111
11201210102212222020021212220202211101212211111111110111111111111111110001010111a1111111100111110111111010122122112202022211222022110110221a11111110110111111111
01222120101122222000222212222212212211010110110101111111110111110000111111111101a1111111110111111111111111112121210212102012211202011212121a01111011111110110101
22222201010200221221220200122111111111101101010111111111101110110111011111011101a1001011111111111001111001101201222120111012221022201020221a11111010111101111011
21212211001121212101011001002211010011001011111111101101111101111111111111111111a1111111110111111111101011111002112201220201111210001011221a01011001111110100111
20221211211222211020122111112221111111111111010112111210201101222102100221111202a1111111110111110101111100122021122200212121220010221112211a11101111111111111111
11100001002101111111211101122111101011111111011112211101111121212012222212112112a1100110101111111001111111100121221121111222210112111011011a11101111101111111111
21220101122021212222100212122111001101111111111011212110111122021121011002010211a1111111100001111110111111102211101112112212202212120022021a11111110011111011101
11122121010100201210121121021010101111111111111112110102221221112211020101012221a1111110101111111110111111022002122002121110221112111222120a10111111111111101011
02212012222122221010222122102110111111111111111111121022121221101221210011112111a1110111111111111111010111111221011101012011012212121222121a11111011011110111011
12002111022012211112202211211021100111010111111111212110220222120021212222200122a1111111111110110110111110000022222111220011012020021111211a10111011111101111001
21021121111121222121122012022121010111111101101100111222111121211101022102211121a1111111011111111111110111111011111002212112022221212000021a11111111111110111110
11011101111111111011111111101111110111111101111012112221002110022200120202102011a1011111101101111110011110122222222112212012202022121001001a01110001111111111111
11011110010111011111111100110010001110011111110111121110220221211212200212212112a1101111100011111101101111122100211111221121202120012221101a10101110110111111111
11011111110111100110011001111010011111111111111102211111011011112211121222111211a1111111100111011111111011121222212220221220112202010210220a11011111111111111110
11111011111010100111101110111011101011111001101112212221111112111222221221210112a1111111111110101111111111111200102002212212021121221222220a10011111111111111111
11101111110010111111110100110101011111111111111111212111111210110221120222211212a1000111100111111111111011111221022120022210100122121212111a10111111111111111101
11101111111111101110110111011111110000101111110102202210221011111111220220212012a1111111111111110111111010101212221212112121112000122210221a01111000111011111101
11111100111010011101011111110101011111111111110012112100112122220112102021202220a1110111110111111100111110111111111111101110111110100111110a11111101101011111111
10111111110101111011101111111111101111010110100110221012222021122212222121102010a0111110101101011101111111111101001101001110111101111101110a00111111111110111001
11011011101110111111110111111110110110111100111012202121112111121210011111101121a0111101101011111011111111111111111111011110011111111011111a11111111110111111111
11110101111111111111110111110111110011111111111010110200202221220121111001112021a1111111000100111111111011111111101111111111111111111110010a10101101101111111011
aaaaaaaaaaaaaaaaaaaaaaaaaaaaaaaaaaaaaaaaaaaaaaaaaabbabbbabbaabbbbbbabaaaaabbabaaa1111111101111111111101111111111111111111011111111111111011a10111111111111111111
1111111101110111111111111111101111111010110111111212222121112122212222111122101111110111111111111001111101111101100111011111111111001111110a00111111111011011111
1111111010110001111111110111100110110110111000111201101220211121021221122111112111011101111110111111011110111101111101111101101111011100111a01110111010111111111
1011110111111111111101110011011111111111100110111101222122011110122211110201222011011111001111111111011110111010111001011111111111110111101a11000111111001111111
1001101111110101111111011111111111111111011011111112111212101111102112102001122111101111111111111110111101111111111101111111011111111110111a10110110111111111111
1111111111110111101011101111110110111111111101111211111111000110212112112121111211110101101111100111111101011111111100111111111111111111011a11111001111011111111
1111111111111110111111111111111110010101111111111010002110221211012101212222012211111111111100111111011001111111111011111111100110011011111a01111111110101011111
1111111111111001111111101111111111111110111111011112112220022111211122011201221111111111011111111111101111110111111110111010111110101101101a11111011110111010101
1111110110011111111110111100001111011110110111101222212101121220210011210220102211111111111111110111111101001011011001111011111001111111111a11110111111111111111
1111111000100110111011111111110110000111111111111221112002102212011212212202101111111010111111101111111111010010011111111111011110111100111a11101111101111110111
1111101111110111111111001111111111111111111111011111120201212001211211222112112110111111011111111001111111111110101111101100111111011011011a11011011101011111011
1111111111011110110100101111101111101111101110100111212212121201011012012200222011111111101111010010111111111111110111111111111111110111110a01100111011111101110
1111100001001111110111111111011111101111111101100222111011211111221020222120211111110101011111111111011110111111010011111111011101011110111a10011000111100111100
1111110111111101111111011111101101110001101111111002122022011221002201100221201111111111111110101111111011111101111111110111111111111101111a11111001111111111001
1111111011111111111110101101111110011111110110111100011111111110011111110111101110101111111111110111111111111111101111110111101111111011101a11011111001011111111
1111101111110111010100001111110111010111101000111011111100111110110111111111111011101101111111111111011111111011111111111111111011111101110a11111111111111011101
0110001111111111111111011000111110001111101110111101110011111011010111010111011110110011111001111111111111100111111110011101110111111111111a11110110011110011101
0110011011101101001111111101011110011011111111101011111111111111111111111110011110111010101111101011110101101112221112200201201222122121122a20111111111110111100
1111111111000111111101111111100111110110111111110111111100110110111111110111111111010111010011101110111111101111211111222212120220121101101a21111011111101111010
1111111011111111010110110011110101101111111011011011101101111111111101110111111111111110101111110101010111100100002202102221121121120121020a22100111111111111101
1111101010111101111110111111111111111111111110110110111110011110111011111110111010111101011111112111120211212002200022010121211212111022001b20111110111111111111
0001111011011110111111111111111111110011021022012100111122022022221112221111111100110111110111110202222112021122212122122222221121210022121b12111111111111111110
1111100110111111011111111100111111111111111111112111011221221220201220220101111111111011111111111212221111020122222022012200202020110102201a12000000111111111011
0101100111111110111111111110110111011001102111212112001212200111010121101111101111111111110000110110211101212211221222100221211112012222102b11011010110111111111
1011111111101111111110111111110110100100002012221122102221111220221100220111111110111111111101011222121210222100202222020011021112001201121b21111110111111001111
1101101110111101011010101111101101111101120121111212111212000221121112220111101110011111110111112201210211012212222121101201022121101112201a20100100101110111110
111011101111001111111010011111111001101aaaabbbabaabaabaabaaaaaaababbaaabaaaaaaaaaaaaaaaaaaaaaaaaaabbabaababbbababbaabbaabbaabaabaaaaaaabaaaa00111110111101111111
111111000010111100011111111111111100101a100221102112220101101101122211211101110111111111010111112122211121100012210222222122012102112021012221111111011011110111
111110111111110110111101101111111111111a101110010212202122022212111202221001111aaaaaaaaaaaaaaaaaaabbaaabbabbaababbbbbaaaaabbbabaababbbbaaabaabaaaaaaaaaaaaaaaaaa
111111111111011111110011001101111111111a101011012221101121210111002111121010110a11010111111111102202201210021122112221020222120111121221201201110111111110111101
111011110011110011111010110101010111101a120212021111201122202122111122201111010a11111101111111102212121021111202210222222202210120002111112221100101110101010011
111111111101111011111111111111000111101a111012021212211222112202211222001111101a11111110011111110112212222212201202221102000200021111221211121111111111111111011
111111101111111100111101111111111111111a020002122220202212010011221110021110111a10110111111111112222220122122111200222221212211121000122200121111111111111100000
111111111010101111110111111011111111110a001222120212202112111122212222210011111a11110101111111111200202221202210012222210122220212211021122210111111111111110101
110111101101101111101011001111111101111a121020121021211212210221110121111110111a00110101111111012212120102111022100220221122212110011110102210100011110110001111
111111111111111011111101111111101101111a101111101122122122201221000112210111010a11011110110111102122221111201012121222221122102120121121212222111111101111110110
010111111111111111011111111111001111110a122112112111121120221222112221101111110a01110011100111101010021120210122222221222020220211021121122221111011111111111111
111011111111110000111111101111010111111a022022211111122201201122111122120111111a00110010101111111212102121112110221022222222202002211210121212110101100110111111
111111111111110011111111101110111110111a120212011121002222011202021222111011111a11110111110100102122011101112212020022222112120002011122110111101111111111110110
111111010110111111111101111001111111111a121111111021120222222212011002001111011a01111111110001110202221211111112202222202202222012112122210011111111111111100111
111101111111111111111110101111111111101a122120011110122122111020202002111011111a01111111111111111111012210120220222020221222202212121222102100111010111110110110
101001111111110110111111101111111011111a120022221012011122022211111122111101001a11011111111110111110121122121110212202020122221001011222121101101101111111111111
011101101001111111111101011110110101100a111021111221221001122111121012011001111a01111110101001112211121202112122002121222222120102211212100222111011111111011111
111111111011111100110111110011101111111a110211011121122122201211222211221111111a01111101110100112122101021011200022222211221202222121200122222101001110111111101
111101111111110011011111111111111101111a120211210000111220211212210211211110111a11111101111001112112200111212011122022200122100002012120022211111111111011111111
001010011101111110110111111110101101110a021202020222001222020120210221211111111a11010010111110012120121110111022120210202122022222011002112011111001101100010001
111111111110111111010111111111111111111a112102122120021111202222122111201111101a11011011101111111021221101112200012222220222012001121120011111111001001111110011
111100110111101101011111100111111111111a102212002122100101120111021121210101111a11101000101111110120110221221122121201201222211000102221022210011110011011110011
111111110111101111111111110111011001111a122022221121221110102212121120100111110a11101101011100111122012022202112111111011122222111100111111110110101110101111111
110011111111110110111111111110110111111a112222211212021212121111112100111111101a11111111111010111110201220111121220112122121001111111011011111111011111110011011
110111110111000111101111111110011111111a002111111212221020121211021122211011101a11111111111111111211202122211202221010111002212111111111111111010011101111011111
