153 13
130 109
122 49
126 101
64 67
119 18
56 105
111 104
8 43
26 34

111111111111101101111111111011111101110111111111101010101111a1a111101111110111111111110110011011111011a011100111011110101101101101111111110111000010101110110111
111101011111111110110111111010111111111011111101111101101101a1a101111111111010111111111011011101110111a111010111101011010111111111111111101101100101111101111111
111111111100111111111111111111001011111111111111111111111111a1a110111011111110101111011011110111101110a001111110110011111111111110111111011001101111101100100111
111111011110111111110101111111101101101111111111111111111011a1a111110111111111011111110101111011111001a101011221100000111011011112122110011111111111011111111111
001111111011111111101111111111011111111100111111111101111111a1a011001111101110111111111011101101111111a111211122210222221020212122121001111101010100111110111111
111111100110111011111101011111111111110101111111111111011011a0a110111110111111111111101111110111111111a012110122111001212102210121102111001101111011111101111110
011011110111111100111111100111010110111111111111101111111111a1a111111111111111111111111010011101110111a122212211221011100222122211211201110111111111111011111111
001111111111111111101111110111111111110111111111101111011011a1a111001111111111111111111011011111111101a120222201111022112011022211121201101010110001111101101111
111111111111111111111111110111011111110111101111111101111011a1a101111111110101111111111111111101011111a020220202212211100112202121220021111111110111111111111111
010111111111101111111111011101110101011111111111110011111110a0a101011110101111111011101111110111111010a120021221212012022211201001220110111111001001111111101111
010101100111110111110111111111111111101110110111111011110111a0a111111111111111111100011111010010111111a001102122111212122221202202112011111011011111011111100001
110111110111110011111111101111111111110101111111111011111110a0a111111101011111110011111101111111101010a122111212121201202112211122111121111011110000111111111100
110111111010011011101111101111111110111111110101111101110110a1a111110111111111110111111111011111111110a112101022120211210122110212111101111111001111111111110011
110111111111011111011111011111111111100111111111100011111111a1a011110111111101111110110101111111011011a122001112211122011101100122121101011111001111111110110111
111110111111111101110110111011111111111111101111111101111111a1a101100110101111111111111110101011111101a110122221022222122111112211122121111111111110111110011111
111110111110111111111110111101110100111111111111111110111011a0a111101111110110111111111011011110011111a121122021122221111110111002121121111010110111011111100011
110111111111101111111111011111111111011001111110101101110111a1a110111111111110111111111011111101111111a011221210221211112010121222120121111111111011101101111110
111111011111110111111111010110111001111111100111001111111101a1a111110011111111110011101111110111110110a111112122212021021210221121201211010111111111101111101110
111011111001111111111110011111111011111010111111111111110011a1a110111101011111111110111111101110101111a121120011120222211222111221120221111101111111011111111111
110001101112122102021212201121020112021112101001111111111100a1a111111101111111111111011111011111111111a102101121211101222101112111212121101111111110110011111011
101111110101211201202222222200210111112211111011111101101111a1a110111111110011111111111111111111100110a111200201112110102222012221012221111111100011101111111111
101101110102021121011211212101102110110101111111111111011111a1a111101111110110011111111111110110111110a121212222200011110101222122201120011111011111111001001111
1011011111122210121221221212111221012020abaaaaaaaaaaaaaaaaaaa1a101111001101100111111111111111110011001a102221000121112212010202011012210111111111011101111111111
0111111101122122201212011212112112212022a211100011111001101111a111011011110111111110111110110101111111a122110210000220212221201022020021100110111111111110111111
1111011101122121100220121121112121201212b101111011111111011111a111111111110101111111111111111110110111a122212222200012121100111220122021111111111011101011111111
0001110101121222220211112000101222102022a111100111111101010111a010111111011111010110001011110101111111a121211211222211221212212012121111111110111111011111110101
1111110111122121102211011212221120222101a111001111111111111011a111111101101111111111110111110101111111a011102022110012220120002121121221010110111111101111011011
0111100110112122112110110111122222012221a010111111101111111011a111111011101101101111011111111001111101a022100121101121122212022221201121111011101111101111111001
1120011111211222202222201222002212202110b111011111111111110101a011111111111111111111111111101111111011a121221002221220121221220112222121111111110111111101111110
1122011100002022212020202222112221110100a211000111101101111111a111111011001011111111011001010111101110a120122100002121102111112202112221111111101111111111101111
2012112222221022212010022020202121222101b210111111100011011100a111111111110000111110110111101110111110a111122121102120112102112210201011111111110101011110111011
2221211101210222121110020002212112121101b101111111101101111100a111111111110111111110110111110001110111a121111112012222101201222201222220111111011111010101111111
2202121221100122221001201222122222120211a101111111101101111111a011111101111111111100011011001111111111a021222221212112212121201121212220011111111111111101011111
1112101210022122221122220002222112112100b211110100111111111110a111111011111011111111000111111011111010a111012120111202202221111122202111111111111101101101111111
2102110202020112101212122222221210111211b101111111110111111111a110111111111101111010111101110110001110a111111022001022122111112212221010220111110010111111100111
2122202201222122112222202012222210222122b111111010011011111011a111110010111010111111101010011111111111a111011122122201002222111021201120101101111101111101101100
0112221000112122202222020220022112022101b111101001111111111111a111110111101111110101001111111111111111a110112212221112002122211222100211121101111011111111011101
1222202021122022020201212120220121010202b110110111111111110111a001111111101110111101101111111111100110a111122212112110212020111200121221120110111111110110010111
2001212122222122121211212222022112110211a211101111110111111111a011111001111111110001011111111111010111a1110011122221200aababaaabaababbbbaaaa11110111110111111110
2101002212100212221122222222022222211012b211111111110111111111a110111111011110110111101111111011111111a1011121111000110b1222000122122221111a01111111001111111111
2102011200112211222020212022222211212101b111110111100111111111aaaaaaaaaaaaaaaaaaaaaaaaaaaaaaaaaaaaaaaaa1001211212220221b1202112221202021121a11101111111100110111
2022002012221102000202222222020210111012a201110111011111111111101011110011011111111111011110111111011110010111011010211a1122212122002122111a11110111110111101110
abbbbbbbababbbbabbbbabbbbbbbabbbbaaabaaab211111111110001111011110011111111110111101111110111001111111111101122212100121b0111001122122122211a11111111111111011110
10002211121002222222222020220121211111012211111111011111111011111111111111101011101111101100111010111100111112210011212a0101111211112211211a11010101111111100111
01111212212010222122022112122122211122220211111111101110111101011111111111111111101110011111111111111101111212220021111b0211002021012020220a11111110111111011001
21201012121210011221022122222210121210111011111111111101100011111111111111011111111110110110111101111111111121101210120a1200121202211211010a11110011010111111111
22111111020212122120221221222120101211121011101110011110100111111101111111111111110110011101101111111110010100012211121a1212121201120211021a11111101011101011101
02122221111222122221110102210221110122221100011111111001100110111111011110011111111111101110110111111100110101202101020b1122112112122211111a11011111111110011111
11010211021222221002111222221222212112111211111111111110011101111110111101111111111101010111111110111111010211222012101a1212122100202222221a01111100111111101111
11111011122002221220222221012102211102120111111111111100111111111110111001111011110111111011111010110111111020100120112b2021201222121101111a01111111110010011111
11202202110012120012201121112100010111111111111100011111001111111101111011111110110111111111111111101100100010112122221a1111212202212221121a10111111110101011111
22011001120112210121210221222101011011101110111101110011111101011101110111011111111111111100011001111111111112220102211b2122202121222120211a11101111111011111111
22012222210110111202112120111220011011100111110111211222202011211102121122122212011111111101111111110111111121011212211b2011111111112112111a11111111111101111111
02021211110201221221210221022201111111110111111110111121001110112112001110122120110111111111111111010111111211111201122b1210220100111220221a00110110111111001001
12202212021202211022210022020111110010111111011011122121102222211200002111212121011001101111111111011111011222100120112b1211221011022022101a11110111111000111111
10112112112001211121102111000220111111110111111112101110211001122121222212202121111010111111111011111111111121121112122b1222010202121020221a11101101111111000111
11222212100010212220111120011001111011001110110112022001100010201220002202122122100111100101110101111110111211001210210a1121210201012112221a10111110111011111111
10112112201220202121122122112220011110101111101112211222112211110211101212222222111110110011100101110111111121101112120b1221201222210201221a11111110101010111011
21021121211120211002221220112001010110001111111110010112122201022211221200102221111110011111111010111111111112212100221b1101022211202112121a11111011011011111111
10111011011111111101111111101100111111101011110111111121111011100221212110121002111111011011110111111111111121011112201a1222121022112221011a11110110111111111111
11111111001101111110010001010011101111111101111111112112010222012210002120112221110110111111111111111110110222212220221b1211111110121212020a11101111110101111111
11111111111111110111011011111111111110111111101111111212012222201221212012110101111010110100110111001111111112121211112b0012222112111210111a11111111100111111111
10110101111111010111111110111111101111110000110010122021112112211221011212220110010111101111111011111101101201122122120a1011222021111201120a01110001111110111101
11100111111111111111110111101011111111111111101111211211100110110202221221112012111111111111110011110111101202222101101b2221101201011011110a11100011111100111101
11111111111111111110101110111011011111001111111112111011121111112022210210212100111101111100111100111111111110121221122a0112221122221212221a11111111110111111110
10011111110000101111111100111111001111011111111112111201111222211221022111112221111101101111010011111111101111110001111a1111111111101001111a11111111111011111011
11111011111110111111111110101101111101111101111110201201121012212122121121022212111101110001100111111001111110011111111a1011111011111011010a11111100111001111010
aaaaaaaaaaaaaaaaaaaaa11111110111111101011010111102221211121212221122121111111012110111001111111110011111111111101011111a1111111111111100101a11101011111110111111
11111110111111111111a01111101110111111111111111112102220112222020120121122000222111101011111111110110110111111111111111a0111111011111111111a11011101111111111001
01111100101110111111a01110110111111001111111111110210121221011112222212102021010111111011111000110111111111111011111101a0110101101111111110a11011110111111100111
11111011111111111111a11111111110111111101011101011021102221101121211222222221221100010110111110101111111111101111111111a1110111111111111111a01011111111101111111
10111111100111011111a11111101111011111110101111110110212102122101101211012122101111001111011101110100011011110111011111a1111001111111101011a10111111111101111111
11111101111011011110a11110101111110111111111011010100212121001120102112021001111111111111101110111110111011111011111101a1100110111111110111a11111111100101011111
11110111111010110111a11111101111111011111101111010011200111111120101012021101222011111110101111111101101011111110110111a1110111110101011111a11111100011111111111
11110100111111100011a11111101111111101111110111102122112102122012222212122022022010011000011111101111111101111111111110a0001110111111111101a01111101111111011111
11110111111111011011a11001111111111110111000111110111222211220120112202212120021111011111111111010111111111111011110111a1111111011011111110a11101111111111110111
11110111011111111111a11100110110111011111111101111210211000122212212011210011220111111111010010111111011011001001111111a1111111111111111101a00111101100100011111
11111110010110111010a01100111111001111111011111110122221020111221211121211112200111101010110111111011001101111110011010a1111010111011111110a11110001101111111110
11101011111001101111a10101010011111111111111111112221222211201222212112101201120111011111111111111101111111111001101110a0111001010000111110a11000111111111111111
11111111111111011111a11111101111111111010110111112011220210211012001112022122110110110111111011111110111111111101111111a1110101111110101111a11010111011110111110
11110111101101101001a11101011111111111111111111111021112220022111220012001222121101111111111111010111111111110111111110a1101111111101111101a10100110111110111111
11011110111111011101a11111110111111110111111111112112120022200221021111222221011010111101111101111100101110111011111010a1111001011111101011a11111101101101011111
11111011110011101111a01000111111111111011111111112112110201210200200122201222211111110011111111011110011111111111110111a1111011101111111111a11111110111101111001
11111111111111111111a11111110111111111011111110111111111111110101111011101111111100101011111011111110111011111111111011a1111011111111110011a11011111011111111111
11101011110111111110a11111001111010110111110011101111011111110110101111110011111110110110110111111111101111111111111111a1111111110111111110a11111110111111111101
11110101111111111011a11011001110110101100101101101111111101011111111110111111011111111111110111100011111111111110011111a0011011111111111101a10110111011111101011
11110110111111011100a01111001111111111111111111110111111001110011011110011111111111111111011111110111111101111012221221a1212221022212221001a22011101111111010111
11111101011111111001aaaaaaaaaaaaaaaaaaaaaaaaaaaaaaaaaaaaaaaaaaaaaaaaaaaaaaaaaaaaaaaaaaaaaaaaaaaaaaaaa111000011111221211a2212121102121012111b21101110111111011111
1110111111011111111011111100111010010111111010111111111111111111100111111111111111101101110111111111a111010100111120222a1111221211121121211b02111111111011111011
1001110110011010101111010011011111011111100111111111100111111011011111110111111111001111101111101202a122121111222220202b2202220122220000110a10111011111111111111
1011111111111111111111101111111111011111020212121221012222102012212010201111111111111111011111110221b102020010111010222a1100002121122122120b22111100011010111111
1111011011101111111111101110111111011101122012211112221111221211222221201111110111111111101011111221b012210112212101012b1121202122101201221b00011011111010111011
1111011111111001011111011011011111110111121111212210122002211220101211211011011111111011101111111211b212012200222122021a0212120221111220111b10111111111111111010
1100100111111101111111111101110111111111011121100012201112011011120111201111111110111101111101112212a102220200122202220b2022220121221212212b11011111111111111111
1111111101110111101011111101111101111111110001210101100101011202121112021111110101101111111111011211b122012110221101222a2222220021022121120b11111101101101101111
1110110111001010111111000101001111111111110111221012201102222211122100111111111111010001011111101122b212101111022200222b2221101121101211222b10011011111101111111
1011111111011001101100110101111101111111121202210212111101221211221002121110101101101110111101110110a110211020121222022b2020022122011012121a11011111111111111101
1110110111111111110111111111011111110111021211202210121011201021100110211101100111111111011001110012b012122020002022220b2210011212221222122a22100101111111111110
1111111111111101101100111011110011101111121201100211221210112021221112221111101011111110101110111102b112222211122221222b2212201220121002112aabaaaaaaaaaaaaaaaaaa
1011111111110110101111011111111111111111122111111110011210111121202102111101101110110111011111101210b002112020221000111a1212020022222212112221111011111010110111
1101111101011101111110101110111011111000112020122221012121221122000212121010110000111111011111112210b011020112102221222b0222101202010212001101111111111111001111
1011111011111010001011111101000111011011111211112212112122120210112221111111111011001001111100110222a221102211122222102b2122222212101011101112111111111111111000
1111101111111111110111110111111111110111122221211221220110212021011112201111011111111011111111110221a222212012020220222a2012012100112121001221111011111111111111
1111111011110100111111111111110101101111121111021202121222211120201121121111111011111111111101112222a212122111220002222b1022122022220122202221101111111011101111
1011111011111111110101110111111110111011002211011111202112112012111202111111101101010110100100111121b011111212112121202b0220022210210122020121111110111100011111
1111111111111111011111111111111011110111101121212011222120101121211122101110101101011111010111112221b120120121122202220b2122121211100021011121011111011101111111
1110111011011110110110111011111111101111021121102211110202122120211121111111101011111110010011111022a221111102221222100b2202022021112111201002110111011100111111
1111011111010111101111011111111111111111122121011221121102121012221121111100111110111111011101112200b110122122120220201b2112220211122212122222101000011111011011
1111111011101011011111111111111111011111121022200111112012112200220101110111111111110101111011111212b011101200002220222a0212202220020210221200111100100111001111
1111111111111111111101101011101010011010112221102200002211210121210201221111111111111111111111112010b221112010110212120a2112211112222011122221011101010011110011
1110111101101111111111110111011011111101010121112220112012221020022122221011111001011111111111111010b111121212112020222b2111211211222110110222001101101110111101
1011111101111001111111111101110111101101122222122122112121112122222200000111110111110110111011112212a220102211021202212b2000212211221222111112111110111001111101
1111111111110101111110111110111011111111101221112011221210111101012120121111111101101111111111102122a110211212111121011a2221102022111020202221111111101011100111
1111111111111111111011101111111111111011110120221121221001221111222211021110111110111000111101012002b111210211201221210a0122022202122120222022101111011111101111
1110101111011111111111010101111111111111101122202022101220102022202022221101111111101011111101012102a102011202202220212b2012112122120122221212100111011101111011
1111101111111110111011110111011110111111102212111012110011112122122210221111111111111111100101111111b121212111222111110b0220211202122022121011110101111110111011
1111111101111111111001111011111111110111122201002222212100211202112102001110101011100111111111110111b222122122022222112b2222002211211211111112111101011111101111
1011110101111101101111111010111011111101101112120122212221211201012222111111111110111111111111110122a222212211212102120a2222012111111111111111000111001111111111
1011101111111111101110111101101101011010121211112102200121011112112101021111111011111111010011102110a010120112002000201a1220112111111111110111111101111110011101
0111110110111111111011111100101111111100020212021121111111121202212122221011110000011111111111110111b221222211222221111b2222021011111111111111110011111110111100
