94 1
50 104
118 42
15 7
76 66
86 2
64 26
50 31
133 26
97 97

12211122112221221212a011220012201111111010111011111a1111101111111011111220102110222212112111020121221b1111111111011011111110110111000111111010010111111111111011
22112122102202111022b122020202111111010111111011110a1011011111111111111022111000102211111022012120221a1011111111011001101111011010110111010111011111111101111111
02222102202222111222b102222001210111111010010100111a1111011111101111111220210211102122121121222222220a1111110101001111100011001111011111111111111111101110110110
20011002211220112110a211221221211111111111111101111a1111111111111111111001221002221111021222011121011a0110111101110011111111111111111111111110011111110101111111
12112122222122221011b111210212201111111111111111110a0111011101111111111122222112120121001120121212101a1101011111111110111011111111110111111111111110111011111111
22010112122122122011a222221110111111001101111111111a0111111111101111111011221200002012112112011122021b1111111110111111011111111111101101100111100111011100111101
11220121211221120101b120120112211011111110111101111a1111111111100111111122221211001211011122211000102a1101111101111111010000111111111100100111111110111111110111
00111102100210212112b212121211111100110101111111111a1100111111111111111121200012120111120000111022021a1010111111110111111111101100111111001011111111111111111101
12112221202221121222a222102120111111111110101111011a1111011111111111101111221202122012222121211122210a0011111111111111011111011101100111110111111111110111111111
20202222221122121101b101112110011101110011111110011a0111110111111011110101022111222201022112011111002a1111111010111101111110111111101111111111001101110111111111
22122111121112120202a110112222211110111101110111010a1111111111111111101200022221021121012201210110202a1110111111100101111111111111011111110111111111111101111111
20221222120220202212b112121102211111111101011111121a2212112211212122201102122221111210221121120012220a1110011111101111122120001122220221220222111111111111111101
02112110212121220210b210111122111111101111111111121a2021110001121202112221221021212201201102212112221a1111111111111100220202210112010222121101211212011111111110
21212212201112122220a121002122211011101001111101120b1011000221001102012122101202201102110222220111112a1111111101111111222002121112120201021112220102211111110111
22211121102121012211b211220202110001111101111111112a2111211121111100222200200212102212012100012212120a1101111010001100120022011011012122122112121122111110110111
12201112111111102101b112211112211111010011110111120a1212202121122211122222012201220012220222122212201b1111101010101111002222112121211202011012222212211011011111
21012110111122002202b122220010111111202202221211122b1022220020202112102021202212211202111121112012111b1111110100100001002022222120122111002111111100011111100101
22221212001111211121bababbaaaabaaaaabaaaa2112201111b1222210222220110120011102222120211111122210201221b1111011101111001121011101121010211201121222021100011111110
2011201112221211002011112102112111112201b0220121122b1111220222212212121222112111221120110220222021211a1111111111011110221122121202012120211121111200110000110110
1001212220002111112002210212120111112021b2112012120a2212122221211112201220200200221211101120110101122b1111101111001111111101212210011211201222010211211101101110
0211122012120212212222022211112111110212a1001012121a0220200212202221202222212122110001100022111211212a111111100111011101121210002222202110222bbaabbbaaaaaaaaaaaa
0121221022120121202222212221101111111101b0222111020b1102122211122221220202222121100210220222211110121b010111100111111122112222102120211222201a121220111111000111
2012022012112011020121202011210111122211a0211212212b1220200011222221112220202222012001222011021201222b111111011110011122221112022121222102201b010222101011111111
1212121222120122212200112222110111111212a1112112022b1211222002221001121012202221220022010001112111222b101101111011111112011202210121212122112a220101201111111110
2220202112111221122102222222210101121011a2102220112b2021012222222200111222022202221211211112221122021a111111111011111102122000202112201221211a120221211111111101
1101111112211211211211222201211111112222a2221221202a2222222220102202221220112222222121110012121221221b101101111111111122111210101022011121102a100221011111111001
0120021101101021221122122112221100112211b1112120222b0222010221222220221120101122212210200222211201022b111111111111110121112022121121102102221a221101111111011111
2222001221100221002020222221120011112121a1221112022a2201210210122212112201221012212101122222200011000b121011112102121222020212212122022211121b020222011010110111
2210021221212102200120120120121111120220b2211122120b1211222221012111021211122202011222222112120022112a101200211122112222212122200212201001222a000112200111000111
1222102201110111112021221121210111021121a0220212012b2121200021220200011022110020020111021102210012121b111222121220222012022120220222111210202b112221111011111010
2102112212102112000211110121020111111201a1200212122b2212220222222220122222222221100200221012011222211b112000212211110002022100211122101221022a212111211110110011
0111011111011111111111111111111001012121b2021222122b2021222200222212111201221211110111101110111111101a122122211102212102120220011211101211112b122011111111011111
0111111011110111111111101111110111010002b2122121020a2212200021011200012122201021111101101111111101111a102211120122222121222120222122221112121a201102210110101110
1101111111110110111111101111011110122022a2122222202b0222222022221220011212212121111111111100111111111a121202121021200202221222221212101222210a121212010111111110
1111101111101111011111110111001110021122b0222220122b2222210200012202222222210010111111111100001111111a102022101221111122122210022222122120220a010111211111110111
1110101101111111110111111111111011120020b0201121122a2221220022220001202122212111010111011110110110111a122220122121221021021222221102221221221b110211211110111011
1111111111011111111010110111111011112220a2101211210b2220202022221210011221212021111111111111111110101a112211022111112122022222112220202221100b102012101111111110
11110011111111111101aaaaaaaaaaaaaaaaabbbb0212222122b1222200112212211011121201201010111111011101111101a112211022122012222022112212020021220212a012121111111111111
11101111111000111111a111100111011112211122001121122b2201201022211200220021121101110111010110111111111a101212222212012211220220220022100121102a120121211111110011
10001111111111101111a001111111111012101101221120121b2222210212120211121112121211111111111111110111110a121121110121212212222222120212121201121a122221111111111111
10011011111111111011a110101111110112120201212202022b2020002222102212211111222112111111010101010111111aaaabbbbaaaaabbaabbaaaabbbbbaabbbaaabaaab221111211111110101
11101111111111111011a111111101111112222112211210222b121222222112212012111120022111111111011111001111101112011121111211222012020021002220020220111120211111010001
11111110111111011111a110111111101012122111221220222a202210110121101111111111011011111111000111101111101122211121221211110002221120121110111111101101110111111101
11111100111111111111a111111111111010122122222210020b210012110110221111111010111111111011111111111101111122111122100211201121221221201211010101111111111111111011
10011110111111111111a111011011111112120102101022212b102210222122121111111011111111010110111011111111111112221221201202022222100101101111010111110101111010111001
01111111111111111110a111111111111102222202120112012a101221022011001011111111011111111010011111101111110211220110222112211211122221210111001111111011110110111101
11111001011110011111a101111011111001221212120110112b202012111121221101111111100110111110101010111111111120021221120122220111100022112211111111101111111111111111
10111111101111101011a110011111011111001011111101111a011101111111011111111111111111111101110111011111111222101100110122201022002112212011101111101111111111111111
10111111011101111111a111111110111101111111111101011a100011111111111111110111011111111011110111111111011221202222222221202021021102222201110101110011111101111110
11011110111111111110a111111111110110111011011111111a011111111111111111111111111111110110111111011111111122110222222221100000111022112110111111110111111101111111
01111111101111011111a101011111011011111111111011101a111111111110110111111110111011110110111110010111111112011211212011111112211112011101011111110111101110111111
11111110111111111011a011110111111111101101111110111a111001111111202221012202121211110112212210111111010210111202022011221211121121101211110101100011101110111110
11111101111111101111a111111110010111111101111111110a111111010012222121210201112210121122121211111111100211111112121112001111222112120101111111111011111111111111
10110111111111010110a111111101111110101111101000000a101111011122222111010121021021120122111001111111101112121121012121222222112001212210111111101110011111111111
10101111111000101011a011111111101101011111111101011a111110111011200002002210122201211220022111111110111001022112021002011001202111212110111111111011111110111111
11101110111111111110a111111111111111110101011111110a111111011112022221121222222221122222221111111111110101102010010110001111100101120101111111111111110110101110
11101010111001001101a110011001110111111111111110111a111111111221021122010121122212112222021211111101110111221012012122210111221221201111101111111111111111111111
aaaaaaaaaaaaaaaaaaaaa111111111101110111111101010111a111111111112201221112222122221012201112111111111111202020211221110211011201120222111111111001111101101001111
111011011111111011011111010111111111111111110111101a111111001112202012120221212212010111211211111010111111011101111111111111011101111111111011111101010111111111
100011111111111111011111101101011011111111110111101a111111011001211221222200220222022112111211111111010110110011011111010110111111110101110111101111110111110110
111110111111111111111110111111111110101111101010111a011100101122012101022211112201122212222110111101111111111011101110111101111111111111111111111011000111011101
110001111111110001111111110101111011011010001100111a111111111221221110211001102111112121222111101111101110011111110111010010101110111011111111001101111010101111
110101110111101111111111101111011110101100111011111a111111111022002102012122112102110100022210111111110100111110111111111111101111111110111110011100111111101110
010111110111101111111101111111111111101111111111110a111110010102011111211221112122202122111010111010010010011111101111101111111101111011111111111111011111111101
111111111111111011101111111111001110111011011101111a101111110200020121100221022021200112211111011111101100110111111011111111001110011111111111110111111011111010
111101111001111111111111101111111001111100110101111a101111111202120122211022111012011121121010110111111111111111101101111111111110110111010101111111111111110101
111111111110111111111011110101011111111101111111000a110111111201121220201222012222121212222101101111011111111111001101111111111110111111111111111111110111111111
aaaaaaaaaaaaaaaaaaaaaaaaaaaaaaaaaaaaaaaaa1111110111a111111111122201111122111210121010220122111101111111111010101111110111111011111110111101001111111010011111111
1111110111110110111111111110101111110111a1110111101a111111111112122212110101102002121201121110111111111111000011100111111111110001101111110111111001111111111111
1111111101100101001100111101110111111110a1111110111a011111101112012122122112121111011012110001111110111010111111110010100101110011011110101111111001111111111011
1101111111011011100101101101111111111101a1011111111a110111110111121112011110012220222121102011011110011101010110111111111100111111111101111011011110111111011111
1111111101110111111101111111111111011111a1101111111a111111110012112210111112121222111222220201111101111011101011110101101011111111111111101101110110110111111111
1101101111110111101101111111011111101111a1111111111a001011101112022112022222212221220111111111111101111111101111111110111111111110111011111100100111110011011110
1110101111111111110101100111011111111111a1001111101a111101111112111121221111021100012122212100101101011000111111010110111111111111111111111011101100110111111011
1011110011111110111111111111010111111111a1110010111a011010111211111210010022221101021101111211111111111011111111100100111111111110100111111111010011111011100101
1111101111011011110101111111110110111111a1111111111a101111111110212220121211102111012202111100101111111011111111111111110111110111110111111111111100111111111001
1110111110111111111111111111110111011011a1011111111a101111111121222021022202111212012100111201111111111111011100111111111111101011111000111111111111100111111011
1011100101101110111111011110111110111011a0111110111a111111111011220201001201111221221021102111110101111110111111110111110111111111111111110111111101110111110111
1111111111111111111111111001111111000111a1011111111a111111011112202111122111002112220222210210010111110111111110111111111111111101111001111111110111101011011101
1001111111001111101110111111111111111111a0111111011aaaaaaaaaaababaaabbba2212221201011011102011110110101111101111111110111101111011011001101100101111111111110011
0100111111110011011111111011111110111110a111111111111110111111111212110b1101100212211221211211111110100101111111110111110110111111111001111101111011111110111101
1101001110111111111111101011101011111111a111110011011111110011012222101b2212111101212210002111100111111101110111111110111011110111110111111101101001101101011111
1111111111011111101111111111111111111111a010111110111111101111101111111a1111111110221121210212222120221201222122011100111111111111011111010111110110100111110011
0100111001111111111101101111110101101111a011111111101111000111111111111a1110110111010212101011222122112012112122111101111111111111110101101110111111110111111100
1011111101110111111111010111001111111101a111111111100111111101110110111a1111111101112101001112012210201222112101111111111111110111101111101111101110111110111111
1111111111101111110101111111100000101010a111111011111111111111101101011a1101111111100211121000001211012112211111011111111111111110111111111111111111011110011111
0001101100111111101111111111001111001011a111111111111111111011100111111a1111111111122212222211110122022110202212001111110111011111001111111111111001110111111010
1111101100111111101111111101111101111111a011110001111111111100111111101a1111111111111112101101122112211221022221110111011111000001100111111111111110110111111111
1111111111111101101111111111011111011111a111101110101101111111101111111a1111111111012110010210102122122021112021011111000111011111011110111010111011111111011101
1010001111111110111100011100010011110010a111111101011110111111111111011a0111111111202112212201111222112211121222101111101111111011111010111111111101111010011011
0111111011101110111101111101111111111111a111111111111001111111010111110a1110111110121212222211222022120102111021111111110111001110101101110111111111111111001100
1011111111001110111111011111111010111111a111111101010101111111111011111a1011111111222011121212012200111011211201210111111111111111011011111110101111110111101101
0110111111101111110011101101110111110100a101101111101111111101101111111a1011111111111011202202121121211200210021210111111110101111011111110111010111011111010111
1110000111111011111111111111111101101011a111101010110111111101001111111a1011011111200111202222222220100221102221011110011111011111110011101011011111111111111111
1010100111011111111101011111111111011111a111111110011111111011110011110a1110011101122222121210202221012122212210011001001111110011111111111111011111111101010111
1111100111001111111101011111111111111111a111111101101111111111111111111a1111111011211112200101221222121202000200210101110111011111001111101111111111111011111111
1111111111001111100101111111110111011111a111110010111110111011100111011a1011111111211221211211020211202201101002210111111011111110111111010111111101111111111101
1111111111111111111111001111111111111111a010011111111111101111101111110a1010011111211220121122012201111022112211210011101111110111011110111110011101010111100101
1111111111011111111111011011011110010111a111101101111111110001101011101a1111111111222210012111122020221011221012211111111111110111111101111111111111111101111011
1110111111011111110111110111111001111111a111111111111111101111101101010a0011101111100210202112111120121112122111011011111111111110111011111111111111101011110011
1111111100011110111111001111001111110101a010111111111111111110111110111a1111101110012012212222121211011211102212211111010111111111111111110111111101111111100111
1111111111111110111111101111110111110111a111111111011111111110110110111a1001111111000122012001212111120212120220211111111101111111111111111101111011110111111111
1111111111100111111110111101111100001111a011110111101101101011111111111a0110111111011112212202112122001122222212010111110110111101111111111011111111111110110111
1110110101011010111111111110101110100101a111011111111101111110011111111a0011100101121202022111021122211221211111211111110100101011111111011101111111111101001111
1101111100110101111101101111111111111101a110011111110101110111111111111a1110001001121221201220122221011201211221211111110101111111111011011111100111011111111111
1001111011111010111111111111001111011111a111111111111101111110111111011a0011011111112100120201111210112112121122201110110101100001011111110111111101011011111111
0111011111011010011111111011011111111111a111111111110111101110110111101a1111111101222022010210210102211220012210110110010111111111111101011011011011001101101111
aaaaaaaaaaaaaaaaaaaaaaaaaaaaaaaaaaaaaaaaa010010011111111111111101110111a0100011011212201221200121222101202201211201111100111111111101111111001111101111000111101
11011001000101111110111111111101111111111111111010101101111111101011111a1100101011120121121102100202221210121100111011101101100011110111111111110110010111111111
10111011111010111111100011010111101111100111111110111011111111111001011a1011110011112012120112100011221220100012211110111111111111111111110110001111111110111101
11111111101111111110011101111011100100111011011111101111111011111111110a0100110011011212222202102112221021221210111111111111110101111011111101111111111111110101
11111111111111111111111011001111111111011111111101111111111110111101110a1111110111022212002022221121120211111120211000111110111111111011110001011111111101111111
11111111111111111111111111111111111111011110011111110111111111111011111a1110111111001012001211120222210111000200101101011111110110111111111111001100110111111101
11011111101100111010111100110101111011101100101010001010111111110111111a0111110101101110011111111111111101110111111110101111100111010111111001111110111101110110
11011111111101110111111011111101111001111011111111101010111011011111011a1011111111111011111111011111111111111110011111010101111111011101011110101111111111111110
11010110011111111111111111100100110110110111101111100011111010111111110a1111111111101111111101101111111011111111011101011010011111111111111010111100101011111111
01111111011111011111111011111111111111111011111110111111111011111011111a0101111111001111100111101111111101110111111011011111111011110100111111101111111110111011
11100011011110010111011111101110010110101101111111111101111111110111111a0111101100011101111101110110111111111111011110111001110111110111011001111111100100010001
00111111111010111011111100010111111111111111101110110111111110011101111a1111111111011101111111011011111000011111111111111111111111111111111111111110111111111111
11101011011111111100111110010110110111111111111011110111111111100111001a1111101111111110111011111101011111101111111001111111111111111111111111101101111110111101
