11 33
155 80
118 42
15 7
76 66
86 2
64 26
50 31
133 26
97 97

211122022020022201111000200121111110111111101011a01110101010101111110001221222121220002221101022212221011110111111110111111111101111111111111101111a101111111111
112210211001221201002102221212211011101101111111a11111101111111111111112122010102212211120112012211122001111010001011111111111111111110110001101111a100101101111
021021221210221212121122121022211111111111111101a11111011001111111111111002212121211120111221021111012111111000001001111111111011101101111101111111a010111111110
010012101122012112112112021122111011111101111111a10111101111111111010012221012222112222211121101011201011111111111011111001111010111111010111011011a111101111111
020221122111121111111111211011211101111011111111a11110111111111110011112112012022211102012011110001212111111111101011110111111111111111110111111111a101111111111
122211110011101210211100011120211111001111110110a00010111111111111111112102221222021112210121222221101111111111111111110111100101111111011100101001a110101111110
220122121012201102222021002120110011111010101110a11111111111111111111102012221111021122220021101001102100011111111101111011111110110101111111111111a001111110111
020111011222022112122011212222110110111110110111a01110111111111111111112212210100222121221121122121201011111111111110011111111001001101111011111101a011111111101
001122222121102120120200122222011111010111111111a00010101111001101111111220221222112210121221212221021011011110111111110101111100111111111111111111a111101110111
111022222102212122122221101200011111111111101111a11011111011010110110102020121212201102112212112211112111111111101101111111111011111111101010010111a111111111101
112122111211022102122211022100011101101111111111a11011101111111110011002211210121121121212210210201010111110111111101011111111001000011011110111111a011110111101
111222111220110112020022102112111111111111101111a21011211201221222012221222122121112201200222110112111011110101111010002100211202122101202120220211b111111101011
012212222121121202122222212112111011001111111111a01222112121202110211122012112221212111121121222122022011111110111011021212112111112121212201121222a111111100101
211011102211122101200121122111101111011111101101a20222221210122212122000220222201210222202220102211121111111111101110101002022011121112211122200021b110111111111
baaababaababbbabbbaabbaaaabbaabaaaaaaaaaa1011111a10112010022112221201122222212220012012201102101212210111111111111110101211120101102022022221202002b011101111101
1221010110212120222121220110110111111111a1111100a12210111221122011010121220220120012022011212112102122111000111101001022121100221122110111111202121a211111111111
0200222202121112011120201101211001121102b1111121a10122222221221220200212222222122212012120112111111220111111111011100002010121222202112110121121220a101011111111
1211111221021021211212220010122110110022b1121011a00220222202211011112112222220212221001110010121120111001010111111111111121212102112221021220210220b011000101110
2221120111201211212212222021112110122121a2221221b20202221222122211222210222222122221222100222210221212111101010111111110120112121111222122021110222a211111110011
1221001221120211210011211111202011112211b2221121a22211221121222201210112200201020222220122222200112202011111111111011020111122121212221210220211222a011111111111
1222211211012220222121021121220011122001b2201022a2122222221222102012ababbbbbbbabbbbabbbbaaaabbbabbbabaaaaaaaa11100011122210202101121112222212212201a111011101111
0112211111222211111121012110112011120000b2210121b2212122220211012221a222222210221012012211110000102022111111a11111111100201021121122101221222112221b101011110111
1112012021212102020122122102121100102111b1220012b2001220212202212222b212222122221111212201212010121100111111a11111011121210221112111210201111101022b101111111111
2110111120220222012111200022221111120102b1212110b0221021222221202102a102220220121211221222202202110012111111a11111111011222112121101020212222220222a110111111011
2121101022011011011121220102201111121021b2222012a1222021121122222121a112021222011111212111121211110111111111a11111111122222212122220121012202122111b101001001111
0212211222102010122121212121121101122101a1222210a2022222220212222222a121220220121000122121122012221121011111a11111111112221121121110112120202022202a011111111011
1111221202100011211101211110020111101111b2201222b1220021120200120020b001022122020220212021012201111022111110a11111001122122102211112111001122221202b201111110011
1021201112120001002112111100211111111111a2111202a2202222220220012202a221202122222110111101220222211110012201a20020212102222212012221222110111022002b010111111111
2102110111021210202021102112120111100202a0021212b2120000222022022202a012211112212110120212111210112110102201a21222122222122212221212202102210111010b211101111011
0222120111121012201110212222202110121212a2001221b1021012222102220211b112200202221111112112001111220101102112a10120101001012002022222222122122222010a111111111101
2201112111022120121221011122121111101222a1121121b2021021211222102220a212122121120021100112202011112021101201b12111111210221121001222221222120002121a211101111110
1111111011111111111110100011111101112221b1011222a2220120212001202202b112101210011110111111011111100101011011a10202221121222222200101012110120022020b011111101011
1110110101111111111011111111111100110220b1202212a1121022022002200121a202221221101101111101111011111100111110a00202111011201120200222221212122012112b111100110111
11011111101P1111101011110111101111022112b1101211a0222102210222212212a020110000111111111011110110111101121210b12012020220221221202221222112112011222a210110111101
11100111111P1111110111111111111111111221b1201222b0222002022202222112b210111112020011111111101111011110001122b12220102200220222212222022212111022021a111111111110
11111111110P1111100011111110111011122122b0222011a2121122100020010210b010110200211110101101111111111111102111b22110101211122222120022201212112122222a111111110111
11111111111P1111011111010011000111111021a1020210b0211120122122211222a220222201121111111111010111101111122201a10222122202002121222211212010210222012b210111110110
10010111111P1111111100111111110111101020a1222210b2011210002222222212a021220021201111111111111111011101122220b22221001111202012022221220221122111121a011110111111
11011111111P0101110111111110100111102222b1221122b1001122212222222222b221202211021111111001111110111101101221a21221211212221022221020021211212220212a211010101101
010110111101P100111011111011101011122122a0221112b2220012122222022102a112112221210101101111101110100111122222b12221222202022102222021012110202211111a201101111101
0111111101110P11111110111101111111110110b2122222b2020202201221222200a022112222120111111111111111110111112201a12221220222222002122221211202121221012a211110111110
1111111111101P11111111101110111010122002a1022022a2022220102202010112a211212122220001001111111011111110122101b01221002022012222222122221111211102212b211111011111
1011110111110P10011111111111111110101121b1121221a2201222122102011011a111011011111111111110111111111010101121a21102021112222011122201201111011101011a100111111001
1111011101111P11111111111111101110122022b0010112a1022211211200121011a110011111111111111111111111111111012012b22122101221202200222112101111011011011a110111111111
1111011111111P11111101010001111111012022b0112121a1112112111221101001a110010111111111111111101110111011022110b22011111021011212211222221000111011111a001111110011
1110111101111P11011111010110111111011111b2102122b2022002022122112211a111100110111101110111001110111111110122a11000111102221111122111121111011111111a110110111111
1111111011111P11001011111101111111110221b2112001a0121121210121210211a111111110111111111111111010110111110010b01020201220120111211221211111111110010a011111111011
1111011111111P11111110111110001111111101a1110101a1111111111101101101a011111111101111011111111111111111111202a22012021122212021122000211011111011011a111111011101
11111101111010P1101111011011111101110111a0111011a1001111110111111111a111001111011111111101011111011011102100a01020101022221122212011021111101111111a111111111111
11111111111101P1110111101101111111011111a1011001a1011011111111010101a101111100100011011101011111111111021212b12021211112101101122221010110011111101a111111111100
11101110111110P0011111101111111111111101a1111001a1111111111011111011a111111110111101101010011111111111101212a11000210011000000010122220110111111011a111111111111
10001111110101P1111101111111011011110111a0111111a1111111111101202111a012021121111011202211121111111111011122a22111222221022112210100111011101101101a111111101011
10111111011111P1100101111111011111111011a1111111a1111110111111101212a111200222110220122201121110010110122220a21222222112112111002211111111111110101a101101111110
11111111111111P0101111111011111111111111a1111111a1110110111112000110a221001010111212111111221111111111112222b21201011222110212221001121011111111111a111101011111
aaaaaaaaaaaaaaaPPPPPPPPPPPPPPPPPPPPPPPPaa1111010a1111011111112222202b102202202101120112010211111111100112111a22222210022211202201120221111111111110a111111111101
aaaaaaaaaaaaaaaaaaaaaaaaaaaaaaaaaaaaaaaPa1100011a0101110111112122021a021222220111110211211120100110011120121b10022022001121201111202001001111111111a111111111100
1111111111011101111011111101110001111110P1111111a0110111111111212200b212022211111112011220201101110111101120a02112011112212002221202021101101111111a011111111011
1111111111111101110101111111101111101011P1111011a1100111111112222220b122222110201001112122111010111110120122b10210111112000112200012111111111111111a111101111111
1111110101010111000111100101110110111110P1011101a0001111111010122202b222211112100200121211011111011111111111a11111111001010111110011110111111111111a111110010111
0111111111111111111111010011111011111011P0100111a1111010111111200222b212120121202011111102111111010111111110a11111111111111011011111001111101111111a101011111111
1111111011011111111011011011111111110111P1111111aaaaaaaaaaaaaaaababba202211021221121112111011010111011010111a10110111101111111111011010111111101111a111111111111
1111111111111111111111011111111001111110P1110111111111110011022011220220111011012211112021211100011101111111a11110110001111111111110111110111111101a110111111111
1001011110010110111101010011111111101100P1011111101111111111001112211112222021121122121012021111110100110110a11111110111111011111011111001111111111a111111111100
1101000110011111111111111110011111101111P1111111110110110111111122120201112211112112221002121110110111110110a01011111110010011111111111111011111010a001111111110
1111111111110111111111111101111011011011P1000111111111111011122120200121220202221101220110120100111111111111a01111110111011111111011001111111110111a111101111111
1110111011111111111101111111111111111110P0111111111111110010121101211110101112110221212121101111111011110011a11111111011111111101111111111011111111a101111111111
1101111110000100011111111111111101111111P1111111111111111001111011002011210210122210012221011111011110011111a10110010011110110110000111111111111101a011111110111
1110111110111101011101100111001111111111P1111101101111111111121112012011200101212211221012101111111011111101a11111110101010101100101101111011110111a111111111111
0111011111110110111101111111111001111111P0101011110011111111101222001012211201002100211102211010111111111111a11111100111111000111100111001110111111a111111100111
1100111111110111101011110110011111111011P1111011111111011111101111211122110112111120111021111111111011011011a11001101011001110111111111101111011110a101111110111
1111111111111111010111111111111101111111P1111111111011001000101112011121111122221020102111211111111101111101a11111111111111011101101010011101111110a111100111101
1111111001110111110111010011110011111111P0110111101111011011102120101201011112222112212020111111111111111111a11101100111101111101111111111111001111a111111011111
1111111111101111111010111111101111110110P1101111111111001101122120021202211210021111021211011110101101111011a10111110011101111101011111111111101111a011111111011
1111111111111111011110110011110111110111P1101111100011111101011111212122222202210022211110121111110011011111a11111111111111011110011001111011110111a111101101111
1011111111111101111111111110111111001111P1111100111011111111121221102022111112101211222101121111111011111111a11111111111110011111111110111111100111a011101111111
1111111011111110111100110111111111001111P1111110011011111111110002211211111122221110112022220011111111101111a10111110111011011111100111111100111111a111010011111
1110100100111111111110111111011111111111P1111111011111110111021110211121221222211211121212221111111111111111a11101111100101111011110101111111110110a111111110110
1110111111111111110001111111111111110111P1111010111101101111121220012102002012012211122111120101111011111111a11101011111111111110111110110111111111a111111111111
1111110101101011101110110111111111111011P1111111110111011111121001200202221100102221220221201010111110001101a10101101111111101111111101101010111111a111111111111
0111111011010101101010101111010001101111P1111101011111111000121221212112120212122200210012201111110111111111a10110111111011111111100110111111011110a111111111111
1111111101011101110001101111011111111111P1011101111011101011022010111212122222012111211122201110010111111001aaaaaaaaaaaaaaaaaaaaa111110101101111111a01PPPPPP1101
1111111011111111011111111101111111011110P100111011101111101100212002201021201022000201222221111100010111111010101011011110011111a011011011110011101aPP0111011111
1110101101111110011111101101101111111011P111111101111111011110111111111110111011111211122101222202020210211222212011110111110111a111111111101110111P111111111111
1111111111010111101111011011111110111101P111101110110011111110011111110111101111102012222102211222021122011110122111111111110111a111011011101111101P011011110111
1110110101111111010111101111110101111110P111111101111001111111101110101101011111111222212201212100010221122221211110111110101111a111111111011100111P011111111011
1011111111011111101011001111110010111110P111111011111111011111111111111110101111111021122210101122101021211211220111111111111101a111111110111101110P110110111101
1111111010110111111101111111111111101111P011111111101111111111110001101111111101110122022111221220022122110112212110101111111111a110111111111111010P111110101101
1101110111011111110101111011110111110111P111111011110111111111111111111001110111012220222122211121222120212210210111101011111110a111111111111111101P111110111011
1100111101111111111110111111010111111011P111101101100111101111111101011011111110112101022201101002122010012121111011111111101111a111111101101111010P111111111111
1111111111110111111001011111111101111111P111110011110110111111011101110111111111111112201120112212222121112121212111011001111111a111111111011111111P110111111111
1111101010111110111101011111110111101111P011111011111111111111111010101111101111012212021212202122112110121201120011011101111111a111111101011101010P000111011001
1110111111001111011101011111011111011111P111111110111101011110101111111010111110111101112202212101100211022121010101101100111111a111111111001101111P000110101111
1111011111111001101101111111111011011101P001111111100110111010101111110111011111111110111222111012200201121122121111110110110110a100100111110111101P110111101111
1010101111011111111011111111111111011110P011111111111110010011111111111101111111111102211111022112020011210111121111101111101110a110111111010101011P111111011001
1101011110111111110101111011110111100111P111110110110011011111111111011101011111111112102111200022201222201111121110110111111010a1110010101PPPPPPPPa111111111111
1111111101111111011011111011110111111111P111101111101111111111010110111111011111011011112211120212022212112221012101111111111111aPPPPPPPPPP01101011a111110111100
1111111101010111011111111110111110011111P111111011111111110111111110011011111011112221111010201212112201122010122111010111110111P111101101111111111a111111111000
1011110111001011100111011111101111111111P111111111110111110110111111110111110101112102222001022222111211211110012011100100101010P011011111010011101a111010100011
1111100010111111101111011100111011111110P111101111100011000011111110111111101110110110102221101000221100111200221111100101000011P100110111111111111a111111011111
1111110111110111111111011111110111101111aPPP011011101111111010001111001010111011101121100220220111211111202222012011111111111111P111111110101110111a110111011011
0010111101111101100111110111111111101110a101PPPPPPPPPPPPPPPPPPPPPPPPPPPPPPPPPPPPPPPPPPPPPPPPPPPPPPPPPPPPPPPPPPPPPPPPPPPPPPPPPPPPa011111111111110111a111111111111
1110110111111110111010111011101110110111a1111111a11111100100111111111101110011011111110012020101112211112120010220111101111111111111111110110111100a111111101111
1111111100011111110111111111101111111111a1011111a01111111101111111110011110111111112222001210221121221101212211111011110001111011110111001111011111a100111001111
0111111111111011111101111110111111110001a1111101a10111110101011001111111110111110101122122110221021012022111201120111101111111110111111101001111111a111011111111
1110110111111111011001111110011101111110a1001111a01111111111110111010111101111111100210222222000212220002021022201011111011111101111111001111111111a111110111101
1111111001100111111011111011011111100111a1011111a10101111101111111111010111110100112210211201010122112222111012211111101101110101111101011011101111a111111011111
1111111011111111111110111011010111011110a1101111a11111111111011111011100101010111111212022122020112102121011211221111111111110111111111111110110011a111111100111
1111111110111001111111111111111011111111a0110011a11111101101111111010101111111110122112021011021211122112022221211011111100111011111111111111011101a111111011111
1111111101010110111111001110111010111111a1101111a01010110111111011110101110101111112212201000112222120201002220200011111001111111111111111101100111a111111101100
0111111111111110101011011111101110011011a1111111a11111111110011111101111111111100011202021110122212112222221122211101111111111111111110111111111111a110101101011
0111010011110101111110011111111111101111a1110110a11001110111111111111111111111111122102011010212020120112121221011101101111011111111110011100011110a101011101000
1111011111011111110111111111011111111111a1011111a11011110111011101110111111110111111122111111120222101011212122220111101111111110111011110110110011a011110111111
1111111111111011111111111101110011101110a1111111a10111111010100111111111101110111112121212021010021120221122122220101011101111001110111110011111111a011111111110
1111010111111110011111111111111111011111a1110111a01111111111111110111001010110111111011011001111111111101110111011111111010111011111111101111111011a111010010110
0111110110111110111111111110111110111111a1111111a11111111111001001001011111111111111111111111111011110111011111011011010111101010111011001111101111a111111101111
aaaaaaaaaaaaaaaaaaaaaaaaaaaaaaaaaaaaaaaaa1111101a11111111100111011011101110011101111111111111110101101110011111011111111011111011011100111110111011a111111101111
111100101011100111111111000110111111111111110111a00101111110111111111111111110110110011001111111111111110110111100111011111011111110011111111100101a000111111111
110111110111111010111101011111101011101011010111a10111111110101111111111111110101111011111111101111101011011111011110110100111110011101111111111111a001110011101
111011101111111101101111101111111110101101111111a11101011111011111111111111110001111101101111111111111111101111101111111101100010110111111111111111a110010111111
001001010110111100101101111101001011111011111110a11111111110010111111111111111111111111010111011111111111111111111110011111011111111111111011111110a111001011001
