94 1
50 104
118 42
15 7
76 66
86 2
64 26
50 31
133 26
97 97

2221122222222201110112111200111011111111011101111111110111111101101110120220211102021121102110120211111111111111111011110101111001111111111011011111110110110110
2121222212012211020222222211211011111111101110101111101111111111111111021221212211122111101221022221121011011111111011101111011110111011101111111111011110101011
2121112112222121112221111222222011111111011111110111010111111111011101101211122120001102022210111112221111011101111010111100110100101111101101110111110110111010
2222120122101011211000112010222111101111011111111111111101101111010111122100122121121122121210020111121111111111101111101111111111001111110100111111111011101110
1121201021221110112021101201112011000110111111111111011110010111111101112211211112120010211222222121110111110111101111111111001111111110011110111101111111011101
2021021222221010202101101222021011101110111011011100111111011111111111111011121212110021120201221111221111100111111111100111111111111111011011111101111101111111
2110120221011222202102211222122111101111111011111111010111111111111011111211221012222122221222202122121111101111111111111111111111011101101100110111111011110010
1121001122212202211212012102002111100111111011111101110111101111111111111121111222120120022212212110201111111111001111111110111001011110111011011110111101110111
0111112021201221021110022021221101111110101111101011100110101011111111112101200021012122221220112222111111111111111111110111111111110111100110111111111111111011
2220221110111111102201212110112011011011101111110110111011101110111111111212102102212222112121210121221101111111111110111111111110111111111111111101011101111001
2122122022012101121221111201221101111111111011111111110111111000111111122001222102011110100210100211211111000111111111000110110111011111101111111111110111011111
0101001012220121021211121220221011100111111111111002221211012202112122111001222111112012212211101201111111111110101111120000012012122112101221020020111111011001
1112111121221111122022100022201111000111111111111112122112111012102121110202221111111221021222111021011011101111111011002202220002211110212111122220010111111101
0010122020212222012120210102122111111101101011111112221222222222222101202021221211121111121012011012111111111111000111111002212101212111222022112112111001111111
1122120101210121222222121112101111011101011111101202112120201022112101122202202110222111121011001212221111110011111010111122002212122212112221011211011111111111
0001002211022220212222012100221111110110111101111210211112220202211112222210221121112212022121220222111110101110101010212212221211012002211201220202111110101111
1221220202222211120021122102121111112021112112212122021221212212222111222022221022112222201222121211210101111111111111022102222222222110112120022112210011110111
0121202121121110111011212222120111122122220002221212222222212021222212222020221021022002211121112102221111111111111111212202121211111201211122120121211011101010
1211122112122211122100002210021111012012121222121222120020211210101112122221222002202121201222022222201111010111011101022012220211212121101212122122211111011011
abbbbababaabaaaabbbbabbaabaaba201112210212111202122202222222212122211120200122221112022022202212aaaabaaaaaaaaaaaaaaaaabbbababbababbaaaabbaabbbbaabbabaaaaaaaaaaa
22222211212102121201211111022a011112121012201212122110201222222220011222120211101012222111120201b010011101010111011111111112012021202220110121112010111011111111
20121011220201211200222212122b110111120212122222212212121220220112222110222212201122111021212210b000110011111110111111100100100101122112112112010120211110011111
21200200112022212220121202122b111112012102111221210021211221102212112212222211122111121210111210a011021111111111110011211220201210202211101022212211011111000111
11202211011112111100122210222a100111112212122222122022212221002012211100222220210222212202200120b122000111111011111111111211220021222111120220122011211011011101
21211221022121111122121112102a111110112201210222112220122222111002201202212222112221112022111110b211210111111111011101021111021112212201111021111102000111111111
21221211011000021101111221122b010110100210100212111210222221212020200021221221202222121110011110a120221111011110111110021112112200210120120222002221211111111111
12222020221210221112100121100b111012210201121221112222211022212222012102211222022020012221201221a211111111111011011111222022001212110211111012211222001111100111
21210211201120012112220212112b211110121002212122121222221002120222021010000201221012210110222022a021121021101200212121111112000221221012211100101100211100011111
11122210021122211210122211121b211112112211120011222022210102222222111210022222221112202211022210a022221221211211011101122022011222221012122120012221011011011011
22102102120212111220220022120b211101220111211212001102012021212000212000202222011101022211020211b102120222020112222111120212202212222122220122110102211111111111
10220121121212022111122011121b211112210122002102122102221211122200022110220220122110121121121222b100111122220201221211212210002202122201201220120122001111111011
11111101111111111110111111011a111110221022112222120221112221011122201021121121201010001111110110a100100022211101011111220210222122220220010122210120211111111111
01100100011110111011011111111a111111112220112212222021222121212222212122211221121111111101111110a000111221221212002012222222212222221212022100012022211111111111
11111100011111011101111110000a111012221210212100112212011202221222220112202220011111110110011001a100100221211010211121212222221012222211111021122210101111111111
11001011111100111111111111010a011112111111111022122120112212211222211221110212221111011101011111a101001121122002101211022200222222122212202210120111111111101111
10111111101111111111111111111a111112211111211100021202222212222212222112212220121111110011111111a111100111102200021221110212022220210210212112211221011110111111
11101111011111111110011111111a111111211022212010222120102122221220201022221100201111111110101101a111111102122222112100210222220002220222122212221001211111111011
11111111101010111101001111111a111112212011022122122222222220120221122102112122221111011111111111a101111112222022021201121122212222122221200022001122211111111101
11111011111110110111001111100a111112112011201101020122212222011122221111121111211111101111111111a011111010201221101110120202221122221222110101102220101111111110
11111111111111011111110101111a101111011210021112221211222202021022121212211222211101110111111111a111111200221010102221220001022222201022101210022001101111011011
11110101011111100111111100111a111010200221221221222220121222100222212112121222211111111111111111a101111221022120010102222021212212202222121100222100101011110111
11111010111110101111111101110a001012120001112222020222122221010222021122112200120111011111111011a110111001010001210111211200020202212120212211112211011111101011
11111111110011101111111101111a111112202000111121121102222102211202111111101111011101111111111010a111111011212121220222111121220112112111011111011101011111100101
11111111001111111110111110111a111012221110221222210221021211122112101111111110101110111110001111a111111111111210101210112211211220112011011111010011010110101111
10111101111000111001110110111a011112212200221022101110121212220121111111111110111111111111111111a101011111221102020001101112112210000111111111001111111110100011
11011111011101110001111110111a010112021211022110101120212002020122100110011101111111011010110101a010111121121022212202222102111202222010111111111111111101111110
10111001111111110111111111111a111110110121012222211121102211212210010101111101101111111111111011a111111020021211121212121202111101212011101111111111111011011011
01101101111111101111101111111a101111111110110110111110011101110111101101111101111111111011111011a111110021212120122121221000111102211111111111001111111111011111
11110111101001111111110111111a110111111111110111111110110111111111111011110101011011110010111011a111110211201012211201102120121112122211101011111111001111110101
11110111111111111101111111111a111011110111101111110110111111110111011000111111111001101011111111a111011112211021020020012020212222212011111111110110011111111010
10111110111111111111111111010a010111011111111110111111011101001101110110101101011111111111111010a011111010201112120120122121102212021111111111111111111110111101
11101010111111110101100111111a001111111111101111111101110111122112101222211101222111122122021011a111001222101121212222120222112201122211111111100111111111111111
11111111011111111011111111111a010111111101010011101010011111102020211111222211112110101222121110a110100021112220222102221122022110221200001011110010111011101111
01110111111111011101111111001a111110111111111011011011111111021010022120011120001121211221211100a101111102220112121221112222211022112111111111111111011100101111
11111011010100111111111111111a101111111111111101011111111001122212010001112212212211111122101111a110111222120021212111120221220222220011111111111111111110000111
11011111111110111111111111011a100111110011111101111111011011111222221001022221111211122122100101a111111221121112120212221022112121212211111011111111111111111110
01111111111110110111011111011a011100111111111111111111101110110121211202101102122100101201221111a111010200221100122112121200101221101110011111110010111110111101
10111001111111111101110000111a011111111111110010111101111011111111022212102121010122202011211010a111111111102212111011122201212212202111111101110100111101011111
11101001011101111111011101110a101011111111111101101111011111021222110021222111112021011122221111a101111111111111111110111101101111111101111111111110111111111110
11101101111111101101101011010a001101111111111110111110111110122212221212222111202212201220111111a111111110110101111111aaaaaaaaaaaaaaaaaaaaaaaaaaaaaaaaaaaaaaaaaa
11111111101110011111111111110a111010111101111010101101111111111021022222220011121101222201221101a011101111111111111111a01011111111111110111011111011001111101111
11011011111011110111100111101a101100111111101101110101111111122020111110112222212201201012110001a111100110111110111111a11111111110111111011111111111111111011110
01111110111111111111111111111a101110111111111101110111101111122112122221101102122211211222211000a111111110001100011111a10111111111001011111111110101110011111111
11110111011111111111111111111a000011111110011111111011011110101021212021011121012102121122001111a111111111111101111111aaaaaaaaaaaaaaaaaaaaaaaaaaaaaaaaaaaaaaaaaa
10001101111111111111011001010a111111110111100001111111111111112201111101002121222121001122111111a101110110111101101110aa1111011111110011111110111111110110011111
11101011011111110111101111101a111111111111001110111111110111010212111122222021202001012210221111a011111110101011111111aa1111111111110011110111111011111011011111
01101010111111011101110010011a110011111001110100111101111111111102212022210112121010111012220111a000110111111011111111aa0011111111111011111111111101110111011001
10101111101111011111011010110a011011101011111111001111111111110221002212102122221121112120211100a101111110010011111111aa0111001110001111111011111111110101111011
11110110111111111111011011110a110111111101111111111111111111112122220110212222002101201101111111a111111111111101110111aa1110101111110101111110100111101111101101
11111111111111101111011101011a111111111111111111111011111101121221221200110222112201102222211101a111111011111110101101aa1101111001111010111111111111011110111110
11111111111111111111111011011a111011111110011111001101111111110021120121020011201112012112211110a111111011111111101111aa1111011111010111011110111111100111111111
11111101101101111111111111111a100010111111110011111111111101120212201002112011121011121121011010a111111110111011111011aa0011111111111110110011111101111101111111
11110101110110111111011000111a111011111110111101111001110101100121120021112222211111211222011111a111110111111111111111aa1101110011111001111101011110111111011011
11111111111111111111110111111a101011011111110101110101011110022212102022122211020212111101221111a110111101111010110111aa1011111111101111011110111111111111111011
11111111111111001111110111101a111111101111111100111010011110121221012210102001111022101022211101a111111011110111111011aa1110110101011110110111110110111101111111
10101010101111111101111111001a111111111111111101110110111110101111112110221220212102210211021101a011101111011100101001aa1110101111111110111101111110011111011111
11101100111111101110111111111a111101100111111001011011011111120011121201221111020201201112121101a011101111111111011111aa1111111111111111111011101110111111101011
01111111011111001111111111111a111110101111111011111110111011110222121211121122121020112120021111a111111111010111111111aa1111111100111111111001111101111010111011
11110111111110111000101110010a111011111100111111101101111101122121211111212220021202210012210110a101111111111101011110aa0111111101100011110001111101011100111111
11111111101101111001101111111a11101001111111110101011111aaaaabaabbbabaabaaabbaababbbbabbaaaaaaaaa111111011111101111011aa0111110111101111111111110010000010110111
11111110111110111111111111111a11111111010101111101111111a1111212111011122211222102210110111211111101111101011101111111aa1111111110111111111111011111110111111110
11101011111111111101111101111a11101111111101111110011110a1111120120012110012212200022212111201111111110011011101111010aa1101111111111111110101111111110101110011
11111111011111100110111011100a11111110111111011111011010a1110111111111111110111101211112222212122122120111022120111111aa1111011111110101111111110101111111101111
01000111111111010110111111111a01111101111110111011111111a1111111101111111110111101211111222012212112222021111011211111aa1111011111111111111111110100101111011111
11111111111111101111111111111a11111010011111111111111111a1111100011111111111111111222010012020122121221101222211101111aa1111010011011110111111111110100111111110
11111111110101111101100011100a11111111110100101101111110a0111011111101110011111111111121101111221212122121012210011111aa1011111111111111101011001111001110111010
11100000111111110111111111110a01101111111111111110110111a1111110111101110111111101222112020122221112201021211111111111aa1111111110010111111110110111111001111111
10011111111011110111111111111a10011111100010111101100110a1110011101111111101111111120011110121222221222121201012111111aa1111101111011111101110110111110011011111
10111101111000101111111111101a11101111011111100011111101a0111111111110110011100110210111100100101212222202021122011111aa1010111011111101111011110111010111011011
11101111010111111111110111111a11101011111101100110111101a1011001111111111111111100122221100202220201200120111121211111aa0001100011101111111101101001111111111101
11111111101111011001101111111a01011101011011010101111111a1110101111010111111111110212020222122122102110022212221111111aa1111111111011001011111011111111111101001
11111111111010110101111011111a11101101111110011101111001a1111011111100111111011110010020112022210100022120202101111111aa1110111101111111111110111111100111111011
10000100111101111101111101110a11011101111110001011111111a0111110111111110111111111010212111200222211222220222212111111aa1111111010111111110111110111111111011110
11111011110111111111111010110a11111101101101110111111111a0111010111011111101111101211102112211202122222211012212011110aa1101110111111110110111110111011111111111
10111101101110001111011111101a11111101110111111100111111a1111100110111101111111111022011122210220120211111212002210111aa1001111111111100011110011110111011111111
11111011111111111101111111111a10110101111011010111110111a1111000011110111111110101102221111102210122222202211212011111aa1101111111110111111111011111101101111111
11011111111111111111101100011a11110111100110001101111111a1111111101111101101011110211011011021120221112211201121110111aa0110110110111111101011111111110001101100
11100101110010111011111111111a11111111110001110111111111a1100001011101110111010011211212222202110202111102121110111101aa1111101010011111111110111111111111110111
11110111111001000111010111111a10111111111011110011110110a0110001101101111011101110201121122011100020012111222222201011aa1111111111101110011111111111011111111111
11100111110111011111111111111a11111111111101101111011111a1111001111010111111110111212201120221221121120222111211210111aa1101101111111101111111111111111111111111
10111111011111111111101111110a11111111111010100011011110a1111010101111111111010011122210101102021010022111102121201000aa1101110101111111111001111011110011111110
10101111111011101111111111111a10111111101111111100010111a1110111111111101111111111212212112112102210211200211222210111aa1011100111111111110101111011101111001111
11111000111111111111011111011a11111111111110111111111011a0111011110110111111110111222212102001021211112220222122210010aa1111011111101100110111110111111111110011
01111111111111011111110011001a01110001110110111010111111a1111011111111111111110111222111120210202110211212121211211111aaaaaaaaaaaaaaaaaaaaaa11100111110111111111
11010111101111111111100111011a11011011110111111101111111a1011110111111100010110000002201212111112111120210120211111100a01111111101110010101a11111110011011101110
11111111111011011011011110111a11111111111111111110111111a1111110111010110111111111211022012111011111211121101121201011a01111011111110111011a11111111110111001111
10011101111110110111111011110a10001111101111101001111110a1111111101111111110110110211102101111111021121211220222011111a11111111011111111111a11111011011001111111
11111111100100111111101111111a01101101111011111111011001a0101111011111111111111111112112111112222101212112222112201110a01111101111111111101a11111001111110111011
11111111111101011011011111111a11111111111110010011111011a1111111011111111111111011112121212022221121120010221121201111a11100111110110101111a11011010111101111111
10111011110111101111111111110a11011110101110101101011010a1001110101011101111011001211111021012000111121121111112110111a10101111101110111111a01111101110111111111
11110100111101111101111111111a10111010111111101101111111a1101101111101110101111111022211222102011111212212212221211111a10011011111110111111a11111101111010111110
11101110011001111111011111111a10011110111111101011011111a1111111110111011101111111221121021212221022020210202121201111a11101110111101111111a11011011111111111111
10111011111111111101000111111a11111101111101111011111111a1111111101101111111101111111210211002210121120101022021101111a11011011011111111110a11000111111111111111
11110111111110110111111111111a11100110101111101101111110a1111111110110111111110111110001111101001111111111010101011110a01011111111110111011a10111011111111111111
11111011110101111011111111110a10111111011111110111011101a1111111111111111111101111111111111111011111111111111011111111a11111110011110110101a11111011111111111010
11111011011101111100001111110a11111101011111111011111111a1101011111001111111111110111111111111010111111111001111111111a01111110011001111110a11111111101111001111
11111111111111011111111111111a11011111011001101111100111a1111010111111100111111101111111110111101011011111001111111111a01011011001010111111a01111111010111111011
01101111110111111111111111011a01111110011111111111101010a1111111111011011110111111111111101111111111111011111111111111a11111101110111111111a11000011011111110101
11011111101111111101101111111a11111011001111111111111011a1111111111111011111111111111011010001111000111111111101011111a11111111111101111111a01101101110111111101
11111111110011111111111111111a11111111100111111111110101a1111111110111111101101011110110101111101111111101110011111110a01111001101111111111a11010101110111111100
