69 119
40 14
118 42
15 7
76 66
86 2
64 26
50 31
133 26
97 97

2101011122210212000211211120211111111111100111011001111111110101111111122b10222222212220222021102212121111111111111110011111110111100111011111111000111111111111
2222101120211210201221000121010111111111110011010110111001111011111000112b11221222122112110122010211221111110111111110101101100111111110110011111101111101111011
2221101100121101112022211010212111111110111101110111111110111101001101002a12011112211012121112102121220011111111111111100111101100011101111111111101001110111011
1010102200010120120222121112221110111100111111111111001111110011111011122a20112012211212101121210112221111110110011011001111111111111110001101111111110111001111
1122001121222021112201210012222111111111111111111101111110111111111011121b11011222112222121212021101211111011101011111011111111110111001111111101100111111110111
1012101220121100111111112021220101111111101111110111111101111111101011121a20121222001112112211120112011111111111101111101011111111110110011111001111111111111111
0112212121121120111202110121201111011111101010110101111110111110111111121a21022111100222212110021112121000111011101111001111111011111111111111101110011111111011
1010222112222221210212111001222111111001101101011111011111111111111111011a12122112221210122012101120221111110011111111111101111111111111101111101111111111100100
1222222122110002122202220112211111111110111111111111111111110110010011111b12111212112122121022122122101110111111111111111110111111111111111111011011111111111101
0021112221102212222012222121220111111111111111011110011111111101011101021a01001202111120201111120112111110101111100110111110111111111011111011111111111110111111
2222210111000110122112121020012111111111011110111011110011111111111110101a21122021201122201012021222121111100011111011101110001111001111111111111011111110001111
1121201120211102100111011021122111111101111111111011220102222111211220120b21222211202111122210111211211111000111110111222122001111021222120211110200111101111101
2111112212120120110010020221101111110101111100110112110110122201121111222b12212012222211211201112210121101111111111111022020122202000222111202211211211111101111
1021212211211211212212222101221111111101111111110222122212222021202221000b22122221120220022221122200211111011011110111202210222211221211120101122110211111111111
1111221211220111212111121200211111111111P11101111112211121221202122110222a20020121100021021111122022211011111111111100222211221112111021122101101112110110111111
2222112211021122121211112121211011111011P10110110212201221121010112020012b22200102221022211022212111101111110111111111211110220201111220021022122222101110101111
1101022011212221022211111202102111122102P11211022222022220211021221121212b21220201211220201121201222200111111111111111120022212102210101111222210210110011111111
211212221121120012111212001221111112212P222021021220022212221202021011021a22202011101122202212211121221111110111111111021222221121112210112212221211011011100011
10212222201121200211012211212120111111P0010222200022222112121220220211020b22002211202021201122210201011111111011011001222122111121112212120021221221011110111111
21222010022022201010210120111121111111P2101112112200022202211222112101002b22222211110022101021222101101111111111111111101121211222211201212011111011211111111111
011211112020122221120212210111111111210P222222211110222202221222222112220aabbababbaaabbaabaaababbaabbbaaaaaaaaaaaa1011210200122221112102111212020100211110111111
1222220211211210001011111221221001121021P112210222221212222202211222111001221221222201010120111212000211110011111a1111202222211120101021122221102222211111011111
12112102022021120102121201001111110221200P12122222222000102022221221111122021222201211021221012001121111011111111a0011211011100122010121211022222120110100101011
22211121210100112001100012211111110201210P01011122220022022022121221112210222212221101121201200101002011110101111a1111101121221212210212111122121121100111110111
2022020212112112202000202222121011111112P221222102212222020222212122120210221222212012011100221121112110101111110a1011120111211112120002121010102212010101111111
1212021012120022101111112021211111111022P012112212222212112221210222221201102222211111111110221121111101010011100a0011022101022222202112222212122122011110101111
2202002102012212011020212121212011020220P210122112122221202222222220121121101102111222221201122101012211011100111a1111101110212212210121112011111200100011101111
1212222000202012101110101121012011112211P222210002002202122020020122111121211212221202021211122121122112002021202a1002021121220222222020002112220200111101111010
1101102012221011202221122212001101112122P020111121202212200121122011111202212222121222021120122222121012211210212a1211122202200211212212110211120022210111111111
2102010121110221120000021102202111021222P111000122222222222221112012122212222210111121111111112211121211121212100a1222102212122222222222111100020222211011111111
11122111111201012220121101222121111002012P22121222022221212122221210120022221122120221210121000120101212021212112b0222112212220212222201002121211121011101111110
111111111101111111011111111111001110121210P2122212222002221012222222202112211122111111011100111011111011211121120b0220211222122212002111122aaabbbabaaaaaaaaaaaaa
110111111111101111010111111111111102122212P2021202220012222022122201221200122211101111111111111110100111200122122a0122211022201021222010222a02222220011011101011
1111001111101111111100111111011111112121112P221122110122212212122112112211120221011110011111101111111112022001212b2000201102221222220222112a11112111010111101101
1111111111111101110011011110111111121200101P001112220222020222100101110021002101010100111111111100011112122221021b2020222121200222221211100b11221022111111110010
0111111111111110100110111111110110120202222P212222201222122201121011122202122011111011111011111110111112112222201b2100221222220222222221011a22212101011101111111
0110101100111101111110110110111111122222122P002200100022222221022000202020021112111101111111111110010101222121021a2221102022202221202200111a12201001201101011111
1111001110110111010111110110011111110122212P202012221102222110200221212221202001111111111110110011101112220221211a1211010222222221222212010a11012011110110010101
1111001111100111111011001101111111112211212P122112221222222020202121122110220221111001110111111110101002221002212a2101222221212022221011201a10121000101111111101
aaaaaaaaaaaaaaaaaaaaaaaaaaaaaaaaaaabbaaaabaaPPPPPPPPPPPPPPPPPPPPb221100202112011111111111110111111111110122121021b2020002202212221221002020b12221112011111011101
1110111111111111111111111111111011112100020211011112112210222222P2221111000221221101011011001aaaaaaaaaaaabbbbababb2111021020221110202201221b20112120211011111111
1011111101110010010111001110110111120211222101210012202022202112P2202221212112021111100111101a111110001122222222211020102022022222222201020b11001111211111111101
1111111101011110111111110111110011101110022112122120102220111122P1111010001111111111001111101a110111101222111112211022221012211012122111111a11111011111111111101
1111110111111110111101011101110010111222111112222211021211112011P0111011111111110101111111101a011111111211111021102122222111221122111211111a11101111110111101110
1111111111101111111111100111111110112200122012021210122101011101P2101110111111111011101100011a111111111022112211112022210111110122111211111a11111111101110111110
1011101111111111111011110001111111102112122122021110121222122211P2111111101101111111011110111a111101111000211022212111102111111012222101111a11010111111111111111
1111111011111011111111111110110111011101111121002122012111210022P2110111111011100111011000101a110110111122111111021221010212120210111211111a11110110011111110011
1011111101111111011111111111111111101111011101111111110101111011P1111111111111111101110111101a111111101000102102000100110101221110020211111a11111101111111111110
0111101100111111011111111111111000111111101111111101111101111011P1111111110111101101101011111a111011001010011211012201012211121121122200110a11011111010011111010
0111111101011010011111111101111111111010011110111110111111110111P1111111111100111111111101101a011111111021211211200101012221011112121110011a10111011011111111110
1111110111101001111111111111111101111011111110010001110111110101P1111111011101111110111011111a001111111211122202222212212112012221112110110a10011100111111111011
1111111011101100111111011111111111110111111010011101011111111121P2011111220211101110122221121a01101aaaabbabbbababaaaaababbabababbabbabaaaaaa11011101111111011111
0011111101010011111111011111111111111111111010111001011101110220P2022111212221221222121112011a11011a111002002211112102021012222121112111011101111111111111101111
1101100111100011111011110110111011111010011011111111100110111121P1221121122111211201102022101a01110a111210211022012201210110122110221111101101111111111110010110
1111110011111101111110111111111111111111101101011111011011111212P1101221102121221022021101111a00111a011121122002112021211112122200220001111000010111111111101110
1111101111110110111101111110111111101011111101100111111111111111P2211211102122222222122220211a11111a011121201112101102111111011101212211101011011111110111111110
1100111101011100101101111101111011101111111111111111110110110201P2221222021110111221111221020a11101a111120012211110020122210112112201211100011101111111110111001
1101111101111101111111101111111111111111111111011010111111111022P0010001112102002021121211200a01111a111220001120112011122012212210112111111111010011111011111101
1011110111110111111111111111111110111110111110111111110111110012P2111212121201022202212112111a11111a110111110111011011110100111111111111111011111111111001011011
aaaaaaaaaaaaaaaaaaaaaaaaaaaaaaaaaaaaaaaaaaaaaaaaaaaaaa1111101111P0210112020122222001022111121a11001a111110110111111111010100011111101111111011110011111010000111
11111111111111011110111110101111111101101111001111111a1011011220P1120211222122221002222221221a10111a111001111101111010111111101111101111110111111001111100111111
11111011110111111001111110110011111101011001111111111a1111111211P2002211020121110222110020010a11111a111101111111001111010110111111101111010111100101111111111111
11111111111111111111111111101010011100110101101111101a0011110100P1022111222110102212122200111a11111a111111110011111111101111101111111011101011111111100101110111
11011111111110000100101111111111101111111010010111101a1101101212P1221212022211211101022222101a11111a110011111100011011111111101111101111111011101111111111110111
10111111011111111001111111111101111111111111111111111a1111111220P2111222202211212212011202101a11100a100111011011011111111111011101111101111101111111111101111010
11111111111111010111101111011111111111011111111110110a1110111112P2121222110122121111212200101a11101a011111101111110111011111100111110011111111111111111011010111
11111111111111011111111100111111110011111101110111101a1110111110P1112210102022211101201121111a11111a011011110111111111111111110111010101110101111011111110111110
11111101111111101110101111101011111101010111111111111a1110101211P2120210220202021002212022220a01101a011011111111001111011111011111110111111111101100111111111111
01111101111101011111011001111101111111111101111101111a1111111122P1020211012121212012121222201a00111a111111111111111011111011111110111111111101111011111111111001
11111111110000101110011101111101100111110111111111111a1101111220P1101120122112212210122101001a11101a111010101111111111011101101111111111111101011111110111110110
11111111101011111011111101111101111111011111111111111a1111111212P2220112210022022221200212211a11011a111111111010111111111111111011100111110111110110111011110111
11111111111111110011111110011011111111111011111111111a1110101110P1101212211220011102021122100a01111aaaaaaaaaaaaaaaaaaaaaaaaaaaaaaaaaaaaaaaaaaaaaaaaaaaaaaaaaaaaa
11111111010101111111011111100111111101111111111101101a0110111211P1112112201020120212200222210a110101110111011100100111111011111111111110111110111101111111111111
11110101010110110101111101111100101101111100001111111a1011111221P1221120210112210211112111111a110001111111111111110010110111110111111011111100111111110111110011
11111111101100110010001111110111111111111110101111111a1111101100P0211122111211021210121101121a111111110111110111101110011111101111111111101111111111111100111111
11101011011011001101010011111111010111111111111110011a1011110122P1221120110112202112201121221a111110111101111111111101011111111110101111111110101101111111111111
11111011111111111111111101111111111100011111111111111a1111001121P0122121111112101112021011001a111111110111110100111001111111111111111101111101110110101111111011
11011111101111111111111111111101111111111101011111111a1011110101P2212212012120222021121211111a101110110111111111001101011101111010111111111111111111011111101111
11111110111001111101111111001111111011011111011011010a1011111221P1202220221022112211212221100a101110110111101111111111011101111111111110111111011111011110011111
11111111111111111111011111111011110111111111111111110a1011111111P1212011210102111221212122001a001101100111010111111110111100111101101111111010011011111100110111
10100111111111011011111111101001111011110111110011011a1111110211P2211112122020022211200221210aaaaaaaaaaaaaaaaaaaaa1101011111101111101011111111011101111111101110
11101111111111111101111010111011111101111111101111001a1101111100P101111011022022012112021111111111011111110011011a0111001111111111101101000110111111101011111011
11111111100111111111110011111011011101111111110001111a1111010110P101111101111111111101121122122112122112022100012a1111111111111111111111111110111101111111111111
00011111111111101101111111111010111100101111111001110a1110110110P111111011111011112210201122121211202201010220211a1011111110111101011011110011101010011011111111
10110111111111101110101001101011101101111111111111111a1010011111P111001111111100002211102011122220112222121101112a0011111111101111110111111101111101111101110011
00110011101101111111011101011111111011111111111111111a1011111111P101110101111110111222111121222212121111112112022a0111111111100101101111101111111010100110101110
11101011111111110101111100001110111101101111110111111a1111110110P101111111111111112122112112201022112221222110021a0001111111110011111110111111111111101111001100
01111111101001111111110011111111100110111111111011110a0111111111P111100100111010110201020111111212112212021121021a1110111110111010111111101110110011111111011111
00111111111111100111111111011111111010111110111111111a1011111111P111011011111111111201122012012102202212021122021a0110111100111011011111110101101011111111101101
10111101111111010111101010110001111111111111111101110a1011011111P111111101111111012221121120020111200012202112222a0101101111111110111111101111010111011000111101
01111111111111111101100010111000111111111111010110111a1011110101P100111011111111110111222002101011122122122001122a1111100101110100111111111100111001101111111111
10111011111111111111111110111111001100101111111111010a1011111101P101111101111111002212111121021111012201012121100a1111111101010011110111111111011110110110111111
10111101101111111111111110111111111111111111101111111a1011111111P111100111111001110021211010020102022111212111121a0010110011111111111000111001111001111011111111
11011111111111101011111101010110011111111111111111111a1110111111P110111101111111110212221020201100102111100212110a1110011111001111111101111110111001101111110111
11111110101011111111111111100011110101110101111011011a1101011111P111110111101101111210121021221011120201121211122a0111111111011110011111111111111111011111111111
10111111111111010101101111001111111110011111111111111a1111110111P011011101011101110022201011212111121120101210111a0111110010011111111111111110111110111111111111
11111110110001001111011111111101011011011111110111101a1111111111P011110111001101101122222200112120112122020222122a1111111011000111110011010111110010011111111111
11110100101110111110000110010110110111111111111111111a1011111011P111110111101011111101121112212220011211111221222a0000110111011101111111011111111111111011011110
11111111111010111011111111101111111110111011111111111a0011111111P110111101011111100120201122211221212221211220021a1101011111111010110111111011111101101101100111
11010011110111111100111111111111111111111110111101111a1111110111aPPaaaaaaaaaaaaaaabbabaaabbaabbbaabaabbaa11122120a0111111111111011010111101111110101111111101111
01111111011111101110111111111111101111011111111110111a1100111110111P110111011010011202012012012122211021b21211112a1111111111111011110011111111110111010101111111
10110111111111111110111111110011111111110111111111111a1110111001101P001100111111111110222111100202121211a11121100a1100111101111110111101010110101111111111011110
01111111011110110101011101111111111011111011111010101a11010111010110P11011111111110221021121120020121200a12122121a0111110001111101110101111011011111111101011111
01011111111111011011110111110111111111111111101111101a110101111111010P1001111011101221012220210222212211a22221022a1110101111111111001111001001111110001101110111
11111110111100001110110110111111010111111110010111101a111111101110111P0111011111112102211220210002222101a11012202a1111111101111011111110111111101101101101011001
11111111111111101111111110111111011111111111111101110a111111011001111P1111110011112122212120102112201122b22222202a1111101011110111110111100111111111111101111111
11111111111111011011011011011111011111111111101111111a110010111111001P1100011101101101222121211011222020b01210111a1111111111111000011001110111111110111111001101
10111101111111111001110010110111111111111111011111011a011111110111001P1111111101111110111121112211221111a10122221a1001111011111001111111011111010011011111111111
01110100111111011011110110111111111111111011111111110a111111101011111P1111111111111122121120112222012221b01122122a0111110111110111011111110110110111010011111110
11111111101011111001011011110111101011011101111101111a111111111010111P1111110111001112121210022112222012b22101121a0011111111110011110111111110111101011111011111
11111111111111110100111101111111001111101111100111111a101111010101110P1111110111112221021211021222002111b20022020a1110111111111110110111111010111111110110110101
11111011010111111111011110111101100101101111111011011a111111101101101P1101010100011202122201100011112120a22022010a1111011111111011111001001111101110110111011111
00111111101100111110111011111111110111111101111100111a1111111011111111P011111011101222122121222121121220a21202222a1101111111110111111101111011111111111111111011
11111111111111111101111111110011111111111011111011001a1111101111111011P111111111111110111100110111101101a10111101a1111011111010111111111110111111111111111010010
11010110111011111111111111011010111111001011101011111a1111111111111111P111110111101111111111010011110111a11111101a1101111111111111101111101111110111111111111110
10110111111110101111111011111000111011111101111110001a1101111111011111P111111111111011111110111101010011a10111111a0111111011110111011111111111111111110011010111
11111111010111101111111111110101111101111110111011110a1110111100111011P110111011111111111111111111111011a11100101a0111111100101101111111110110011110111111111101
11001011110110111111000101111101111101111111110111110a1110111111111111P101110110101111111111111101101111a11101101a0111110111111101111110101111111101111101011111
11011111110001111111001111101110001111111111101111111a1110111111111100P111111110001111111010111011111110a11111111a1011111011110101001111100111110101111111110111
11011101011001110111111011101101101111101111101111101a110111011011101P0100111100010111111001111101011111a11111110a1111111111111011011000101111111110111101101111
