22 2
103 11
118 42
15 7
76 66
86 2
64 26
50 31
133 26
97 97

1212111110102212220120210b022200111111011111111111111111001111011a1110100221022111210210121112121122120111111111111110101111111111111111011111111111100101111111
1111221211100002010100111b020011001111111111111111111101111110111a1110111110211110022020110211111111021111011100100111111111101011111111111011110011111111111110
2112111111122212112002001b111001111111111111111111101101111111111a1111120100120112222202122110011112020100111000111111011111111011111011111111111110111101111111
2020112211121022202220202a112101110010111101111110101111111111101a1111110112120abbabaabbabbbbaaaabbabaaaaaaaaaaaaaaaaaaaaaaaaaaaaaaaaaaaaaaaaaaaaaaaaaaaaaaaaaaa
0111210221102112211110120b102211111111111101110111111111110111111a1111122011001a21020210211111020010101101111111111101010111010111011111111101111111111111111111
1220112212201210222121111a011120011111110111011011111101110100111a1110122211111b20002221101122222012121111111111111111111111111111111111111011010011111111111111
2020121010212221012201212a222111111101111110111111100101111111111a0110012001222b02110210121212001202201111111011011111110111111111111111100011111111011111111110
1112122111221220112222111b202020011111101111101111111111111111101a1010101012122b11111202221111112122221111111100011100111011111110111001100111111011000111011111
0211101111212210201222011a212021010010101110111111111110111111111a1111112110122b22022211010102222111121111110111111111111111111011110110011111111110111111110111
1112220222212111121012220a002121111111111011001111111000111111101a1101122200012b20112121110210121222110011111111111011010111111111110111111111000101111111110011
1212011211121111122210212b201120111011111101101110011011110111111a1111111210102b22201120121211222012211001111011111111101111011110100111111111111111101111110111
2212200221112112220010111a221111010011111110110111210222222202201a2121122122222b20212212102111112110221001111111101111011211011122212012211222221022211101011111
1202102221211010122210012a021000101101010111100111121211010212010b2211212222221b11121222111101120011111111011111111101020002101122202202111011110012211101001001
1100021122111121221022010a011121110111111011111002202220102220002b1212012120122a21112100012211102020110011101111111110121011210212120212022110122122211110110010
2012102101121220011202011a021221011111011011111101101211202210012b2222222212211a01210122121221102022221100110111111111222210121201221202112002120210011110111111
2211120122210022202122101b112111111110101110111012111111002222112a2112212022222b21222212112111122201201010111111111110211022122211122100212222121021011010111100
1112012110201211121110101a102111111011120122121211101021212222222b2110222111221b00121220122111012222121111011100111111221120112221001021222221121110211111111110
0111212100211122221122112a201121111100121220120122220200220012222b1122122221222b22101021100021220001211001111111111111022121112112211020112212112112201011111101
1020021002211121222110202a222121111012010222212200222220222010112b1221222101121b11111022101211022121120111111111111111221122021122212102112120121011211110111111
1022010122110112212222211a202121111222202010120121102111121102102b2121222222220b11222111102111111111121011001111111111121002101212222100111002220122211111111001
1201022222111112222112210b120021111111112222121121221122012222222b0222212012222b22110022112022211211220001111010101111121111221111211222020101122121211111101111
2210112001112121012021010b212220111221122122121101121222100220201a2211221222201b22011212022222112100121111110011101111211110112112111212211012011102211001111111
1102211112011012110100102a122021111022021021221112222000020222012b1212002222022b11122210200120021120220111110111110101122211121220221120111122122212011111010111
1211110110002012101002020a020211111002021122221022122222012120102b1112122202220a21211011111121011222211111010011111101221112222010022200112212011111211011001111
0200022110212212122011211a021121111202202222220222120222221212211b2221222221221b22211102012222202122111100011111111111112210112121221221221121111122011111110110
1010121211210121222022221a102111101112201012202112021211012222022b1000222202202a20121222202022212200221110111111111011002111112221110102121012022110201111110001
1122112210210102212112202a221021111120111210012022022222202121222a1112120202220b12212002211121222221121110111011111111020100211221010202102122112111001111111111
1220122222222022112211120a011121101111220021202022122202022122220b2122220222222b21212211122102112011101201022001221112122021122011121202010011212221211101111111
1022122111110210222210111a121211111121122112112112222222222110222b1222102212200b01222212121111121121211201220220012121201202212222222202112111211002111001111111
1112212122021222021111211a222011111202212022211222122012220012000a2102112122221a22202002112021012111111202211022222110022212220211220221212211222121211110101111
1022122021200012200102111a021201011112121222121222012220222222212b1220200020222a02100022211121021121121121121222220202220121200222202022101220022211111111111110
0111111011101110110111111a110111111012202111001112200221210112012b1202002112121b11111110111010111110111101202101121000212221022021222211010112112110211011111111
1111110111111111111101001a111011111120111010220112220022202221222b1020201112021b11111111010101110111111122212122212111112222212220222212010112111201211110111111
1110111111011111011011010a111000111211022222011212220220222122122b2102201222001b11101111110111101011101212022211112222221021222222022210200221122202001111000111
aaaaaaaaaaaaaaaaaaaaa1101a110110101210022212112222122122220212202a1011011122112b11100111101111111111000011011211220120202002220222222020112122221011111011010111
11111111110111110111a1111a110011110222211121221212121102102221022b2221012002112a11111110111111111001111220220111210101022022122021111101021211110100111110111101
01101011111011111111a1111a101011111211112121200021222022122102212b1121202011021b11111111111101101010111121220221222221200220002222200201201210212201211111101101
11111111101111101110a1111a101010110011112110001012111222202202222b0121122111122b10111111111110111111111122010122212211022222022212202212211011221222111111101011
11101101111111101111a1111a100111001021112111210112202212212210202a2101021012112a11111100101111111111001222222021122212121122212220212220110122111111211111111111
11011011111010011110a1011a111111101120210111101012112222120021122b2111121110212b11111111111111111101111211102112211221222121222222212222110122011112011101110110
10101011111100111110a1101a111101111111202010212020220022222222222a2220012212112b11111111111101110111111200212001211222000202222211112222122012200021011111111111
11111111111111111111a1111a101111111121122120011111211222222222212b2111010122111b11111111111011011111111211110111101111010202112101222202220112202121011111101110
11011110100111101111a1100a001111111220111112211022121001012222112b1011110111011a11000110111111110111111112212221221222012212221121121210111111110011111111111011
11110111101011111011a0111a101111111111211202221000210102222221122a0101111111110aaaaaaaaaaaaaaaaaaaaaaaaaaabbbbabbbbbabaabaaaabababbabbaaaaaa10011111101111111111
10110101101111101101a1111a111111011122202212012222111120201222102b1111011011101011011101111101111111111121021101100202011021020212212010110a01001101011010111111
11101111111101000010a0110a111111110222112222120110220211110210120a1110111110001111001110111110110001111210201121200011202101121100011011111a10111111110111010101
11111011111011111111a1111a001111111121012012221211100222111112022a0001101110111011111100111100110111111120111121221110011122002011110011011a11110011110011111111
11000001111111111101a0001a111111111111011111111111111000111101110a1111101101101011111111110101111111110210112110201111011121121022022011110a11110011111011101110
01110110110111110110a1111a111111111111100011111111111100011011111a1101111110111111010101111011111110011100121212011121202212011122212211011a00001111111111101011
11011011101111010010a1101a110110110000111101111111111011111111011a1111101110101111110110100111111111110122221111000100211110111102111111111a10111111110111010110
11111010101101111111a1011a101010101110101110111111111111111111111a0111111111111101111111111111011110110122110001221001010111201201101111011a11101111011110111111
11111111010110110111a1101a111111011011001111010110111101111111222b1211211122012222022110220100111111101102112202222212210012102211022010111a01010110111111111111
11011111010011111011a1101a011111111111111111111111111111101011210b1221222122101100022120222110111111111111220211101010210011122200122111011a00101101101011111110
11101111101111111111a1111a011011111111111110010110111111101111210b2210102122221120112122112011110111111210120112012121102211200120112211100a11011111111111111111
00011110111011111010a1111a111001101111111111011110011001111111001a2210111112112210112100112210011111110011211211211212110202110111021201111a11001110110111111111
01101111111111011111a1111a111111110111111111111111111101111111111b2210222020020100221111211211111111011220111221121110220121011211211011111a01111111110101101101
10111110111111110111a1111a011111100010111011111111010111000110221a1221121012011101110111012111110101010022211212122100120120011121112110111a11110111101111111111
11111100111010111011a1111a111111111001100011011111011111111112202a0122002120011101211121012211001111011111112200200222110000002111222111101a11111111011111101101
01010101011100011111a1111a001111111111101101111010111011111112012b0220212120110220121021210011011110111010110101111111111111111100111111111a11111110111111011101
01111111110110011110a1111a101111111110111011111111111111111110222a2122122211122210221212110211111111111101011111111111111111001001111100111a11011111110111011111
11101100111001010011a1111aaaaaaaaaaaaaaaaaaaaaaaaaaaaaaaaaaaaaaaab2101202120222212111112021011110101111111111110111111011111111111011110111a11111101111111101101
01010011111001001111a1011111111111111110111110111111111111110220022022221121112211211110221110110011111011100110011111011111110111111101111a11111011011110110111
11111110111111111010a1011001101101101111101100111111111110011221112202112210021110222102112110110111010110111111111111101111111111101011110a10111111111110100111
11101101001111011111a1111010111111011011100111110101101010101222212222211122222221110101210110111111111111111111110101111101101111011111101aaaaaaaaaaaaaaaaaaaaa
01110111111111111111a0111111111110111111111110111111111111111010211111110201011022220021211011011111111111011111111111111111011101111111101110111110111010011110
10111111111111111110a1111100111011011110101111111111011110111212221122221021112112212011222010111111111101111111001110001111111111101111110111111111101010111010
01011101110111111101a1111111111111101111111111111111111111110110122101110220211222010202212111111011111001000111011111111101111101111111110101010111111111111111
11111011111111111111a1101111111101100010111011101010111111110011221112012202112021120122112110011110011111111111011111111111110110111111111110111101110011101100
11111110010011111110a1110111111110111111101111011111001010101220222101021120111121201121212111100110110100111111111111111011111111111111111111111110111111110111
11011111011111110111a1111111111011111011111111100111011111111111110210122021210121220110201101111111111111101111111011111111111111111001111111111111111111111111
11101111101111111111a1111101111111111011111011111011110101111120222221112212122122122012222111111111011111111111111111111111111101111111110000111011101101110101
11011111011111011111a0111001111011111111111111101111011111111021202121011220121212122222222211101101111101101010101111111110111101101111111110111110010111111111
11111111100111110101a1111011111111111111011011101111111111100110112022211211212201200202100111111111110111101110111111111101111111001111110111111111111010110110
10111011011110111010a0111111111101101111111111111111111101111220121221121220122112222220101111110111111101101111111111111111001110111100111110010111101011110111
11111101111100111111a1111110110011111110111111111011111111111111201212121111122201220101222111101101011001111111111101101101011111101101110010111111101111011111
11011100111111111111a0111101111111011101010111011110111011100121212121111212012202111201221010111101101100111111111111111111111111111011011110111101111111101110
11111011111111111101a1110111111011111111110111111101111111101110001021011122102211120111202111011111111010111111111101110011101110111111110111110111111010111111
11111111011101011011a0011111111110101011111111101111001111111122212221112022102121001102221000111111111111111111111111110110101111111001110111111011111111101101
11111110110001001111a0110111111111101111111110111110100110010021222122120012122022201221100211011011111111111110111111111111110111101011111001100111101110111111
11101111111111111111a0111111111110011111110111110111111111111212102010110122211222222200222011011111101110111111110111111011001011111111111111111011110100110111
11111111111101101110a0111010100111011111111111111111011101001121011220220110120120110012212111011111111010111111111101010111111111011101111110111110111111111110
11011101111111000111a1111101111011111111111110001111111110111022212112112122112221221110121010011111111011011011111110011011101101011111111101011110010011011010
11110111101101110111a0101011011010000111011110101101010101101111111101111110111111020212011121122011111122222102211110001110111111011111111101010111111001111111
11011111111101111111a1111101111011111101110111011111011100110011110111111111101111022220202221221222110111011100111001101111111111111111011111101111111111110111
11111110111001010011a1111011110110111011011111001111111111110110111011111111001111110002010020100122110112112212011111111011111111111111111111111111011011111111
10101111101011110011a0111101111111111110111111001011100110001101111010111111111111110121021222221211122021222202211111110111001111111111111111011010011011111111
11001110111111101111a1111011111111110110111011101011111110111101110101111011101111101221101102100021002022011122011110111111111101111010111111100110101100111011
11110110111011110111a1110111100101010111110011111001111111111011001011111010111111102121112121111211212222011002211111111111111111011111111001111111100111110111
10110111111111111111a1011111111101010011111111111111111110111110110001111111101011020211102220221000122112102202111001111011111010111111110111010100111111111110
11011111111111110100a1011001111111110111111111111111111111111110110011101111111110211020121112202111222112101022011010011111111011101111110111111111101101111011
11101111110111010100a1101111111001101111010101111110111110111111111111011011011001101111112112200111010002202011011001111111111101011111111111111111110101111011
11101110111111111111a0110111101110111111011111111110001010110111111101111001111111121111211201210121020202212121111111111111111111101100111100111111010111110110
11101111110111111111a1111101111111111010111111110111111111101111101111101111110010101122011220212102221212211121101100011011110111101110011111111111011111110111
11100111111111011011a0011110111100110111100101110101010110111111111111111110111100001211120111011211112102111121111111110010110111110101101011111011011010101010
01111111111110111111a1111111111011011111111111111111011101111111111111111111101111021011022121022121111122012211211100110111111101111111110111111111111111011011
11110111111111110110a1111111101011111011111110111111011111111101110111110111110111112120221011111201202112112001210111110111111111111111111111110111111011101111
11111110111111101111a1111111110101001001111111110101111111011111101111111111111111212111112112121022001201212122211011111111001011111110111111111111010011010111
11101111101111111111a0001111111110011111011110111111110110110111111110110111101111012112000001120210111112221211011111101001001111010011111110111101101110111111
11101110111111001111a1111110011111111111111111001111111111111111111111111111111111222010101202222210101001222102111111011111111101111111110011111011011001101111
01011111111111011111a1aaaaaaaaaaaaaaaaaaaaaaaaaaaaaaaaaaaaaaaaaaaaaaaaaaaaaaaaaaaaaabbabbbbbababbbabbaabaaaaabbaaaaaaaaaaaaaaaaaaaaaaaaaaaaaaaa10011111011111111
11111011111111111110a1a11110111111110101101111101100111111110100111111111101011100221020012210212212220222122010011111111011111110111101001110a11101111101111000
11111101011111111101a1a11011111111111001110101111111011100111111101111110111111010012122012121221112101202211212110010111111110111101001101111a01111011110111010
11101011110111011111a1a11111111001011111111101111111110110111111111110111111101011011121102001112112221121220222011111011101100111011110111011a11011101111011111
11011101111011111101a1a11111110111101101011010111100111110101111111100011111110111101021221110121221212102011002011011011101011111110100111111a11111101011111111
11100110110111011110a1a11111111101111101111111111111011111101111111011110101101111222121201112110112211112110210111101111111111111100101111111a11111111111110111
10100110011011101111a1a10111111101101100100100101111110011100111111111111111111111120112111012221222211222211122111011110011111111111111111011a11111111111011111
11011011001101111111a1a11101011110101111110101011111110111111111101001110111011111100211201100210010212010111101211111111111110101101111101011a11111111101110111
11011111011111111101a1a01111111010111111011110101011011111111110100111011111111011011012111021221120022222111000011100110111111001101110111111a11111110111011010
11111111111111111111a1a11111111001111011111011001110111111111000111111101111111011122111121121221222112221011222210111111111110111111011111110a11111111110110111
11111111011111111111a1a01111111011111111110011111111100101110111100110100101011111211121212002221110122202011021001111011111111100111111101111a11000110111110100
01111111111001111101a1a01011011110111111010111011101111101101100111111111111111011220111022210020212220222210121111111111111111001011011111111a00111011111011111
11111111110010101110a1a01111110111011111011111110111011100111111111111011111101111221102222112112110101212221102200110111111111011110111111111a01111111111111111
10101111111011011110a1a01011111111111001110111011110011011111111011111101111111111212012022212101020211222011221210100011111011111110101110111a11001101111101110
11110111011111001001a1a01011011000111111111111111111101011111011011111111111111111111011011111111111111110111111111111110011100111101111111101a11111111001110111
11101111111101011111a1a11010100110111101101111111111111110101111101111111110111111111111001011111111111110111101110111111101111001111111111011a10111011011111110
11111101111111111111a1a11011111111100011110111111111111111111111110101110111111111111111111111111110101111011101111101110111111011111100111011a11111111011111101
11011111101000111011a1a11011101111111111000010001111111111111111111111111111011111011111110111111110111111111111111111111111110101011111111111a10010111101011011
11111111111111111110a1a01111110111111111111101110111110111101101110011111110111110111111110110110011111100111011111111111111111111110111101111a11110011111011111
10111101110111111110a1a11111111010111110111111100111110111110110111111111111100001110111110110101101101111011111011111111100110101111100111100a11111011111101111
11111111111101111111a1a11101111011011011111100111011111111101111111110010011011111001111111111111111111011110011111110111111111101101101111011a11101001111011111
