11 33
155 80
118 42
15 7
76 66
86 2
64 26
50 31
133 26
97 97

011111111202212121112112220a2221101111101111111011001111111101111110111220122222122021110112221120222211111a1110111111111110101101111111010111111a11111111111a11
110110112101012220200111121a1111111111101110110111101111010101111011111221222222112110220212110011120010111a0110101111111101111011111111101111111a01111011111a10
121221012122220102112212222b2111011111101111111110111110111111110111010101222102021112111102212121112200110a1101111100111111110111111010100011111a11110111010a01
122102202011220200100220210b2220101111111111111111110111111000111111111111111021012211000210201210112011111a1111011011011110101111010101111111011a01011111011a11
002112212122221122211122011a2121111111111011111011111111111111101010101220011021212222111220010122121100111a1011111101111011111111010111111011111a11111110111a11
221110212222220122111121211a2211101111011111111111111111101111111000111122022212220200102222210220221211111a1111100100111111111110111111111111111a10011011111a11
001110212122220122002101112a1200010011111111110101011111111111101011011002220001201120201021122122111111101a1111110111011011111111111110111111111a01101110111a11
211021000110212121212120021b0211101111111010101011110101111001111001111121022011221220222211011112022110111a1111111110101111011111101111110111101a11111011110a11
020221011022222122011112112b1111101111111111111111110111111010011111111020212222212012111202011100112111111a1011011011100001111110111101101101111a01111111010a11
222212110020112111212201001b1121111111110011111111010111001011111011111110012022211121120001201112111001101a1001101110011111011101111101111111110a11111101111a11
221121101021021122210022122a2210111110101111111111111111110111111110111102112222221201111220110112121101101a1111111111111011110111011111111111011a01011111101a11
201112101120112112112212212b2120011111111101111012211010111220211220220122022201121012111210210011022110011a1011011111211211210201212110212111211b02111111101a11
111202110011112212201101112b1221011111111111110111210011101022110012102222100122112001222121122101222211111a1111111101110210011121121211010112112b11200111101a10
211111011202122101111010221a2221111101011011111111220222221202110002201222211201210202221200212021111011011a0101001111112221000010200212102021120a12111111111a11
120111222111202211102101121b0221011111001111111111110101211220022210112121222212110211222211222121221110111a1101111101122002011221112221021010212a22210011011a10
121120111220120112212111102b0221001111111111111012212210011121201112211020122202211112121011101222010111111a0111101101121122011100122202112222012a01111110111a11
220212202102110022012111010b0021111211210211021012222222212021222011121222222220112111121222111121112211111a1111110000212120111102211211201011120b22111011111a11
112110212012112110200022120a0121111221212220022112122010002222220222121220001221221210212221012121210211111a1111111111112122212201220211121112221b01011111111a11
122201101021111212110111121a0121111121122221112112121221212201212011200122212002002222122021121010222211111a1110111101102122112011101000022111001a12111110111a11
210022210212012212110211001b1221101211200202221120211220222021022200122222012221222112210210011121212111011a1111111111212211121210220121102020012a11111111011a11
102221212200220121102010210bbaaaaaabaabbabbbbbaaaababbbbbbbbabbbbbabababaababbbbbbaabbabaabbbbbbabaabaaaaaaa1010111011221212101101220202120112110b21210110111a01
2202111111112120222211121010221011111211010201011222122022122212222021122122222212012102211111210112111110110101111111110202120022212020200222221b01211111110a11
0112211010101202122112222111021110121112111012120210220221201022222221000202222001111021121221022101111111111110111110101111112221222222212120201a21211111110a00
0112111221111211120022121012212111110110021112212202222210222222210222101022221112010222112212022201211011111111110011201120120211111120101221120a12111111111a11
1012112001211212212202111211111111121221011110102222122202222212222121121102022122212110202101021122201011110101111111012222211122121211121212211a21211111111a10
1112111211112211111111101111221011122002220111110122210122122212122111112100122102022222012211112122021100011110010110112111221221120212222112011a20201111111a11
2200111221001121021002120121111110111111101021000101002122122101212221222122220100120120222222110122210111111111111001111112112022212121022222112b20110110111a01
1011002112022221222211121111022111112121100220221122121022002022011222000010222221200222110001221212000100112012112111102221201222200001220201222a01111111111a11
1211002112212221022021022211100001020211120221211220122220002102202222120202102200222221211110112101101221011220221211212021220222220222211012222a22111101111a01
0221210201222012110101022110000111122222120211112212210022122222121022222202202222011121112200200222111012201021102010210220210122022221221121200b11111011101a01
1222202222202122022112121212222011000120122221120102212002222221210000210022220202112102112120022020221022020010111202210222000022110102101210121b22111111111a01
1111111111111110111111111001101111111220201020011202212002212102112210111101120110111111100111100111001221222000222220222210122222221212102120112a00111010101a11
0111011111010111101111011111111111120121121221201201021202021222121012110022212111101111101101111111011011122111110212222201102212212210120220211b12011111010a11
1111111111011011111111111111111110101020121112221020211222122222102122111220111211011111111111111111111221121122102101120122022020122102220112111a10111111111a11
0111111111111010011011111101111111012221112011121202221122222212211212011112212211101111111011110111101201121100012211212211220211122112212210121b12101101110a10
1101011111111111111101111111001010102101112111102001022222200112211111122020122210011111111011111111111202011111021101122121111222112022011100022a22111100110a11
1101011110101110111111110111110011122012122122121222221222222110022020022111102111110101011111101111101012111002022111022202222222012022120122111b10211010111a10
1111011111111110111011111111111111010122222210012221002221220122121201011211221201111011011111111010101111021212112100112222222102211011121111111b22211111111a11
1011111111111011111111111110111111112011221201102212220222122211221220012221222211101111111110111011111112002111222222021212022221221211201200102b12211110111a01
0101111101111111111011110110111011101212001111012220022222222222111112212121102101111111111111011110110220122122102012112222222222101021122210222b21211111011a11
aaaaaaaaaaaaaaaaaaaaaaaaaaaaaaaaaaaaaabbabbaaaaabbbbbbaabbbbbbbbbbbabaaabaaabbbbaaaaaaaaaaaaaaaaaaaaaaabbbbabaaaabbbbbbbabbbbbbbbababbaaababbaaaba21111111111a11
1111111111101111111111101111111001101212222021121211002112221222211201212021122011111101011111111111110201001221112101221220022212122212212112010111211111110a11
1111101111111111000010111101101111122102211112210212210011000222101111111111111111110111011110110101111120200212120201010020020002212011111111111111111111110a11
1101111111011110111111111011111110101010022102221122220211211222121111111111111111010011111010111111111222120121120112010222122020011111111101111011110111111a11
0111011111111111101111111111101111111110211102221122122112212120101111111111101010111110111010110111011111222112200202010121212022220211111001111111110011111a10
0111011101111111111111111111110110020112210221210110211120122121201100101101111101111111011110110100101121112121100010012221200120002011111111111011111111000a01
1111111101111111101111111010111111121120022120120111111220111111221111111011111110011101101111111111010212221022101001212221021102220011111111110010001111111a11
1011111011111111110110111110111101111111011111111101111011111111110110111111001101110111111110110110101122122111210222121122220212102101111110111111111110111a10
0111111111111111111011011101010101111111011101011111111110011111111111111110101010001011111101111010001221001112001211102201202101112111100111111111101101101a11
1111101111011110101110111111111101101111111011011111111010110111110111111111111111111111011110001010111221220111212122211212222211221210111111101111110100111a11
1110111111111111011010110111111101111111110111101111001111110111111010101111111111101111111101111111111221210011210011021112101112220210101110110111011111111a11
1111111111110111001111111111110111111111111111010011111011111211020122200121012221202121212111111111100112101012212201121021220111111201011011101011100111101a11
1000111011111101111101111111111111010111111011011111001101111211222111101122002010222202122211011110000112122112120111002222010021212100101110111101111110101a11
1111111111111111111110101011111111100011111111110111110101101111202112222222221212111210102111111111011210101110110122210212121002221011111110110111111111001a01
1110110111111111101001010111110111011011111111110011111011110221111122221011111211220201212211111111010111121222212121211112211202220211111111111000111111010a11
1101111111001010111100111011111011111010111111111111111101011220122121112211212100101012202111111110111121220111022102011221211122110111101110111111111011111a11
1110001111111011101010101111001111111110100101111111111110111011110211222011210121122122220011110010111122211222112122111222112211112110111100100101111111111a11
1111101111101011011111111101111011111111111111011111101111111112121000222010110111120222021211111001111122110210121212122101211221100001011010110111011111111a10
1111110110110111111011111110011011111111111110111111101111111110111210222121121120201212011211011111111111111011111011111111111111110111111010011010111100111a11
aaaaaaaaaaaaaaaaaaaaaaaaaaaaaaaaaaaaaaaaaaaaaaaaa101011111001212210201221021120210011102011201111111011111110111110011111111110111111111000110111111111001010a11
111111001111111110110111100101110111101111111111a111111101111100212222202111112120212101211111111111101100111011111111111111111111111011111111111001011110111a11
111011111101111010101111100111111111111111111111a110111111111011112222120211111110210121212011111111111111111111111111111101111100111111110111011100111010110a11
111111111111011110111001111101111101001111111111a010011001111110120121121021122111210211211111111111101111100111011101111111101110010111011101111011101101100a11
111111111111111110111101011101111110111111111101a111011101110021121120112120100201201002011101011110101111111110011001111111101101111110011101111010011111001a01
110111111111100110111111011111110011000110101111a111110111111022100212120212222122121101211211110111110101011111011111111111101111011110111111111111101111111a11
111111000011111111010000110111111011101111100101a111111010110122100222011221121002122010112111011111111001111111110111111111110111011111100011011011010011110a11
111101111111101111111110111111001111111110110011a100111011101121201021220111220122112111122211111011111011110101111101011111111101111101111101111110111111111a10
111111111010111001111011111001111111101011111111a111111101111021101122001022201121120122112011111111011011101111111111111111111110011111101011101111110011111a11
111110110010011111111111111111111111110100111011a111101111101212122222111110011011010022121211111111111111111110111101111111111101111101110111011110011111111a00
111111011011111100111101111111111111101110111101a111110111111122220112211211111121020021101111111111111111111111111111110111111111111110110011111111111111111a10
111111110111001111111011110111011111111111011011a110011110111112222002111111220210102121201001111001111111000111111111111100100111101101111111111011111111110a11
010111011111000110111110011111111101111010011011a111111111110212021200112101021102222212212211111011111111011111011111010110011111111111011111111010011110101a11
111111111011110111110011111110110111101111111111a001111110111102221112222212220202012211012111111111110111111111110110001101011110111111111111011100011101111a11
111011111111111110111111111111111111111011110001a001101111111212222201020111021012002011120211111011111011111101111111111101111110111111100110110110001011110a11
011101111110110111110111110110101111000111011110a110111011111101211022120221211000122022002111011101011110111111111101111010111100110011111011101011111111111a11
111111111110111011111101000101110100011101111111a111011100111221221101221021012111212220222211111111101111110111011011110011111111111111111101111111111111011a11
111011110111111111110101111010111001111111111011a111110111111121211122122012102112122022121100001111101111111110110111101111011111111010110010111101110101110a01
111101110111111011111010111011101101111100111110a110110011111222212121102211222221122201112211111111101111111110110100111111111111111100111111111110111111111a11
111110001001101111111111011110110110011011111111a111111111100220222001002122202222101122111210111110011111111111111001111100110111110101110111111111101011011a11
110111110111111111110110111111111110110111101111aaaaaaaaaaaaababaabbbaabaabaaaabbbaaabbbababaaaaaaaaaaaaaaaaa011111101001011101101110110111111111110111110111a01
111101101111010101111111111101100111110111111111111111011011122221012221012001220112110121021111111111110000a111111111111101111001100011111011000101111011111a11
111111111101011110110011101111111111111111111111111011111011021202222120112121221112111110101101111111001111a101111111111111111110111110101011111111111111111a11
111111110111101111101111111011111111111111111101111111011011011101111001111111111101021112021110212210010102b001111001111111111010101111101111111101011111110a11
111111111111111110100111110111111111101111111111011111111110101111111111011101101121111200021122111100212212a101111111111111111111111111111101111100111110111a11
111101111011011111111001001101110101110111011110111011110100111101111111111111111111212211022212221201122211b101111111111111110101111110111111011110001111111a01
101100111010011011111111111011110111111111011111011111111111111001111111111101000122112120012121022020211012b112211111111011111111101111111111100101111111111a11
111111111111101100010110111111101111011111001111111111111111010111011011111110111100211221201211221101211110b010200101011111111111111111111110111101101101111a10
111111011111110101101011101110101111111111101111110001111111111010101111111111111110120210201211211002111112a121211111101011111110100111101111111110011111101a11
111101111111111111111110111110110111101110110111111111111011110110110001101100111112122111102221122212222212b112111011111111111101111111111111101111111111111a11
111111111101111011101101111100101111110011101001110111111111111101111111000111110112022112102221112201220000b101000111101011101011111101001111111111111101001a11
101111111110110011111111111111111111001111111011101111111110011111110111110101111122211222221200111110001222a102111010011111110111111010111111110111011010111a10
111111111111011101111111011001111111111111010011111111101100101110111111111110011001021022221212221221121111b022200101110111111110111011111101110111110011110a01
111100111001011111111110101101010110111111110111111111100001010011111111101111111101012222211212012011210111b211211011110011011101110111110100111111100000111a11
111001101111111011110111001111011111111100111111111111011101111111101111111101101112201212212022200121012222a201011111011111011110110111111111111101011111110a11
111111110111111111111011101011001111110101111101111011011011110111111111110111101122221201211101211111112102a111201101111111001111110101111110110010111111000a11
111111111001110100111111010001110111111011111111101111111111100101101110111111111121221111121010201221122222a012110110111111111111111101001111100111110111111a11
101101111101011110111111110111101110111101111101111110110110101111111111110011111122111112120021210121200212a210001111111101111110111011111111111111101011111a11
111101111010111101111111111011110101101110110111101011111101001111111101110011111121120221112110211112220102b020211111110111111111111111111111111111101101110a11
111111101111111111111111011101111110111011111111010111011111111111011111011110101110202010201011012001122112a222001111101011101111111101111111111110111011101a10
111111101101111111111011011111111101111111110111101100011001111110110111111100010111220202110122122222012121b221211110010111110011111110111111101111101111111a11
111111101111111011101100111110111111111111110110111111110101110110111111011110110111222122011211221210112021a212200111110110111111111101111111111111011111011a11
101111011110111101100101111111101111001111011010111111111111001110110110111111111121211121121111021120220212b222111110111111111110110111111111111110010111111a11
111111111111111111011011101111111111111011111111110111100101011111001011111111110102010222221112122111121112a212210110110111111011110111111111110111100110110a11
111011110110011101011101111101111111111110111111111101111101101011111111100101101121110101011211212220222200b101011100011111111111101010111110011111111110111a11
101111011101011111111111111011110101101100111101111111011011111111111011111111111111120211102212022120021201b121111101011010111111110111111101111101111101111a01
111101101110111101111111111110101111111011111011100101111111001110111111101111111102102211121111022222221122b111111111110011111101111111111111111011111111111a11
011111111111111101111101111111111111101111110111111011111111001010111101011111111120210221211022012222102120a201101101111111011111111111101101001111111100111a01
111101100111111011101101111101111101111111011111011111011110001111010101111111101111002212021121122011100121a211211111101111001011110111001111111011111111011a11
110111101111101111111011100111011110110010101011111011101101111111100111011111111122120121202120210112202101a122211101101101111111011000111110111111111111111a11
010110111111111111111111111111011111101111111111011111111111111110001111001111111022200210221021121220201121a121201011111111100111111111111111101111110111011a11
111111100111111011111001110111111111110111110111111111111111111111111111111111010121021112222011211120111122a002001111111111111111010111111011011111111111011a10
111111111111111111101111110111101111111111011101111110110001101111011011111111111111102001202211001111010011a222111111001111100111111011110110010111111011010a01
011100011111111111111110111111111011011111001110111111111111111111011111111111101112011222121022221112112110a022011111101111110111011111111101011111111111101a11
011111100111111111101111111011011111001011101110110100111011111111111111010110101101110111110111111111111111a111111001101111101111111010111111011100111111111a11
111111111101011111001011110111111111011111110111111111111111111101010111111111110101111111111111111111011111a101111001111111011011111110111111100111100011101a01
011110110111111111101110011111111111111101111111111111110101110100111011011011111111001111011111101110110111a111111111110111111101011111111011110110111010001a11
110011001111111111110101111011111111110111001011110111100111111111111111111111101001111101111111111011111111a111111111100101111100011111111111110011101010100a11
101101100111011111111101011111101111110111101011111111111110111111110111111111101111111111111111101111101011a111110111111111011101110011101111011111111100110a01
101011101100110111111111011111110011111111111011110101111010111111111111110111011110110111111101111011011111a111111111101110111101111111110000111111111110111a10
111101011101111001111111111111111101011011111111111110111111010111100111111011111100111111111111111111111111a111101011111111011111110111111111111111111111111a01
