17 10
132 106
118 42
15 7
76 66
86 2
64 26
50 31
133 26
97 97
0221121012002020010220201020022111111111101111101110a110111111110011110112212121011012111120002a0100201110110110111111010111101111111011101111111111110111110101
2220112122112001122221010212122111111111111011111111a011111011011111111122221121221012222201122a2122211111101101111111111111111101011111111111001010111110010110
1211110121112121120022122221222011001111110011111111a010111011101100111102221221212210220021222b0112021101111010111111111111111111111111111110010011111111111000
1120201122122112221211112121022111101001111101111111a111111011001111101121122211011212101222222a1220120001111101011111111111001111011111110001011111100111111000
1121212112111202100012020121211011010101111011110010a111110111111111110010021001022121222211102a1012111100111110101011011100101111111111111111000011111101011111
2121201202021111221111211122222010111111111111111111a110111111110111111010202201210222121211202a2122101011111111101100111111010101111011100101111111111101111111
1021012202122220202212202201122111101110111111111111a111001111111110111121122111221111212121101a0201101111111101011011101110111101111101001011110110111011111011
2211111102221221121210211001121111101110011011111111a111101111111111111012210212211221211122112a2121120111110111111111111111111111111111110011111110101111111000
2102212200122110022122222102201100110101001111111111a001111111101110110211222221112020111120221a22202001111111111011111aaaaaaaaaaaaaaaaaaaaaaaaaaaaaaaaaaaaaaaaa
2112122100100112012221221221211111111011101111011111a111011111111111111211012102012022222212121a02001111111111111111111a1111011111111100111011011101111110111110
0201120211101121110011022000122111101011111111101111a011110101010100110200110102101112010101100b12210101111111111000011a1111101111111111011111110111011100111000
1021022212121211022121010121021111101110111001110211a121122210112212211222022212221112010200112a02002111111111111111112a0212222202111222212122022101201110110101
2100021221220112222102201112201110111111111011111120a012122222112200112221022220001121211010011b11011211111111111111112a2222221111221101122112211210211111110011
1212211111221102022011222020202111111111011011111012b022222221211122112002210221221201121210221a12022110111011111111112a1202211012210211012121221211011110011111
2110212220212202211212021121222101111111111110111220b121021110012211121122002222222022012111012b11212111011110111111000b2100020122112211011212212102210010101110
2222101102221220222222222121110111110111110100101112a021110011210211120212212112012222211221102b21111211011111111110111b1221221201012121222010222212001111011011
2122121222102121122212012102012111002221012120220102b202020002201022001212012222210202212000202b12111201101110010111112a2220112220112220222221020121111111101111
0021011102101121212110120222112111122220121210201202b222011101222211211201220220212110212221120a11011210100111111101111a2122210210111011202121212122211111111011
1111222111011112112011222112000111120121001122102121b112202222122002111122222220221200012111210a11221011111000111111112a1120222022011120122202021121201111011110
1221122221001010101222212211202010111202221222012212b110222222111011211222221222120022211221022b02122111111111111110010a2101121110222222222211112001200111111101
1211111120112211002200201020000110012221101012021212b202002122020112002122010221110110120222222a22121110111111011101002a2212101121001211220121220022111111110111
0221212020102110102112001211200111021201102112202222a220222022201222122222202122112011212211101b00011211111110111111111a2021022221121212112122112211111001010111
0122001212221120121122220111021111122111122011221222b122102212101022021202022022121120202220211b01011110110101111111111b1121222112002210211211111221111111111111
2121121222010221220111111110210111122101211122122112b022221221120201012212220122122112201002111a11102111111111011110012a2111221022022222111112221221211111111111
0121111222112111110120211121121111112112212212110202b102212201121122111212222202221111101001121a12110211100111101011010a0112112120101010121212110112111111001110
2202112201011222100221121111200111121122111200221111b222122212022200121222221221212011000002110b21220211111111111111112a0121011111201202122211220101211110111111
2212222020002210111221122101212101101112122110020221b220021211122101020022022202121101012012010a22022200111111111011011b2202211122101010110022212202111111100111
2112220212212121102112111111220000121121022210110222a211212211222120110211222222221120212221101a22111202111221221202202a2221122022222220021121121121111111111110
2020210111022121121010022212111011102120121201202002b221222022012200211122211220201020220201122a11111011110122221120200b2222222011212022222100221121211001111110
1201122222222212200212211120222111112202122110222220a222210022221120111000022222200122111111120b11212011211112221201202b0210222220202221120221222212211110111001
2022022221212201201122010210122111012212120012120212b112202222000112220100222122112022112022121b11021212222211110221100b2221210102122121011112120011111111111110
1111111111111001111110111101111110111122012210012200b201022000120212122121222212111101111010111a11101112212211200220212b1220220222112202011121222112211111110011
1111111011111111111111111111110100011222021222220222b220222222222210122101020001111111110111111a11011112122121221121000b2222220212202021122211102222111011111111
1111111111111111110111011111111011111021111112220002b220202222222222201212001221111111111111101a01111101222212022221222b2222122222111211021122221112111011111011
1111111011010111110111100111011001111101222221120022b212200112022210021221202202110101011001101a11111112011220111012220a1222202222222102211220212221211011111011
1110111101111111011111111111111100121210222122120122b212112002222211202212121101110111111111111a11111111121110212012212b0212212122222012212210122211211111011111
1111110111111110111101110111111111110211202220210222a002221202202101121222112112101111010111111a11111112211021222210102b2200202222022212201211210211111101111111
1111111111111010111110101010011111122002111121122211b220121220002202222020211122111011111000110a11111111012012121121212b2012212222012221020122212211211111000110
1111011111011010111011111001011101022012000121002021b222210202222221112112211212111111111010100a10111012112220212121101b2020222222222210121100202011211110111111
1011110100101111111010110011011110111010202222010120a120111222220222000001001022100011101111001a01111112221011212021202a1121221011120222012221111121011111111011
1111011111111000111111111110101111021122111112222122b000020220122111201121201111011011111111111a11111101221111220121112b2120202222211211012211202211211111111011
1111111111110111111111111110111100110022211210210222b221220221220201221022121111111111111011101a11111011222121222222110b2001211202120201201222221120111111011110
0111001111101110111100100111011111011101021221112010a122120111021111111101111111111000111111111a11111111122021111102210a1212221211111211010111111111101111101100
1010101101111111110110100111111111102210112020111102b102020222211211111111111111111111111101111a11111102201112112111021a1210002221212211011010110111111011111110
0110101111111111011111111111111011110221020222111111a120211112100211110111111111111111110111011a11111111121212101020201a1102121112101111101101010111111010101111
1111110001110011101111111110011110110010200022102212b221121222220000111111011111011011001111111a11111102110111111212111a1001012200121211111011101111111111011111
1111101111101101110110111111011111121220211112022211a122221212221211111111100111111111110110111a11011110211212220212012a1221102112022211110111011101111000110100
1110111111111101111101111111101101111001111111110100a111110101111111111111111110110111111111111a11101110022102120221010b2012222120221110101111111111111111101010
1110010001111011111011100111110101111110100100111111a110101111101111111111111011111101111100101a01111111001110022111000baabbaaaaabbaaaaaaaaaaaaaaaaaaaaaaaaaaaaa
1011101111111110011110011111110111001111111111111111a101110011011111101111111011100111111011111a1110101121222121010222222212100122122111111101111111111111111111
1111111111111111111111111110011111111111111110111101a101111110101101111111111111010111101011111a1111011022112201020121212102112111122211111110011111111111111111
1111101111011111111110110010101011101111111111110111a001111111112022221022201221010221122122011a0101111212110011212122102210011220220111111110010111011111101110
1111111101111111011111011111110011111101111111111101a111000112101022210112211122022212212212110a1001111002210222212212221102211221102010111111111111111111111101
1101111101111011111111101111111011111111111111111111a011111012010110120212211101201111202200110a0111011222101111101121102211022222222011101111110101011111111011
1111101111111110011110111111111110111111111111011000a111111100221211121222012211222211111121011a1111011210111121210221221212222121211111011111111111111111101011
1111111101111011111101111111100101111011100001111111a011111112212001121122100212202211010112111a1111111211112201102212112122112111222111111111010111100111101101
1111111101111111111111011110110101110011111110110111a001111111211221111111201102002020210021111a1101111202212221212211101121112022212010010111011111111101110111
1011111011111110111111101111111111111111111111011111a101011112102112211220122221021120222120111a1111110212122111212211221022220211110201111010101111111100111101
1010111111101110110111110111001011011111111111111111a111110111111211211222210212110102011221110a0111100111111101111111100111111101111110111101111110111111101011
1111101111111101111101111101111110011111111111111111a111100111222111221110222010211212222111111a1111001111111111111111110111111111111110111111111100101111111010
aaaaaaaaaaaaaaaaaaaaaaaaaaaaaaaaaaaaaaaaaaaaaaaaaaaaa111110111120221220110000120101021012011111a0111011111110111111111010101111111111000111101011111111111101010
11111110101111111111111111011101001101101111111111011101011111001000200212002012212111211121110a1111010111111111111111101101011110001110111111110011111111111111
01111100111011111110111111111111101011111111111100111101101110220100012202112122112221212211111a1111111101110110011101111111011111001111101111101110010111101111
11111100111101111110101111111111001111101111111010010110111110202120111202221111220112212022111a1111111111111110111111110111111110111111111111100101111011111111
01101111111100110101111011010110111101111111111111110111011112202200210222111210010110122202110a1111101101110011111011101110111111100111011101011111111101111111
11111111110011111110111110111101111111111001110110111111111112200012211221222001120101222101111a1011111111111011111111110111111111110111101111011111111111111101
11111111110111110111111110111011111110011111111010111111111110122212222212102221111121222212101a0111111111110110011111101101111111111011111111111111111100101011
01011111001101111111111111111111111111100011111011101110101112202221110121101111111021212222011a1011010111010111111111011111011111111110111111110111111001111110
11101111101110101011111110111110101111111111110111111011111111012120201201112222211210210212111a1111011101010111111011111111111101101111011101011111111111110111
11111111011111111101111111111111101011011110111011110011101012021210101120121112120202021112111a1110111111111110011101110010111111110000110101101100111001111100
10111111111101111011111011101111111111101011111111101101101011102111120011110022110211211110101a1011110011110010101110110011101010111111111101111110001111110111
11111101010111111111111111011101111101111100111011111111100112101100111022011122221112122100111a1110010111101101111111011110111111111111111111011111101011111100
11011101111110110011101100111111111111011111111111110100111110012202011020212222022001202102111a1111011111111111001101010111111011110111011111011110101111111100
aaaaaaaaaaaaaaaaaaaaaaaaaaaaaaaaaaaaaaaaaaaaaaaaaaaaaaaaaaaaabbabababaabbbbbbbabb21210201122101a1111110111101010001111101111111011111111111111001110111111111101
01011111011101111101011111011101011111111010111011001011011112120020112111111011b20212012101011a1111111111111111111110111111011111111111111101011111110011111011
11111101111111111100001111111111110110111111011111111110111112211211222120222110a10202222221111a1111111011111111101100111001111110111110110111101111110000110111
10011101111111111101111111101101011101111111111101111101111100211122222110011021b21120110111111a1111111101101011101111111111111011101110110110110111111111110111
11110011011101111101111001111111100011101111110110100100111112220120121111210112a01101100201111a1011111110011010101111111111111001101011111110101111111101111011
11011011110011111111111111011111111011101101111111111100110111221212001212210111a21210000211111a1111011111111111111111011111111101011011111011111000101111100111
10111111110111011011101110111011111110111111110011111011111111211202110111021012b12201122121101a1111111010110111111111010111011001111010111110100011010100111111
01101111110010101101110111001111001111101101111111111111001011021212011102211221b00121222002110a1101101111011111110111011111111111111101111111001110111111111110
11111111110111111111111111101111100111111011111110110111110111222212211102200112b21210021001111a1011110111111111011111110111111111001111111111111111111111111111
01111111111010111111111111011011101111110111100111111011111111101111011110110111a12111122112202a1222211221022002111011111010111011111111110011111111110101011001
11111101001111111110111101111111110111111111111110111111111111011111111111000111a11111122212020b1122011222220002111111000111100001111111111111111111111111110110
11100111101010111111110011111111101011111010111100111101101101111011001111111101a11112121100212a0021001121102212011111111111100111111111111010011111111111110111
11111110111011001111111111011110011011111101101001110111110100011011101111111101a11221212221112b2012220000000111101001111111011111110111111111111111011010011110
11101111111111111111100111110101101001111111111110001101011111111010111111111111a12212211001221a1222121001121101211011111111111000111001101111101011111111111111
11111110111111001110111101111111110111001111111011111111101111011110111111111111a12120121001110a2212121111120012011101101111111111111110011111111111111111011111
11111100111011101111111111111111111111110001100111011111111111111011111010111111a10212101102012b1110221121121112111110111011111110101100110101111110111111111111
11011111111111110101101101111111011010111101111101111010110101101111101111101111a11221111120120a1020212112212101111101110110011001110111011111111011111011011111
11001110111111101100111111111011111111101111111011111111101101111101111111111111a11102122221002b2121211222011222011111111110011101111110111111010011111011111111
00111111111110110110110111110111110110111001110011111011011111111111111111010010a12221222222222b0220110122212121111110110011111111111001101011101110011110100111
11011011111110111101011010111111101101111101101111110100110100110101111001111111a12121112211122a1202212120011212111111111011100111101101111110111111111111111111
00101010111111110011101110111100111110111111111111101011111101011111111010111110a11101012222222b1211212221101102111100110110100111111101101011011111011111101111
11110101011110111110110110111111111011111111111110111111111101110111111111111111a12211221021022a1022002212121111211111111111111110111111111011010111101111111011
11110101111110011111011111111110110110111001111101110001111111110011110111111110a12221202122201b2011011221222020201011111110111111111011110110110101111111111111
11110100111111011111111110101001111111110111111111111001101111011100111111101111a10200121102012b2112110101111211211111111111011110111101111111011111101111111011
10111111101111111011110110011111111111110111011110111011010111011111110111111111a11211111120202b1212222211221122110110111101111111110111011110011011111111111011
01011111111110111111011111110111111110101011111110001111111111011110111111011111a12000101221010a2112102112210111211100111011110101111010110111100011111001101111
10111011111111111101110001011100111111111111111111111111110111011111111111101111a12212211111112a2211121011222212100111110111101111101111111111111111110111111111
11111111111111011101101111111110101001111101111011011101100111111111101111111111a11112221200122b2221121111120112111110101111111000110111110011111110011011111011
11110110111111111111111111111101101101111111111011111011010111110011110111110111a02221210112120a0222021111121120211110110110111111101111001101110110111011111111
11111111010111111111111001100110111011101111111011111101011110011011101111111111a12201211222211a1111212121111101211111111111101111110101010111011111111111111110
11011111111101010111010110110110001111111110111110111111111011101111111111110111a10211010121011b2220221002111210201010111011011111101111111111111101011101111101
11010110011111111111111101111100101101111010110111101111111111111010011111111101a11001112110121a2110011122111201211111011010111111101111111100111010110011101111
11111101111111010011111101110101001111111111111110111111011011001011110111001111a12222112122212a2102120111022101211111111111111111111110101111111111111111111111
10111011111111101011001101011111101111011111110111010011111111101110111001010011a12022101002211a2112222111221111111111111001110111111010101110010110110101111111
11110101110111111011111111111011101111110111111111110101101111111111111101111010a10212102100122a1112122201221201011111111111010101101111111111111110111111110111
00111111001111101111101101111111101101111111111111000101111111111111111111111110a10112121211201b1111201122022210101111111111100001111111110110111011101111111100
11011111110111111111111111111111101101101101111010111010111110111111111111100101a10101212201102b1011111222022120101101111011111111111011011101111111101111111111
11111001111111010111101111111111111010101111110011111110111111111111111101111110a12212221212122a0121120122111021110111110111011111101011111101101011010111111111
10100111010111111110111110111111111101101111011111111111111010010011000101110011a11111222111221a0221122220220202011111110111111111011111111111111101101111011101
01100101110111111111111111111011110111101011010101111101111111111101011101111111a01221120102021b0222111210212121111110111111111101101011101011111111111111100111
11101111111101111101111111111111011101011100011111011101111111111011110111111111a11011101111111a1111110110010111111111111111011111100111101110111110011011111111
11111101110111111110111111111110101111110111011100111110011110111101011111111111a10101111111111a1111111110111111111111001111111111111101100100111111111010110111
00111111110111111100011111111101001111001101011010101111110001011111001110011101a01111111111110a1101010111111101111111101111111111111001111100111110111111111110
01110111011011101100111011110111111111010111111101111110011101110010110110111111a11011011111111a0011111111101101101111111101111100111011111111110010100111111111
10110111101111111010001101001100111011110111111111111101111101111101111111110111a11101111111111a1111111111101111111101111110101111101111100011111111111101111111
11111111111111110111101110011111110111011101111011111011111111111111111111111111a11011111101111a1111111110101011111111111100110111111111110111101111011110111111
01111011111110011101011111110111111111111110111011110111110010111111111111011111a11011101111011a1001001100101111110111111111111111111111111101111100111000111011
