10 104
107 13
118 42
15 7
76 66
86 2
64 26
50 31
133 26
97 97

111222211212212110122202011102110011111011101111100100111111111a1010111212220211b1212b22220210122111221111111110111111011101111111101111111111110111011111110011
211201222111112101201211112110211111101111111111101011011110111a1111111100020220a1020a22211211011012221001111111011111111111110101111011111111111110110101111111
211201022212122022012121212202211011110010111111111101101111111a0110111210110221b0011b11101112202112211111010111011111111111110110111111111111011100111111101110
021121010122212110012112201212111111011011111111010010011111111a0110110012212221b1101b12121221110112110111011111111110111010111011110101111011111111001111011110
112210120010220012100212111112210101111111111110010111111001111a1111111220201020a2012a22222121111121001101110011011101011111111110110110011110001111111111110010
102222020212112120210212012010100111110111011101110111011011110a0110111221011210a2221a11121021210101011111111111111100110001111111111101101101110111111110011111
202111122120002112121012221011211111110101111101111110111101111a1011011212001220b0110b10002200101110101111111111111001101111111000101111111010110111111110111111
211122212212200112220111202210211111111111111111111100110111111a1111011211222111a1012a10212120120222211110111110011110101111111101011011101111111110110111111111
201110021111120111220111221101000100011111111101011111011111111a1111111112202211a1212a21222222211122121111101110101111110111111000010111101101100101001110011111
210011121202121211022110221010211100111011101111101111111001011a1001111221021121a1112b11111221211022221011011111111110011111111101111111111111111110111100111011
111011222211102020211111012220201101110111100111111101010101101a1011110210110211a2102a21212101100110021100111011110111111111111111100101111110111011111111111111
122212201121101221201112002122111111101111110111021210212220122a1111211222202211b2022b02221211112022121111111111101110111211221222212221002212111211011110101011
220112012120222112120121222001201111110111111111121222220112121b1110202222211220a1122a21001222212221211001111001111111202122221101100212100122121211211011111111
022220122010101211011021111222201001011110110111121112122112021b0201202220212222b1220b21111221211121121111100101111111112022120222121201210102210012111011011011
111121120112001211110212021220110111111110111111111121220100210a1121122122020101a0121b22021221211221211110111110111110022212110101212010111120200110111111111101
100212110022110121122212012201111110111011111001112211121111220b2011201020022020a1011b20212220110121101101011110111111121221200011021120121220022110211101110101
220212202211112211122211211112201110121120222012200202220020202a2012202022222222b0101b11122111201111121111110111111111020012112021211101220100210011110011111000
120211021101210221221201001121210101221110122222222221012122122b2212110222222200b2010a20201211021121221101110111110111111110211211212111202221001010211011111111
011020121011011112022222012212110111212222111102202122222220002b0211112212222022a1210b21111221102112121111001111011111112212212221012011112220212200211011111111
112211122212222121212022210212211112212200022211100202212022222a1022212002212122a2112a22222122110211111011111111101111222222202121110201222112111011210111111111
212212112221011202000122112101101111110121121020102021222220022b2010222200011221b1121baaabbaabbbababaaaaaa111111011111121211212211011112222211012100211101111111
111100222012021220111021121202011111221111012210202022211121222a1202022121122222a110122212211010222221111a010111110111221222102010221212002011212112201111011111
021101220212211212122122112212011102022220221112210022120211222a2111111221202222b222110121001011021002111a111111101111111020122111021111210201212122211111010111
000111222211220022112111121120211012122020222212122220222222120b2201211121222112b112112201102012211011111a111101111111121211122200022212112210200112211000111101
111010122110120020021210100112211002020100112012221022220110222a2101222222201211a100121001021222121200110a101111111111211012221001221221201202120200111111010111
220102112110212221221120021222111101121112220212101222222222202a2201212222122211a210121121121210221102111a111101111110101201111221212212110021202202011111100011
220110111111211012200220122222211111212001100021121122111002222b0212221022222210a102201222001221121021011a111010111111101102211221212120000221112102111111011011
102102112212122221202221111211110110121012111212212112222222222b2201121121222220a221012212222212021122102a211221201210222001112201202221120212111102211111111111
211201111212211112212011221212211111211222212122100211222122001b2220101221122110b111210100012212121122111a222101122001221212220202222022221111102221110111111111
212202022101222211101121012022001102020221001110222222201011101b2001201111022222a122201102111122202121111b121000111112222222221100221202121100122111010111111111
022111111201010220211010021111210102122011002021222020202202212a2111022221211201b002210121211012022220111a221012120122002221121110222012001112012212201111110011
001111110111111011111111111011111111111110202121102220120222222a2210211212211110a111011111111111111111022b122222201122212002002022122220122121121021201101111111
110111101111111001111111111110110112201222011122022022212210022b2221002112111101a111111011111101011111111b221111221212020222201112212212121212102211101111111011
010100111011111111111101111101111102021111122121122000212212221b0211210212012221a111110111110111111111022a110022102012201122022221002011211112111222011111111101
111111101111111011001111101101111111212210102012222122221222001a0210122111010122a111110111111111101111020a012121202222212220222221210212212021102212011101011111
111111110111110110111101111111101112212122122212120222122222121b2121110101010220a101101111111110111111111a020012220020121220001022222122201112200202011110111111
111011111111111011001111111110110101221021120122220222022221222b2101100212022122a111111111101111110011120b002211101112020112201220222200111211020022210110111101
100110111101111110111111001011111111220210112110122202222222201a2221210122211222a101010110111110111111111b021221200202120221202110221221002011202022111011111000
111111111111111111111111111011110001011122011211122122212202222b2220211222211211a100110111111111111110121a022212112221102222200102002222212200202011111111011110
111111100111111111111111111111110111222120212210222022222102212a1111221211010120a011111010111111111111120a211011121212222222122222112220100101211012211111111110
aaaaaaaaaaaaaaaaaaaaaaaaaaaaaaaaaaabbaaaaabbaaabbabaaaaabbaabbba2221221222100122a101111111111011011111122bbababbbabaaabbbbbbaaabbbbbbbababbbaaaaaaaabaaaaaaaaaaa
11111111010111111111111111010111010102012222222110022220202212201212211221112100a1111111111111111110111021112220101210021222221022200202110111202101210101101010
11111111111111111111110111011110111112020002220121101112200121021111111011110101a1101111101111111101111121022211211011112022211110222211111011111110111111110111
10111000111110111100010011110110111022211221121212221222011111021211111111111111a1111101111111101111100210111111200221020121101202020211110011111111111111101111
11110111111111111110111110011111101202120112121221102121100202121111111111111111a1111111111101110111111212100120212222212201221122122201101111111011011111101001
0101111101111111010010111111111001121101baaaababbbaaaaaabaabbbbabbaaaaaaaaaaaaaaa1010011011110111111011001212221021012120110220021021211011111111111111011001111
1111110001111111111111111010011011000102b21212121212122110211212211011111111111011111111110111110111011011112202212212002011111121011211111111101011111111110111
1110110111111011110100101111101011111001a10101111111100100111110011111010111111011001111111111110011111202122021212122210201021111111110111110110011111101011111
1011101111111011111101111111111101111011a11111010101111010101111111001110110111111111111110111111101011012210211012212111112200221222111011111111111010110011001
1111011111111111110110111110111001111111a10111110110111011111111011111111010111110111111110100111111101122001102111012122121112122112111111111011101111111111110
1011101110011101111110111110110101111111a11111110101010011111100111110011110101111111111101011111111111122120011222211222112212022211111011111111111101111111110
1111111111111111111011111111111011111111a11111111101011111110111202111210221122022212111220211101101111112221110012221211121021111201210111111111010111111011110
1111011101011111011010111010101011011111a11001011110111110111012221211212121202112201222112211111111100011222111221121221220121121121110111101010100111111110111
1000111111110000010111111011110111111011a11111101111101111110121200111120201221101122010021211110111110000122112110110122201011112111111111110011111110111111111
1011011111010111111011111011101101111010a11101111111110111101221220100111122121010121211210201111110101122100101121211112222022021212210101111011101111110101110
1111011011110110101101011111111111010011a11111111011001111111112221212112221111102221222021211111111111221221212112200221012102121211211111011111101111111111111
0011111101001101011111111110100101010011a11011111111011111111212120202012120222112222102101111111011110212112122102121112012112201221211111010110111011000111111
1111100111010111110111111111001111110110a11111101011111011111122022201012022100102101120002011111111001212110112122100221010212210220111111011010110100010011001
1101111111111011011111101110111111111010a11111111111110111111110122211020120221202120221011110101111110111110101001011101110111110111111111010011111110111111111
0111101111101110111111111111111111111101a11101111111000111101101122001121200122222001011221211111111111001101111101111111111111111111111010111101111111110010111
1011111101111111011111110101011111011111a11111011111011111010201021110202020222111121100112011011101110111111111111111111000101111111110011111001010011111111011
1011001110110111101110111111110110101110a11111111111111111110222011122202121112021021121122011111111011111110111101111010101111111111111110111110111110011011111
1111001110101111101111001011100111111101a11111111101111111101202121222220121111221222112201111010111111111111111000101110011111110111111111110101101100111110111
0111111001111111100100100111111111111111a10111111111110101101022121222012001211121112211202111111111110111111110111011111110111101001111111111111111111010111011
1100111101111111111111111011111111111101a11110111011101101111222202211221211120220211022011010100110111111111110111010110110111111111111111111111110101011111111
1101111110011100101100001111010111001111a11111101111111010111202111211110022212111222112001111111110111111111111011101111111110111111111011111110111111110111101
1111111111111111111100101001110111111101a11111011011101111110112221211121221212111211201212001010111001110111111110011011110101111010111111111111111101010101111
1111011110111110111111111111011101111111a11111111111111011111201122221221021022010121220120011011111111111111111110011011110101111111111111111111111010011011101
0111110111001010111011111111100111000111a11111111111011111101102211200222201211111122222212011111111110111101111110011111111101111110111111110001100111101111111
1101001111110111110011111111001111111010a00011110111101110110211202121202000211121101111122101001101111111110111011011110101111011111010111010111110111111111111
0100011111111111110111111111011110110111a11110111111111110111011000011210121121112122211122111001111101111011101111111111111111111111111111111111111111011111111
0101111110101111011001111011111111111110a00111110111111101011101011110022211210102021222021111111111110111110110011110111101111011011111111100011011111011110111
1111000111111110111110111111111101111111a11110111111001111011212121012212121111121010212111111111111110111101111110111111110111111111101111111110101111111111111
1111010101111100111101111111110101111111a11111111111101111111212212112211012121201112212112201111111110111111111011111101011011111111110111111101111110111011111
1111110100111101111111101111111111011111a11111101100111111111202200112210221221122102010100200111100110101111111111110101111101111111101111100111111111011111111
1111110111101111011011111111100111011011a10111111010110101111010211012021222121112002122121011111110110110101011110001010011101111101001111111111111111111111111
1101111111101101111111111111011111111111a11110101010111111011200222111110011222210011010011211000111110101111101110111111111101101110101111111100110111101101111
0111011111111111101101001111110110111111a11101111110101111111122201120021102200221200222111100111111011110111111111111011101101110111101110101110111111001111011
1101101001101111101111110101111101101111a11111110110011110111120122211112121121112112002221101011111011111011011111111011111101011111111100111101111101011101111
1000111110111111111111011111111111111111a10110011111110111111120221121110020112220201102122111110111111111011111111101111110001110100111111111110111111111101011
1111101111101111111111111010111111111111a11110111111111111111000222221112011121022121211212011111111001111100100111111110111011101101111111110111111101111011011
1111111110111111111111110111101110111111a10111101111011101111010101211122010211221020222022211011111111010011011111111101110111111111101111110111111011111111111
0110111111110111011110101111100011011111a11111111111011111011111100111101111111111211021211101111010221021111221011111110111111111011010111111111111100111110101
1111101111110101111111111111010111001101a01110111101111111111111111111011111101111020200122121221220121221112022201111101011011100111111111111010101101111100110
1111110111110111111111011100111111111011a10011111111001011111111111011001101101011101212112000021021202201111111011111111111011101111010111110101111111000111010
0111111111110101110101111111111111111111a11111111110100001010110011110111111011111200201212111001212110001022100110101110111000011110111110111010111011011011111
1111111100111111101101011111101100111111a11111100011111111010111111111101111101111121101112221110020201022201120211111101110110111111111101111111111111111011111
1101011100101011011111011111111111111010a11101111001110111111011111101110101111111220121211111211011200222200212210111111111111111101111111110010111011110011111
1111111100001010101011101111101111101111a11111111101110101111111011111111111111011111221222121002220121221212011111111101111101111110010111111111111011111101111
1111110101001110111110111111111101111100a10111111110101111101101000101110111101111002121210211101222000211212012010111111001111010011111111111001111011111011110
1111111001110011000110111111011111111110a01111011111111100111101110111111011111110022121221022211121221010211112211101110011111111111111111010111100101001101111
0111100110100111111111111110101111011111a11011010111111010111111111111111111111001121210220212021211110212121221111111111111111111111101111111101111111110111111
1001111001111111011111110111111111001111a01111111111111111001111100111110111101011210212212121222110220222221121111111010111101111011111011111101111111111111011
1101111111111111011111111011011111111011a01111111111011110111011101100111111110110102112111220112112212011122022110111111111101111101111111111111111011110101101
0101111001111111010111011111110011111111a01011111111010111011011110011011111011110121021100110210020001112202111011011111111110111101100101101101111100001111111
0111101110101111111111111111111111111110a01111101111101111101111001000111110111110210221102012202112211012221221011110110110101111110111111101111110111101111101
0111111111111111111111011111111111110111a10111111101011111101111011101111101101111022211111111221012220111022121011101111111111111111111111111101001111111011110
1111110110111111111011111111011111111111a11110111010111101111001111011011111111011022111111111122220122121222012011111111011110111111110111111111010111101110001
1111010111111101001001101111111011110011a11111111010111111111111111011111111110aaabbbaaaaaaabaabaabbbbbabaabaaabaaaaaaaaaaaaaaaaaaaaaaaaaaaaaaaaaaaaaaaaaaaaaaaa
0111001101111101101111111111110011111111a10101111111111010111111111010111011111a11101220220122011122121211211112101110001111110111101111111111100101111111011111
0110111111111100110101111011111100111101a11111111011111011001111100110101011101a10001120212112111212202012110022011101111101101111011111001101111111110111111010
1101101110101110110000011111001111011111a10111111011111111011110111111110111111a01202202121122021222112010102222111111111110111111011011110100001101101101111111
1101111011111111001111111110111111111111a10111111010111111111101101111100111111a11212111212212212221111212212122201111111001001110111111101011101101111111111100
1111111110111111011111110110111011010101a10001111111111111111011011011111100111a01221121122000121222011220101211011111011011111110011011111101110111101011111101
1011111111101101100111110111110011111011a10011111111111011111011101101111111011a11211201011111111210102212112222011011111101111100110111111111111110011111111101
aaaaaaaaaaaaaaaaaaaaaaaaaaaaaaaaaaaaaaaaa10101011101101111110011101011101111011a01011221202200122201010210112122211111111110111101111101111101101011010011111111
1111111111111101111111111111011111110111011111111111111111110111111111111101111a11221202011012222021211101102221211101111111110101101111111011111111111000111110
1000110101101111111101110111101101111111101110100110111011110111101111111111111a00111202101222221212011012012120011011001111110111101111111111111111011111111111
1111111110111110001001111111111111111110111111111010111111111111111011111011011a00212022000201111021211012201101211111111101011111111101111111111011111111111111
1111011111111111110111111110110101011101101111111111111111111101100111111111111a11210212022211110222202212011202111111111011111100110101011011111011111111110111
1111111111101111110111111101111101000111110010111011110101101111111100111111110a11112110212112021011112010012120111001111101111111110111110111110111101111001111
1111111101111011111111110111111101011111111111101011111110111111110111010111110a00222222112121012020210002122201010011111111110011011101011111111111101111110101
1111111010111111001111101111111101011111011011000010111111110101111111111111100a11211012112112121210220212210122110111110111111110111011101101111111111011111111
1111111101111111111111001011101111111111011111001111111111011110111111111011011a11111111110111111111110111110111111011111111110111111111111000111110111111011011
1111111111111111111111111101101111011111011111101011111111110111111111111111100a11101101101101111011111110111111111001111111111111101011111111111011011111111111
1001011110111101111001111111110111110111111100110011111111111111111011101101101a11110110111110111011010111111010111111110111111011111110111111111111010111111101
1101011111011111111110101100101111111111011111111111111110011111111101011111111a10101111111101111011110111011111111110011110101111111101111110111110111111111011
1111001111111111111111111111001111111111011111101111111111110111110011110110100a11011001011111101111110111111111110001111110111111111111101110101111111111110111
1111111111111001111011011111110111100001101111111011111111111111110111111101111a11111111111110111110111111101111111111111111111010110100011111010111111111010011
1100111111111011011111111111111011110011101010101110111111010001011111100111101a10111111010111110111111101111110110111111111111111111111100110111111111111111111
