69 119
40 14
118 42
15 7
76 66
86 2
64 26
50 31
133 26
97 97

20002201012121022111002100121220a10111111111111111101111111111110101101212102121020101221111221221002011110111111011110a1001111111111111101111111111111010011101
11110122121212221220111111101221a11110110101011101111111101110101110011102110011122211202211110010121111011101111111101a1110101111111011111111111011111111111111
10211110211111201122112112111210a00111101111111111111111110110111111111010120202222120212021211111202110111011110111111a1111111111101010101110101111111111111111
20202112210102211222110201100021a11110101111011010111111111001011111111211220021202201202121121221011011111101110111111a0111110011101110111111111111111111111111
21001222201012212012021221221021a01111110110010111111101100011110111101201120111101221221021110101101201101111111110111a0111110110111110111110100110001111111111
12212201011221211110212221020210a11111011111111111100111011111111011111111022122121122112102121121112110001110111110101a1111110010101111110101011111111110111111
21110121221211121122200022222111a11100111110111111111110111110111111011022201210211122021002122121111111111111100111010a1111110111111111011101111111101110110011
01201000110020100110111111111121a00111000100101110111111011111011110101101210012012100211010222011111211111110111111111a1111101011111111101010111110111111111011
21112122121122012120211101112201a1011110111111111111111111110111100111022211101bbbabbbbbbabaabbbabaabaaaaaaaaaaaaaaaaaaa1010111101101111101111111111111111111111
10222212220220021012211220021111a1111101110111111111111101111011111001010121022b02212200121022122201101111101101110111111111011111101101111101010111110111111101
11212222012111111212021221100201a0111111111110111111111111111111111111002112020b10021212112221211211100110011111010011101111101111111011111000111111111111110111
22020012222122012211100102021121a0110111111101011122202120221112121022021201222b01111021112111212020011111111111111111212211122221200021011112012122111011011111
11212111110022122122221211022111a1100101011111111111221011101220212211201022022a01121201201101111121221110001110110000212121111200120212010221212112111111111001
10122220202221100222101001010011a0111111111111111212211000012011111122220222222b11222212211111012202110111110111110001121211021212210000201122111212210110101111
12221121100101111112212222110121a1110111111111111101122001121012222222221222202b21201101112110222221120001100010100101002121022222012210112110001112211111110101
12021101122001211001111120022220a1111111101110011121022111120220211212122212121b11201012211121212112111110110110101111211221202122211122101222120011110000010011
01112221021212111221021202202101a0111101102122221121020211212221222112101112121b12102221222100112201220111111111111111111222121210101101110122211211210111110100
22221101222211020001210221122001a1112100002122002222120122202121212111121022120b22012102122212012221201111111111111110111112112212122212122101001211101010011101
12122210001202212112121221000211a1022202112111121220121000021122222101220222122b10110221111211211222111110111101111011021111020022222121211012111102211111111110
10110120020012211111211022011111a0102221111022121111212120112222212210102002222a11212100020111111120221111011111101111122112222022212110120201112021210010111111
11211022112002112202101102211201a1120121111122120202201122222222222021012212011b21122001221221001212211110001111111011111211020111121011221100200202010110111111
22022010212221022010201111111121a1110220022010011200222102222212221111110222222b00210120201112102202010111101101110111200121121012012112102112211001101111110110
12221211221012221111000121012121a1120111010120102212002212222021210220112012221b22012121112011011211201111111111111011201221221121212021021220011221111111011101
10122201221102220012202010102111a0121220011121111222001212012101022221112222202a10121222220222221200020011111111011111112012112022012112110111110112211111101010
21102201121121012112121201201101a1122211222121020021221202211011211102101212120b20220121111121212002011111101100111111122020121111212121222000210200211011100111
20101201020200111002122022010221a0012211222111121122020202212022220112121021222a11112112212112122112221111011111111111020020221212021112122221222110001011110111
21222211210200021111020001112120a0111212221210102022022202222222212101212220102a12011210222111001112011101110111011110222211121112221022222021121110111100011101
21021110111211110011211200122121a1122122222111122102200022222222221221212102112b02110221221000021212221111211021222111222021012201122202212222001222201001111111
10120110002121120222111221122111a1012222222202111122222222002222202010212202222aabbabbbaababaabbbaaabbaabaaaaaabbbabbbbabababbbbbbbbabbbabbbaabaabbbaaaaaaaaaaaa
21110210210021201122222011120221a1111111211112120010220202022222211221220222222211221111111011222221221110122222122121122012220022021010111110111111211111111110
00112212220221222101011122110201a1121112222201111222122212002022020221222220220121222202202221202201121212001121121021000210221022222222112111022121211011111110
00011111011011111011100111101111a1110111212122202022222122222022222110111200122100111111111111111111011121122220211212022021010212222021001222101121010101101111
11001111111110010111110100111011a1012201020210221221222212222220120221201011121101111111001110110111101200012212121022020021222222002220221110221220211111010111
11011101111111011111011100110111a1100122021102211222202022222220021220201222212111011111111101011101001121211210012212222222122122122111211200220201211110111111
01111111011101011110111111011111a1122111111222222202020222022222222112112001112111111111011111111111111011121211200201212122222222222112121210212112211111111111
01111111111001101111101101111111a1111001211222121212020212012121022201011211102111101111111101001111111100202020201011122022201202222222011112222112111110111111
11111111111101111101111111111110a1011021211220002012212220221120222221121202110210100111011111111101111222200212020212120020222222210101211201220021211101111111
11111101110111010110111011011101a1021210100212122221202102220022121101022122220111111111101111111110101211212112202112022020212122122221212120222101211111110101
11011111101111110111111101111011a1011022112122211000020020200022202112111211221111111111101111111111111122122212012021200022222120022021222121110111111101111110
10001101101011110111111111111111a0121211222200122222211022201220102021112210221111111111011111111111111112210122001020102100221212222022121201202121111111110101
01111010011011011111110111101111a1122112201110022222011222012122212210212112121111110111111111100111110110102222202110210102212212222201120011001121110111110110
11110111111101111101110001101110a0120111201102021212201222222212212011000121212211111011110111100011110212202212121121012211221122222021011111110212001111111111
11111001111011111101010110110011a1012211111200220211121122202022201111111111111011101111101111101011111212021020120022012122121211112111110110010111111111111111
10111110111111111110111011111111a0111212020212122221220122121112220111001111111111111110010111110111111121220202021122110112212120211010101111111101111110111111
11111110101111111111111111011101a1112201101121122121112102221222121111010111111111101110011111111110101120202012221222112122121021222111111111010111011111011110
11011110101101111111111111001111a1012222122201122102212111220121011000111110111111011101111110011111011120211202102121221220111022221011111011110111111111111011
10111111111111101111111111111111a1021012102221220211221221120212111111111111111100111101011101011011111221112012220001221221200221222211111001111110101011010111
10010111001101011100111111011111a1111011011110001111101111111011111110101111111011111111111001000101011211112212110110102200210111001110111111101111111011111111
11111111111111111111111011101011a1111011111111111111111011110101111111111110111111101111101111111001011221100001221221202121212222221201101011111110110110101111
11111111111111001011101011111111a0011110011111111111111111110111101111111111111111110111111111101001001121021100121212202111212212122211111111001111100111111110
11111101111001111100111111111011a1110111111111111100101111100101111100011111111111111111011001011111110111200221220121111212222211112211101110010111111101111011
11110110100111111111111011111111a1110111111111011111111111111102122212202012020111012112002011111011111112221001102102022112221221211101001101111111111111110111
10100101111111010111110111110111a0111001111011011101111101111212121211211100210102220200112111111110111212211010101221222212002011121211111110111110110111101111
00101111111101101111101111111101a1111111101011111111111111111101222121002211221120122022121211111110011222122012221110011122111011222111111111111111111111111111
11010001011101111111111011111111a1011101111011101111111111111111122210221211121222111102101111111110111201021211120122120112221210112111001011111010111111011111
11111011010110111111111001111101a1011101111111111111111110101202120211012020202010021121212001111011101212211210022211001120012212212111111111110110111011111111
01111110111111111011100111111111a1111111111111101011011110111122212121101222221011021122021111110111101212202210221020111001201120122110111111111111111011111111
10111011111001101111111011111100a1111111111111110110100110111010022202121212122011211122012210111101111111022220200100122220201211012111101111111111101001101111
11111111111111111111111110111011a0111111101111111011111001101022221221111111021010210021110110111111011111110111110010111111011110101010111111100111110111100000
11011111111111101110111101111111a1111011111101011011111111001122011010121122210112212222112111111111101111111111111111111111110011101111011001111111101100101111
11001111110111111111111110111111a1111011111111110111111111011212012101120122121120122210222111111111111011111001111111011110111010110111111111101001111101011111
11111110001011111111111111011110a1110111111111101011110111111021002211201210220101201212210111110101111110011111011111111110111111111111111011100011011101100011
10101011101101110111011111011111a1111111111111111111111111011101111100010220021211222221200210011111111011111111111100011111111101111101110111010100111100111111
11111111111011111111111111111111a1110111111110111111111111111112202111212201101221220111122111101101111111111011111110101101111111011101101111100011011011111111
01111111111111111101110111111111a0011011111111111111010101011122100202022012112212000122000111010111101111111111111111011111111111111110101111011111011110111111
01110111101110111111111010101111a1101111011110111011111110110212120121211101102211221102200211001101111111111011111110001100111111011101101101111000111011111111
11110100111111110101111010100111a1101010111111111110011111110111022222202020120212011200111211110110111111111111110111111111111111111111101111111001111111111111
00001101111110011100010101110101a1111111111011101101101111110212101222112102122222210211011011111111111111111110111001111101011111010100011011111101111111111011
11011101111111101110111111101111a0111101110111111011111011011210100201222012112011211111112111001111010011110011111101011101011111111111101111110111111111111101
11111111011101011010110111100111a1111011111101111111101111000121211122012221110212122020211211111011110111111011110111011111111011011101101111111101111111011111
11111010101011111111111111111111a0111011111111101101100111011022202122212111121110211122010211110011101111111101101101111011111110101111101011111001111110101101
11110111010111011101111111100101a1101110011010011111101101111221120121121211121201221112012111011001111110111101111111111111111111111010011111011111111011111010
11001111111011101011111101101110a0111111011111111101111111110222211001222212122212121110022111111100111111101110101111110101110111011111111111001011101111111011
11111111011111111111111110111101a0111111101111111111111111110221220210202022011221211222102211111101011110111101001011110111111111111111101111111110111111011110
11111101111111111111111111110111a11101111111111111111011001aabbaaaabaabbbaabaabbbbabaababaabaaaaaaaaaaaaaaaaaaaaaaaaaaaaaaaaaaaaaaaaaaaaaaaaaaaaaaaaaaaaaaaaaaaa
10111101101111111111101111111011a10111011101111100111110001a1112200211120100220120102110222111110111111111111111111101111111111111111011001111011111110111111111
10101101111101111111111011111111a11101011011110101011111011a1011101012211112121002112022202201111011111111111011110111011111101011111110111110111111111111111111
11111110111011001111111111111111a10101111011101110010111111a1221022222111202112120112010122211111111111001111111111101100111111111111011111111111101110011101001
10111111011100111101110110111111a11111111111110111111111111a0011122221221122202202200012222210111111111111111111111111111001011111111111111001111111110111111111
11111011101111111111111111010111a11011111101001101111110011a1112212222112211222011222211102011110111111011111101101011111101111110110110001111111101011111111111
11110111111111011111111110111111aaaaaaaaaaaaaaaaaaaaa111001a1202111110011222011221221112212011011101110111111111010111111111101111110111111111001111101111111111
0111011111101111111111111111111111111111111111101110a111111a1012221111211122201111220120210111001111111110011101111011111111111111011011111111101110111111101111
1111111111101111010111011001111011111111111110111111a011111a1101101101111101111110102120222101212101122122212121211001101111001011100011111101111111011111011111
1111111101111110011111111011100111111111111101111111a111111a1111111010100011111110112102202012102120021121021122210011011011111011111101110111111111111111110011
1100011001111011011011001111111101111111111111011111a101111a1101110111110111111111111012112201212111200212101220110101111100011111111111110011011111111111011111
1101110011111111111110111011111011011110111111111111a011111a1111110101111111101011211100210201201000021212102211211110010111111110100111111111111111111101111101
1111111101111111111011111101111111111111111110111001a110111a1111111111111111110010012102112212121022122000220122110110010111111111111011110111101111011101111111
1111110111100011010101010101011110111111011111111110a111011a1101111111011011100110011001120220211211010202002211211011111111011111111011111111110111110111101011
1011011001010111111110101110111111101110101101111000a110111a0111111111011111111011222202111122121001120211122211210111111111101011111111010111111111011111011111
1011111110111110111111010111110111111111111010111111a011011a1100010111010111001110101110211002121011022110112212211110111101101111111111101101011111111001111111
1111000011011110111111101110111100101001011111101111a011111a1001111111111111101111211012222212020200221222111222211011110101110111110111011111111011111110111111
1111111110101111111101011111101111101011001111101111a111111a1101101010101111011111210110011212212100202112201211211111101011111111111011111011111111110011111110
1101011011111111111110111111010011101111111111111110a111111a1111110111111111110111212211110121122201212211002222011101011010011101101101011111111010111101111010
1111111011011111101111101111111011111011011011111101a101111a1111111111101011111111011111121112120111112111111112010111111111101011101111111111111101111111111111
1101011101111110010111111111111111111010111110110111a111101aaaaaaaaaaaaaaaaaaaaaaabaabaaaaaababaaabaaaaaababbaaaaaaaaaaaaaaaaaaaaaaaaaaaaaaaaaaaaaaaaaaaaaaaaaaa
0101100111110011111110111011000111111111111110110111a11111111111101100001111111101011220112212222122012121110212111111111111111110111111111110011111111111111111
0011111001111111111111111101111111111011111110111011a00010111111000110111110011aaabaabbaabaaabbaabbbabbabbbbaaabbaaaaaaaaaaaaaaaaaaaaaaaaaaaaaaaaaaaaaaaaaaaaaaa
0111111110101011011111111111111110111111110111111111a11100111111111011111101111a11212111221020101211211212211211111110011111111011111111111111111001111111011111
1011111111111111011111111111111111111110111111101111a11111111111111111111111011a01021021120220220121111120221202001011011000111110111110111011111111111111101110
1111111111110110110001001111110111111111111111111111a11111101111111111010100111a11112220221111201212222101211202211111110101111110011111111111011111111111010110
aaaaaaaaaaaaaaaaaaaaaaaaaaaaaaaaaaaaaaaaaaaaaaaaaaaaa11111111011111111111111111a11010022120012222110212022202112110111111111111111111111111111110011100111111111
1011101010111111011111110110110011110100011101111100111011110101010111111111110a11101221220221212012111021120211110011101111111111111111100111101001101101101111
0111101101111111111111110111111011111111111111111111101111111101111101111111101a11221220102112012222022221222001011111110111011011111110111111100111111111111111
1110111101111101001011110011111111011010110011111111101010111111111111111111111a11122112101201121200020202101101001110111011111111110111110111111111011111011111
1011111111100110111101011110000111011111111001010000001111111100111110010010101a11122210212111011010212121221001111110111100101111111110111111101111110001110100
1111111110101110111111111011011110101110101101101110111110010111111111111111110a11111200212101021120220111222202211111101101111111111011111000100111011111101110
1011110111011011111111111101110101110111111110111111101111110111111111111111111a01011112211100021212021121221002111101111111101101101111110101011111111101011111
1111110101011111010111110111011110111111011111101011011111111111010101111111110a01122221222121012212212122201212111111011011111101111111111111001100111001111111
1110111011111011111010110111011111011110111011111111111110111110101111111111011a11212200010210011212221112111210011101111111111110111101111110111111011101111111
1111010111101111111101111011111111101111101111111111011111111111111110011111111a11211002122110002211102121110121101011111111011111111111010111101111110110110110
1110101110111110111011101101111111111010101110111101100101101111110111111001101a01020211021220221112011101102001210101111010111011011111111110011111110111110111
1001101111111101111111111111111011111110011101111111011111111111111111101001111a11122022201211020220200202122221001111111111011011111111111111111111111011111111
0111101111111011111110111111111111100111111111101101010111011111011111101111101a10200222211222211221212201212111111111110111111101111111111111110011111110111110
1101011111111111111110111111100111111111100110111110111111111110111110011111100a10101011111111011111110111011111111111111111111101000011111001111101111111111111
0111111111110101111010111111010111011110110100111111110101111111111111011111110a11111111111111111110110111111111011101011100111111111111111000001111101111111011
1111111111111111001111100111111101111011111111111111101110110111111101101111111a11011100110111111111011101111010101100101011111100001111010110111111111111111011
1111111101111101111011111111011001011110111011110111111111111111110111001110011aaaaaaaaaaaaaaaaaaaaaaaaaaaaaaaaaaaaaaaaaaaaaaaaaaaaaaaaaaaaaaaaaaaaaaaaaaaaaaaaa
1110001101011000110111001011111101110111111110111111011111001111111111111111111111101110111011111111101111111111111111010101000111011011110011111101110001111111
1111111100111010101111111111001011011101101111111111101111110010111111111111100110101111111111100110101111111011101101011111101010111111101111111011111111101001
1011011111010111011111111111111110100111111111111110001100111101011111001101111110110111111011111101111011111111110110011010111011110101101011110111101101100011
