10 104
107 13
118 42
15 7
76 66
86 2
64 26
50 31
133 26
97 97

2111210211121122012201021211211011111101111111101111000111011001100111112112112112021212021221011221201110111110011010110111011101111110111011011011111111111111
1122222120100112011210211011220011100011111111011101111111111111110110112011210100210202022001122012011110111111111110111001101001011011110101100111111111111111
1220121222122212221221100011111100111010101111011111101111110011111011102011222101012111101121211110121111111110110110111111111111011011011111001011111111111111
1102110111002222112122121211020110111011010001111111101111111111101111011010221210212121122112221121121011011111111011111111111111111011111111111111011010111110
1221020100122121122111111112110111111111111111011010111111110111111111002110122211102221210112122112120110111111111100111100111001110001111111111111111101011011
2211202012112121111121022111221111111111111111110111111110101111001111121012121201202221222221122021020111111011110111111111110101111110111101011111111011111101
2022001022212221121212221011101110101111111110111011001111111101101111122212121101211001212110110211101010011111110011111111111111111101111111111111011111110111
2222122212111112022221220012101110111110110111111111111111110011101110111121020222201101120112222220101010111111110110111011111111111111101011011101010101111011
0121121011121211101121122010111111111111110111111110101111111111111111112221211112200111201102111222110101011111111111011010111111100111111111111111111101111111
2112222212201121222102022122111111011111011101101111101101111011111011122101012111021212100120100211021100101111110101111011011110101111111011111011011111111111
0221221221121210211222001211020110111101101111011111111111011010101011111011120110212222011220112222211111011111011111111111111011111111111111111111111111111110
0121122111000112012221122222011101110111111101111112211110220011102221002220022210121220022222022221221010101111111111012211210112201220211012210021210011011000
2201210200120021102222212222201001111111111110111102002221021201011111002210120221112011221202011201211110111110111010001211121212020111212222222020111011111011
2111212111212211221102221222121100111111100111111222011000121222201111122222222011001102112202111221221010110111111011210200102201011001122211121122011110101111
1122100212112121220221012122222111111111111101111201110121010012012211002012202212111012121221221112111110111111110111122202211211110212201021111122211111101111
2120222212120112021112210201112111011111111111011210122001022010111121222122220012122122212021101222201111111111011111102200111212211112120012002121211110111111
2212101102221122121122011110220111010212221021211020212211222221122211211220112021111122222020222212210111111001111111211121011112111212100021121220211110111111
0001220212221112111112022000011110011121212221212212121220022022222202011221122120201102022212000121210111111011111111222110001111021210221220112112211011111011
0102021222121121221221021211021111011112211202221222121200222220221201121102221211121202100211211101120111111111101011210022112002212112112212212112111111111101
1011121221122221022020212012220111012112211202111200120120112222211220122122122102112111101121222102211111001110111110111212201112210212201221012121111111100110
1212022022112102211211221102122110010111121101112221110200202221222202112122222101021121021021011021121111111010111101120201102210211010202011101110101110100111
2122112212222221212111121211121101122211201021221122212222221020222222122221222221011212121022222120001000111010011010212212122222211012122020212022211111110111
1112221221112201000120121220222111122210222101112220022200202102022122112201211111201121001120200110101011111011110110121000010202002021011020211111110101001111
2201111121211212202021021110220111111222122212112220022002210122121211122221220020201112202121121112121011101111111111220121011211120211121112121122011111110111
2112100010222211112122022211221000121111111110201222220100222220021102102021022210100120102211011012221111011111000111021122121102201112121222202211111110110000
2221201122212110120212100211210111002121111201221221222022201122001212221201220110000211202110212221201010011111111111201222112212220221222110020022111110110111
1012120121222022221121201110201011112100110002122022011220201222221122012200122222100112211222221011021111111111111111012120112212121222101222022022011000111111
ababbbaaabbaaaaabbabbbaabbaababaaaabaabaaabbabbaababaabbbbabbbbbbbabbbabbbabbaabbaabaabaabbababaaabbbaaaaabbbbabbbbbbababaaabbbbbabbbbaaaabaaabaabbbbaaaaaaaaaaa
2111202122100111221211221122011101010111102111011021122221222010112122202222222122120122022002021212111201021121211221222222222212222111110200011102210111111101
2012121212222210222000111022221111101121122100021120212202022202222121202220222202120212000122122222201212211101011222212210222212010002222011100011211111101111
1221221210221212122012020012221111111221111200112021222020122222102122122022102122021120122000012002011202121110022212222212200210222122202121111112111011111011
1110001111111111101011111111011110112122220111210210222221122211221112021111021200111111110011111111101112211220222121222202022212110222102110121112010111111100
1010111111111011011111011111111111110110221021200021112221010222122012011212002211111111111001101010011011011112112112202012120222022110022122020001011111011111
1111011111001111111111111111011010020001221012211202222212210022221212211212021101001111011011110111111221100212021210122122022122212101111110220101110110000011
1011001111011111110110101011011011120222122210120222202221202112221212021112020111110101111111001101111222200102222221222112220020221101122210121222111111111111
1101111111110011111110011101010111122111211211010221222122022222221211111110120011111111111111111101110021210022121022122221221222202221212101122010211111111011
11101111110101111111101110111101111012211212121002222121021ababbabbabaaaaabbbbabaaaaaaaaaaaaaaaaaaaaaaaabababbbabababbbbababbbaabbabbbababbababbbbaaaaaaaaaaaaaa
11111111111011101011111100011010111122210202210102120222112b1011221220212102201210010101111011111100011112102121102022202210222222222120121021112212201111011111
11111001111111001111110011111111111220001221222222121202221b2122220102021222122111111101001101101111111211100122211112111012220222022111212110221120111110111111
11111111111101110110111011111111011112022221222202202220202b0220122122122212120001111111011111110101110221221122221011220202220122222201102212210100111011101111
00011111101011110111111111111111101121022100121201221102210a0211221212111112211111111111011111001110111111000110122221222110222222222222211121121010111011110111
11110110111101111111111110111011011121112021210222210000022a0222120221222202221211111011011101111011111121211210212212212222212102222222112122221111111100010111
10111111000111111111111011011101111110122112120101111122112a2111221111110111111111101110011111111011110102111200112111100211211020122011111001111101011111101111
10111111110111110010110111111111101120011121122021221222221b2210121110111111101111101111111111111111111211021111112210222102110101122101010011111111110101111111
11111111110110111101001111111111101222222221201111111211011b2121111111101011110111111101111001111111010010211121100210210222222221112111111011111111011101011101
11111110110111111100111111011101110011202012122110121020122a1102210110111111111111111101111001011111111121112021121102222121121112112211111101111101110111010011
11010111101100101111011011111110110020211211112202211121212b1102021111111111111110111011111111001111111020122120110202111201110222022111111011010111111111111111
11111111111011101110111111110111101001101110111011111111111a1111110011111101111111111111111110001011011102212112121021202121110101222210101010011111101110011111
11011111111111111111011111111111101111111111011101011110011a1111111111111111111111110111111101111111001101101022020201222220111201221111111101101101111010101110
01111010111111011001111110101111010111111111110111111011011a1111101111101111111111110111010101110101011222221121020212020112222022212101111111111011011111111111
11111111111111111110101101111011011101010001111111110111111a1110110110111111111111111111011111111100111011012121021112111020122102222211111111111111111110110100
10111101111111101101101101010101101111111101101111110111110a1001012212010222110101120221010200101011110120111111110121222210121111021101110111111111111111111110
01111100001101111110111110111111111111011011110111111011111a0121112201221012212aaabbabbbababaaaaaaaaaaaabbbabbbbbaaaabbabbabababababbaaaaaaaaaaaaaaaaaaaaaaaaaaa
11111001111111111111111111110111110111011111010111101101111a1110211000222220010a22121020012111111111010000022110200112112120110100212111101101111111110010111110
11111111001111111111010110110111111010111111011111110011111a1022211202121220212a00202201010101110110111110110010112121022211211210111211111011111010010110111111
11111011111111111111101111111011111011110111111111111111011a1222210120112111121b01111211110210111111110201122221111211211211111201221011011111110111110110101111
11111011010010111111111111100111101110101110110111111001111a1202220112221211200b22202221201211100111101102120002221122220212011200221011110110111100101111110111
11110001111111111111101001111111111111101111111111001111111a1100201211112012210b20002111221111111111110110220122121101102111202112121211101001101011011100111111
10111111011111110111001101111110111111110111011111111110111a0010112120020212121b21112112112110011111110011011101111111111000110011011111110111111101111001111110
01110111101111111111110101010111111111010111111111011111100a1110022011212101211b12120201121211110111011111111111110101111110011111111011110111111111101111110111
01101110111111111111111111111111101101001111111111111011101a0111121222212212110b22210222102111101101111111101011111100100111011110001011111011101111111111011111
11111111101111101111001101011011111111001111111111101111111a1212122121210101212b12222221201100111110111011110111111011101111111111111101111101100111111011010101
11111111111001111111111011111111111111111101111111101001100a1110112211222121021b12121111101001011010101011101111110111111111111001111101111011111101111110111111
10111111001011111111010111011110101111111111111001111111110a0001222111011102202b22022212111101101111111101011110111101111110111010110101111111001111111011111111
11111111101111110101111111110111011111101111101111111111110a1102211222000022002a01121121111201000110111111111110111100110110111011111111111111011111101101110110
11111011011111111111010111101111100111110100111111111111111a1212200122012000122b22112111022111110110111111111111111011111111011111111110101111111111111111010111
11111111111011111110111110111111011001111101111101111101111a1212222101221221221a22120212121111111111101101111111011011111110101101111111110001011011111111111111
11110011011101100111111110110111100111111011111111100111001a1220201121212221221b21201220012210110111101110111110111111110111110111111110111111111111111111011111
01110111101111011111111101010111011011110011111111111111110a1222122101220011211b11120011110011110101111011011111111111110111110001111111011111111111111111101101
11110110111111110110111111101111111111111101111111001110110a0122121110010022222a221112111122101111110110011111111111011aaaaaaaaaaaaaaaaaaaaaaaaaaaaaaaaaaaaaaaaa
10111101111111010011011111111111010101111111011111110111111a1011022010222011212a121112111210010111111010111101011011111a0111110000101101111111111111110011111110
10111101101111111011111111110111111111110111011111111111010a1210112201211200011b022011112210111110111101001100111111101a1111101101111110111111111100111011111111
11111101111010111111101110111111111010110010101111011111111a1011201121121122211a111012100112011111011111100111101111111a1111011111100110111110100110111111111101
11111111011110111101101100111111111111111111101111111111111a1212122210022211212b012212000211001110111001111010111011111a1111111111001111111111011011110101110101
11101111101110111110111111111011111111100010110111101011001a0222222010202021120a211220201220011111011111111101011111111a0111011111111111111101100111100111011011
11011111111101110111111111111010111010011010111111111111110a1011222100211220221b122222222222111110011110111111111110111a1111111000010111111111111111111101111101
11111110111110111111111110011111111111111011111011101111111a0112121221000212000b122012222021011111111110101011101011101a1010111110011100111111111110100111111111
11111101111100111011101111111101111111101110011111111110111a1211220001222222112b222111211121111111111111111111111011110a1111111101001111001110111111111111101011
11110110010111111111111111110111110111111001111111011111111a1222121112202022222a221121111121111111111110111111111111101a1111011011111110111111110011111101101111
11111111101111011111111001111111111011111111110110111111010a1222222012101001212a011212120101101111111111110011111001101a1111111111011111001101111110111010011111
11111001111111110010110111110001111101111111110111111111111a1222022111121210012b211121111100111111111101111111111111111a1111101101111011111111101111111111101111
01111100010111111011111111001111111111011110101111111111011a1020111111112010202a221221200121010111111111111101101000111a1111111011101011111101111111011111110101
01111101101101111011101111111000111111111101111111110110001a1111111111110011111a002021112111001201012021111202202111111a1010111101110111101110110011101111101110
11111110111111010101010000111111110110011110110111101111110a1111111111110111111a101001111211221221100101111122002101111a1111111110010101011011110111101111011111
10101101110110111011111111101111111001100010111111011111101a1011111111111101101a100110221211110121111221211101122111011a1101111110000111111111110111101101111111
11110111111011100100111111111111111111011011101111101110111a1111111011110011011a111212120121122220222121212111201011111a1111101111111101101111111011101111101111
01101101111111011111011111111111101011111111111011111110111a0111111110111001010a001222212021210002110211012121212111111a1111111111111111111110111010101111111011
11110111111110111111011111111110011111001111111111111111110a1100111110110111101a011112212100011211212222222121220111110a1111111111111111111110101110111110100100
11111011100111111111111101111010001111111111111110111111111a1111001111101111011a012012112202121222111120012202222111111a0010111101101011011111011111111001111101
01110111111110111111111101111100111111111101110011111111110a1111101000111111011a112122222121212212010111220222022011011a0111111111111111011010111111111111111111
10111111111101111100101111101111101111101001110111111111011a1001110111010110010a110211222020201221211210112212221001011a1111111101111111011101110111111001111011
11111101101101111111111110110111111111101111101110011111011a1111001100111110111a010001221201022201022101000121101101101a1011101111011111111111111101101110101111
11111111100111110111111111101110111101010111111111111111011a0111101111101111011a101012111222202101222112210121121111111a1111100111110111111111111011111100111001
01001111111101101111111001111111011011111111101110111110101a1011011101110111101a110222110110222220222110221021020101011a1110111101111101111110111101011011110111
01111011111101011111110111111111000101110111111110111010111a1101111111111111111a112221212121221201222022201011000101111a1011110110111111111011101110101011101111
10111111111110111101111111111111001111010111001111111001011a1111111011101110111a100010210221112222111002122111122111011a0110111111111111111111111110111111111101
11110111011011011110111101111111111110111101111101111101111a0011111011010111011a112111101110221121210212012112011011110a1101111110111111010011111101111101111111
01111111111101011111111111111101101111111110011111111101111a1101011111010111111a011121000211222210121121022110121111101a1110111111110011111011101010001111111111
10111111111111010111110111011100111110111111111111101111111a1111111111111111111a112212012110221101112221210111121111111a1111111111111001001111111010101111111101
00101111111111111111110110011100010011111111101101010111101a0111111111101111111a112221112222221121212111211121222011111a0101111011111111001011111011011000101111
11101111111111011111101101111101111111011111111101111100101a1101111100111111111a012111120000102120211001121121222111001a0111110101111011011101101101111111111011
11111111111111111001111011111111011111111111111011101111011a0001101011101111101a001101222110222201221222222121202101111a0011011111011111111111110011111111011101
11111111101111100111111111111111011111111111010101111111101a0111001011011101110a112222101121202201120120021200121111111a1111111010101101101101111110101111111111
01110110111111111011111101111101111111101111111011110001111a1011111011111111111a111221010110221211021202111022001011101a1101011010111111011110110101110111001010
11111111111010111011110101111110110111010011101101111110111a1111011111101111111a011212101122112122202101121122101111111a1011011111111111011111101100011110001111
10011110111101111010111111111111010110111111110111111111110a1101110011110111111a111211221011011202222010121202011110110a1111111111111111011110110110101010111111
11111111011010011011111111111111111111110011111011111111111a1011111111111111011a102202110111110021111221112211120111111a0011110111111110011111110110111111100110
11111110010001101111111111111111111001111110010100110001111a1111111111110110111a101211112221211111222121121121210110111a0111101000001111011111111110111111111101
11111111111111111000111110110111101001111111111111110111111a1101111111111111011a112102212212222121212202112122112011011a1111111011111001101011111101111111111111
01111110111111111111010110010111111111111111011100110111111a1100111111111110111a011021001211110222111111012220011111111aaaaaaaaaaaaaaaaaaaaaaaaaaaaaaaaaaaaaaaaa
01111111111000111111111110111111101101101111100111101111011a0111111111101111111a10110111221022220101022110120110211111111010110011011110101111011001111111011110
11111011111011111011111111011111111101101111101110111001011a1010101111111101110a11001112102102210101121010002121010101110111111101111111110011110110111111011101
10111111111111011110111110111111111111011100101101011011101a0110101111011100011a11112120122011020112121201212202111111011111111111111111011101111111111111101010
11011001111111100111111110110100111111111111111011101111111a1111111101110011111a01111110001111011111101101000111101111011111111110011111111101111111101111011101
11110111111110111111111101111111111011111111111110011110111a1111011111010011011a11111111111110111110111111111001111111111011111111111110111111011111111111001111
11111110011111111110111111111000111011110010111101110111111a1011111110100110111a11100100101111101111111111111111111110111110111111111110110101001111011110111111
aaaaaaaaaaaaaaaaaaaaaaaaaaaaaaaaaaaaaaaaaaaaaaaaaaaaaaaaaaaa1111110011101100110a11011111011011011111110111101111111011111111101011001111111111011111111011111111
1111011110111111011011001111111110111010110011111110111011111111111111111011111a11111101111011111111111110111001101110011111101110011100111111111110111011111111
0111110111011110111111111110111111111011011111011111111010111111011111100111101a11111111111001111111111001011111000111111111111111011001111110111111111111111101
1101101111101111011110011111111111111011111101110001111101011011111111111111110a11111111111101111101001111010111110111011011011110111111111101111101010111101101
