71 10
8 119
118 42
15 7
76 66
86 2
64 26
50 31
133 26
97 97

21101122012012102202002101121021001111111011110100001010110111110111101002120a1b21120200111121121210121011111111010111111111101111011110111111011011111111011101
10212222121121121120010210011100111111101111111111111101001111001011111220010a1a20222212211022222220221111010111101011111111011011110110111111011111111111110101
12012222221110211211021102211211111101110111101001111111111110110001111022222b2b02211222112011011111111110111111011111011011011011111111111010111011101101101111
11010122222200201111222120011101111111001110111011110001100011011111111020112a1a21022210021211110020211111101111001101111111101110111011111111011111111110011111
02112120122211121020211122212221111111110111111111111111101111111101010220000b1b12210112112112011000221110000111101011111110100100001111111110001111011011111100
22211121111001100000222021121121011011110111111110111011111110011111011121101a1b22100010022010101211211111101011110101111101110111111101110001110101101110111000
10022111110001102012220221201201100101111111111111111001101011111011111102212a2a11222001221201202212221111001111101111101111101111111011111111111101111111111110
12011120011212121220221201102000110111011111111111111111010111111111101002021a1a12212112021110211021021101110011011001111111111111010010111011110111011111111111
20111212222211211211221001100220110111111111111110111111111111100101011020111a1b11211112021221220200021111111111101111011111111110111111100011011111111111011011
21212121211211121011200212120220110111111111111111111110111111011010101221222b0a12112122212201112111221111111111001101011101110111111110001110110111111111111111
21122111222020222212111021111111111111110101100111110111011111111111111211210a1b10011220202012202121010111101111101011001111011110111111001110111101011111110111
21122011112211100022221100022211111111011111111111102120112122121022210201122b2b12210211121120102121211100110111111111012221112211121201220212222201001111111111
11121220121202120111202221212101111010111111111011111210011212121111121222211b0b00222120102022220111211010111111111101110212012212211222221221121100211101101110
11222001020101112122102202202101010110011101111110011111022101112122122212102a0b22101221111221222100111001001111110111210222102022012122211221021112010001011111
11021121202221211021111222220220111111111101111112121102121022010112212220011b2a21022122211122122001221111111111110110221001122112122121212111021122111101111011
11120010221210220111211212201000110111001111011112112002012221210021020222022b2b22221120110102220020021111001111101101111122122112020020222201211212100011101010
10022020220100121212112121121220011121210112012222222222212012222221202122220b2b20222111001112211221101111010110111110111211101212001111022120221200111111101101
22210210022112221212002102211011111121220022222220222211012222222201211222222b2b11212220121211121210211101101110101111222102112011221111221112122222101101111111
20002100221012022222101121110221011022212200212020102202122112212212102002211b1b12211001222020011120111111111001111101121211122110211120121221221011011101100111
21012222011222212112211212022110111101222102021112222000222112212020112022222b2b21022222211221021220211111011011111111102221012222001222022012201121010111110111
11021202210121110112202121122211011222211211211222222222222121221110222012220a1b22022221101221121201210011111101111011021122002110202002111212111121211111111111
11020101222222212121211100122221101000212121212012222222022011222001020222110b2a11102201210011110211110111111111111111011012221212110112110201022101211111001111
21222211211212012122110121000201101222112221210120202222222222002012002201012b2b12122211222122122220121110111011011111211212012110122212102001022210210101111111
12110211121211112200212201210221101212102121200111201022222122120120122221222b1b22111111211121001211121101111111101110222120122211111212012012112121111111101011
02210021211112201212222012111221110212121222112020200222220202222120010122102a2a00021112121002122111211011111101111011102222222011211112110202210121201011111011
11222201002101110002012202211200110022011221202112112222212202011212120222122b2b20222102222221201122010111110111111101111212211221202212202111212110011011001111
10211202220201122111111110121111111010122201212201212122020202201220211211221b2b22002122111200201220111111111111111101211101110110102222222122120110011111111001
22110211121112220100110112222120111101022122202222211121222010202112211122100b2b12221122202101121211101021201101212121222112222202221211222122121112210110101011
11211220111110001221201212221011111212122211200110110021222010212220111221011b2b01010102222212110111211201221222210210222212102222102212202012002212001111101111
10122112110220112210121221112121110210122221111220212222022222122011202222222a2a20012211212110212201020111110212102212222220212021222202020220010002011010101111
01202210212002021010222211111011100121212111122112222012210120201222202210222b2b10220102221221212211221210121011211222202221121220211011111221211220010111111111
11001111111111111111111111101111001110210000210112220221222210222021122121110b1b01111111001110101111100222021212112111222222222221012111111220211012111000111101
11111011111110111110111100111110111211021020112222212200221222222221101200222a2b11011111111110101111011221221002011222211122212222021202102101121202211111110101
11111101111111111110111101111111111101212212122210021220122112222211222000112b1b11111111111101111111110222212221111100121222110222021200111112112010111110111111
01011110001011111101111110101111111010212222212000121022022000122222022021222a1a11111111100111111111101221112110122020011220212222221122111121122211111111111011
11111011100111011100111111011001101012122112212012212022202212212021022101002b2a11110011101111111111110202111112222212210122122222220122022100012102111111111111
11001011101111001110010111111111101011112212022022022222202221122210110120001a2b11111111111111110011110101111111110121220222020222222112122122121210111111111111
11111011111111101110111111111100111212212212110221122021202222210222210121221b0b11111111110101111111111110122121111002011110221222222222222112112221111111101111
11111111111101111111111111101100101221121211202110212222022111010210020211212a1b11111111111111111111110202111112110201221112121222201212200122111022211111011100
aaaaaaaaaaaaaaaaaaaaaaaaaaaaaaaaaaabbabbaaabaabbbbbbbababbbbbaaaabaabaaabbbabb2b11111111111101111010111212022111201022212122222221202221110212210122201101100101
1100111111111111111101111101101111110021021222120002122222221221221202000211ab0b11101111110111111101111122021200101111221221220222122212200021022011211011101111
1111111011101111111110110111001111112001121111012002200101211200120222211112aa1a11111110110111111111111112211111211211212221120222202212212212220112201101110101
1111011110111001111111110101011111102121000102211010222022222201111101011111aa1a11111110111011011111111210210122012111212222101222120201110111111010111111111110
1111011101111110101101111111111111122000011220111220101221202201120111111100aa1a11111111011111101101111200200102100010111210210112221211110011111101110110111110
1111011101111110011111111111111011011102110110220221202211122221221110101111aa1a10011111101111111111100102002020120211020121120201211111111110111101101111110010
1111111111111111111111111111111111111222211202222202211102010202221110101110aa1a11110011111110111111011211111121021212101112010212121211111011111011101110111111
1101011111110110111111110101101011120001010122110012011221111112210111110111aa0a10111111110111111110111101111111111212211210212222001111111010111110111111111111
1100011111111111011110111111101101011011111110101111110010101111111101111111aa0a11011011101100101110111222211112012111221201112202111211101110001001110111001111
1101101111111110111111110100110010111101110111011110111110111111111011111111aa0a11110111111110111010111101012210200011211200221202121211111011101110110100111111
1111111111111111111111111011111111111111111111100101111101111111011101011011aa0a11111111011111110111111011111121222212121122011210100111110111111110110101110110
1111101111011011111111111011111110111001010011111111101111111111011011101110aa1a00010011111101110011111221011121022110210121111021222101111110111111101111111111
1111111111111101111010111110111101110111111111101110101111111012210212221021aa1a11022121201211111111101121222111112011220110212022220110111010111011101111101111
0111010110101110111111110011111010111111111100111011011111111201111010111210aa2a12211101211110110101111112112012012112111212212222210211111011111111111111111111
1101110101111110011111111110111100001111111101111111100111111122222211122020aa1b21102122011011111111111002022122201112010212222212110211111111111011111111110011
1111111111110111111100111011101011111100111111111111101111110212020121202110ab1a01112111102211111111010111212112111020112212111110110111111011111011101111111110
aaaaaaaaaaaaaaaaaaaaaaaaaaaaaaaaaaaaaaaaa10101101010111101110202002120210210bb1b12011222210211111011111112011101121221122211011110221100111aaaaaaaaaaaaaaaaaaaaa
1011111101011111111111111110110111011111a11111011100111111101121112111112020ba1b12121202111011111111011221221201012220220111221211211211101a10011111101110011111
1101110111011111111111011111011101111011a11101111111010101111220211211121120aa1b11012212202111111011100112222112001212200221001111111001101a11110011111111111111
0110001111111111111111110011111111111110a11011111110101111111221201120121121ab1a00121211211201111011111101101011111101111011111111011111111a11111111100111111011
1011111111101111011111111101111101111110a11111111111011101101002111211211012ab2a21202201112211111010011110111111111111011011110101111101111a01111111111111111110
1111111111110111111010111110011111011111a11100110011111111111111222021010102ab1a02222022011101101101010011111101111111111111011100111111111a01110101111111111011
1101011111111111011011100110111111010011a11010011101110111010221210120220121ba2a21212221121111010101111101111011111101011111111101101111111a11111111111111111110
0111111111110111111111111111111111101011a11111011111101101011102021221221211ab2b11222002220111111111100111101111111111111110110111001110010a00111001011111110011
1111110011111101111011111111001111110111a11111011111011101111111120211202001aa0a00122221121201111110111111010011110111111111100111101111111a01111111111111010111
1111111011001111011111111011111101111111a11100111111111111011102111212111111bb2a22122020221111101111111111001100011111111111011110111101101a11111110110111111110
1100111101111111111111111011101111001101a11111110101001111111111112220221211aa0b22221220212111111101011111011111011111111101111101011111111a11110010111111111111
1111111110111111111101111100111010110111a11111111110111111111210211120121120ab1b11101121221110101111110111110101110111111111011111111011111a11100111111101111111
1111111011101110111111111101111110111111a10101011111111100111202221211010212bb2b00011110111210011111111101111101110101111001111110111011101a11111111101101111111
1011111111111101110111111110101110001110a11111101111011011111102122220012021ba2a12221222010011111111111111110011111111011111111111111111100a11111101110111111111
0101111111011111100011111111101111111101a11110101111111111111122122122122201ab0b22011211220110101111011111110101111111110111111100101111111a11111111111111111111
1111110001110111111111111111111111110110a10101010111111110111102221212222212ab0b21021121211211101111110111100111111111111111111111011100110a11111110111111101111
1111111111111001111111010111111111111111a01101111101111101011111102211012011bb2a21022210010111111111111111111111001111011111111111010111111a11010111111111010111
1111111110101110110011111110011110111010a11101100111001111111010110112221211ab2a11212020222211001011111110101110110010110101110111111111101a01111111101111111110
1011101111111111011110010111111111110111a10011101111111101101021202212101222bb1b11201220001201111111111100010111101101111111111101111111011a01011100010110111110
1011111110011111111111011111101111101110a11111110111111011111222212121210222ab0b12222012122101001111011111111110111111011110011111001011111a11010100111111101110
1011111011110011111011111011111110111110a11110110111110111111220210210022212ab1b22122211122111111111101111000010111011110001110110110110110a10101011111110110110
1111111111011111111111011111111111101110a10001101100101011111211011000102121aa1b20110211111211110111111111101111010111011110111101101010111a10110111100111111111
1111111111110111111011111111011011111111a11111110001111111111112002212111112bb0a11102111111011110111111101111111111111011101111111011111001a01111111111110010111
1110011011111110011010011111101011111011a11110111101101101111221122221111211aa1a11010222222201011111111111111111111111111101110011110011110a10011111111101111111
1111011110101010111111110011111111110111a10111111100111111110211011222222020ab0b21112221222111111111111111111101111101111010111011111111111a11110110101110111111
1011110111111010111111111111111110001111a11111111110100111111100211212011211bb0a12211112112011111110101101101110111111101111100100011111111a11101100111111110111
1111110011111111011110111110101101111111a11111110010101111110112022122211022bb0b21210211111011110101101011111111111110111111111111101111110a11110111100101111110
1010101011011011111111101010111110110111a01111111111101111100111111111111111aa0a11222200221212122122102222222012211110111111111100111011101a11111011001111111011
1111111111111110111101111111101111110101a11111111111110011101111101111110111aa0a11122111211000100211021211212211211111110101111011110111111a11011111110111111111
1111011111100111111101111111111111111111a11111111011111111011111110101001111aa1a11210101201221220022222212111001201111111011110111111011111a11110101111111111111
1111111101111111110111111111110111111111a01111011111110111110011111111111110aa0a10122120101102212002122212221121111101111111110111111111111a10110111111011111111
0111011111111111001001101011000101111110a00111000111100101010111111110111111aa1a01021112111222110010021121021202011010101111111111111111100a11111111111101011110
1111111111011001001111111101111101110101a01110101111111111011111011011111101aa1a11212022222122020220111111121121211111101111100111111010111a11111111111111111111
1111101111111111111110001010111101111111a01101110111000111111111100111101001aa1a11211210121201201101120211102120110101111110101011011011101a11011111111111110111
1111011111111111111110011111111111111101a01001111111111111110111011111111001aa1a10101211022112110112222111102211111111110100011111011111011a11111011111101111111
1101111100111110101111111110111111110111a11111011110111111000111101111111010aa0a10102200122122122222022210202222111111101111101101100111111a11111100111111111111
1111011111111111010111000111110011111111a11111111111010110111101100101111111aa0a00020021112021120021122010210122211010100111101111111011011a11111011010111011111
1111011111100101010101101110111011110001a11111110111011111110111101111111111aa1a01110101222112110112202220221111111111111111110111101101111a10011110111111111101
0101111110111011011101010101110110111110a11110011111111111011011110001100000aa1a11121211202121221211212012122021111010110111111111111101101a11111011101111110011
1111111101111011111111111111111111110010a11010111110111110111011110011111110aa1a11201210211211210122022022121202010111110110111101111011101a11101101110111110111
aaaaaaaaaaaaaaaaaaaaaaaaaaaaaaaaaaaaaaaaa11111111011111111111011101111111001aa1a1111202120121110221aaabaababbbbaaaaaaaaaaaaaaaaaaaaaaaaaaaaa11011101110001111111
1111100001011111111101111011011111011110011111011011111111100111101011111111aa1a1102212122121120020b222120201221101111111111111111001011111111111011111001101101
0011111111111111111111110101111111101110111111101111110111111111111111111111aa1a1110022202122101010a102201122111011111011111111111110011011111011111101111111111
1011111111111001111110101111101111111111011111010111111110011111011111111111aa0a1120220110112212120b111202021111111111011111111110111011111001111111101110110111
11110111111111111110011110111111111111011110111111110111aaaaaaaaaaaaaaaaaaaaaa0a1021220211210212022a121111122111111111110111011111111110111111111001111011110111
01011111111111110111111111111111111110111111111111111111a11111110111010111111a1a1002000002211210102a102022110120010110011111111111011111111111111111011011011111
01111111101110111011001011010111111100111111111011111111a11111101110111101011a1a1102211221102221212b101221111212211111111111111111111101111101111111101101111111
11011101111111111111111111100110111111110111111110101111a10101111110111111001a1a1111222120121112221a011021021120011111011101110011111101110111111111111111111101
10101111111100011111111111011101111111111110111110100110a11110011111001101110a1a1112211120221122221b222112111222211101100111110100111111101101111011111111110001
11111111011111110111101110101100011011111111011111111111a11111111111111101110a0a1101022121201111222a012100101211110011111111111111111110011111101111111111101111
11101111110110111111111111111111010110011001111110111011a11111111111111111101a1a1102121122102002122a201101122000011011001101111101101101010011111111101101011111
01011011001111011110011111100101110011111011111111111111a01111111111111111111a0a1111202201011001212a222000102011111111110111111111011111101111111000101011111101
11011111011101011111111111111111111111111111111111111111a11011111111111111110a0a1110022121110000022b211221212110211011111111111010110110010111111011111111111111
11111111111111111111110101001111111111111111111111110110a11111101011111101101a1a1111212211122212012b120211121202011110111111111110110111111111111100011111111111
11111100011111001111101111111011111111011110011101110111a00111100011111101011a0a1121121222110202212a102202220120010111111111111011110110111111111001101111111111
11011110111011111111111100111111111110110110000101111111a01110111101111101010a1a1122211222211121002b110102110021110011101111101001111111111111110111011110111010
11111111111110011111110110011101011100101110111110110110a11111111111111111111a1a1010221111222211120a122211010222111011111111111101110111110111101111110111111111
10111011110111011110111111101111101111100101010011011111a10111110011101001100a1a1112021201211111120a212111210121211101110111111110111101111101110011101011111111
11111001111111011111101111000101011111111101011110011111a11111111111110110111a1a0111111101111110010a011011110110110111111111111111111101101111011111111111111111
11111111001011111011101111111111100100101011111111011111a11111011111111111110a1a0111011110111111101a111100011111111001111111011111111101001001111111111110110011
01011100111111111111111111111111111110110110111111011111a11111110111011111101a1aaaaaaaaaaaaaaaaaaaaa111111101101111111111111110111111111111111101111111011111111
11010100111010111111110011111011111101011111101111101101a01111111111111111110a1011110111110111110100011111011101111011111110011110111111011111111111111011011101
01011111100111111010101001111011111111111101011111111110a01111111110100111111a0111111011111111111111011110111111101011010111111011110011101111111111101111111101
11111111111111111111111110101111001110111111111111111001a11111111111110011111a1110011111101100111111011000011111111011111111111111111111111111101111111011111100
11111111111111011111111101110111111111111111111101010111a11101011111111111110a1111111111111101111101111100110111100010010011101111111101111010110111111111111111
