147 49
12 54
118 42
15 7
76 66
86 2
64 26
50 31
133 26
97 97

1120a212112111000210122101221111101111111001011111111111110011110111011110210112001022212122b1112222101011101a111101110a0101110011001011011111101011111011011111
1012a102221202222212211211101011011110110101111111101111011111111111111111112000200011221202b2112221121100101a100011100a1111000111011110111111100010011111111010
2002a201211222102111221212121221011100010101111010111110111011111111111212011102211121220101b0202112211011011a101101111a0001101011011110111011110101111110111111
2112b111211112121212222121120111110111111110111111110111101111111101111112221112202202012202a2021121020100101a111111111a1111111101111101011011111111111011111111
2122b020102122100121021221212020110101011111111111011111110110111101111212212212222110112211b0110121221111011a111010111a1111110101111110011110111001100011111010
1112b111212022112220121121102021111111100110110100010011111111101101110101211122102101212120a2102212220011111a110100111a1111111101111111111101111111101011111111
1200a121111122121200212100011111101101110011011111111111011010111111110202112111121101211121b1112112101111111a011111111a1111110110101111111011011111111011111111
1211b122212221021222021122022111111110101110111111011110011111011111110211112221111121211121a2012102111111111a111111111a1110000111111111111111001001110101111100
2111a212222101222121210211211000111111101111110111111111111111111110110002200212202121102120b1121002211101011a101011110a1110110101111110111101111111011011001111
2211b011010112111001212120012211111011101111110111111111111111111111111122202110112222021212b2212011121111111a101111011a1111111101101011011111111101011101111011
0221b221121211211121120211102111011110111000011111001101111010111111011012121121121112122202b1001221210101111a011111011a1111110111111110101111110111011111101111
1201a110021112020022121221221000111101111111011102221222122221210221112020221201121101100111a1112220111111111a111111100b2211121222011022102222112201011111111111
1122b122122222212101221211122121111011011101101112022111120220111001101222212212122022102220a0212222121111111a001110111a2112012121220120222111120002211110111111
1021a220122012221111012122012211111111111111101111210021220221121121122222122022221001112121b2221222210111111a111110101a1011211022122222112021222210010011001010
1101b212211121122222222201120211111101110011011012121111111222111222210012022212121110021112a1121111121011111a111101112a1121111212122201201112112222101110001011
0211a112212221201220000111012001111011111111111001222212012112211201102122121221102212101012a1212000121111110a101111112b1022210020220220101111212211100111111101
1210a101002121210221211211120100111221101221021021212222200022222211201200211220212102101201a0012211221111111a111011111b1111011020201210210211222110011111111111
1201a212210202200220201021220121111212222112222212022222222122222211102122222120211022210111b2110221121101101a111111112b1212102112222212101121212221111111101111
2012b101202110111002111111111211111112122121111112202112202220112222210221222222120121121112a1012222011100111a001111102b2002212120211220010100122221011111111001
2120b211210122010212220101102221110101121220221012222021112121122012101020212212101012202112a1020012010001101a110111112b2222022122222212211202111212211111111011
2112a211222111022112111122221121111112110212122220222102222222122202012222212221021222201122a0022011111110110a111100102b1211022010122022012121011102111100111111
2001a120202211021111201021201021001212201222120012220002212222221221121221122202101220011102b0202120221101111a111111102a1011222220221112120201020212111101110111
0002b111022022221021112122201110110201202222111202020100112122022211122122222121222011212102a0122210100101011a101101101a1012222111211112010111220220100111111110
0202a111121201020112202002012111110222122021111210002200121221220011222222200122221010121211b1112220211100111a110110100a2011222121211111021011220101211111101011
1220a212121212022100120112101211111122121002121212010212202220210211212222102221122100112012b2212110211101110a011111111a1211121121211111212211122210110110111111
1112a011122212222110111122211221111222201212212122112202202222122011022212101221202111222121b2222220101111111a111111012a0202111200211211022220210201111111101111
0221a110110101022201110112222211011112022122122120102000222021222202022201021202211101220221a1112012111111111a101111111b2212202120200121212120122200110111111111
1001b200112021211121011111112211111201102111210112022222220022220222021211112022102110101121b0020222111211222a211122122b2120020222010210222012011211111111111111
1101b012211221222212202212222020101112122100111022110212222102221110111222221002121212020220b1110212021222120b201012222b2221222220022211012202210201211011111101
1122b022221221021211222212012121110221112212221112110121212212022220222222220222122202221020b1212112221222100b111222222b0121022222001211202120002212211101110111
2202b122122101022202221222021121101221221122001202020222221021200222112010022222120111201111b1222002011022200a111101012b0222222112120222211121222010111100110101
1111a110101101011101110111111111111211212120120220202221222221022120111021212222111101101101a1111111111101212b121002102b0222022210221211111220011110211111110101
1111a111101110111111111111111111010120221112122121120222122202022221120122221220111111110011a1111001011212111b221120022b2202200101221212121211101110111010101111
1111a111101101111111001111111111111121212112200212020221222212112201012212102121111111111111a1111111111111111a121111122b2222222222022010210121221212011101110111
1111a001101111011111110111111111111221110022122212221212221222221101010212221210111101111111a1111010111222011a111001021b1201222222221010211121112101211111011100
1111a111011111101111111110101011111221222111011202022122222122022222200112222022111111111100a1111111101222101a112111021b1222022210100202201221012110211101111010
0111a010111110010001111110101111111001201121200012222222021222021021211220212111100111111111a0111111111221102a021111112b1212120202020112022021221012010101011011
1111a111111010111111111111111110011111111110221100120012121201212012111212221100101101101111a1111110001012222b120221021b2222002022022121222121112221011100111111
1011a111110101111111011110111110101102110111020212101002021222021221012111100222110111111011a1110111100101111b121221221a2102022202021210211110111212110101110111
1111a111101101101111110110111100110022112020220020220122222202102121212220220112101111111010a1110101111201002a021202222b2122022122120022121111110211011110111111
1111a111110111101011111011101110111111121212010011122022222121022110110211221010110011011111a0111001110121220b201121112a2002201121122201122012100210011001110111
0111a101110101110111101111111011111102121112202220222222222121221222211021211102011011111011a1110111111202110a201210212a1122021022222112212212221100101111001100
1010a101101111110111100111110101111022212022211200122212002110110010111100111111011111111101a1011110111122110a211112122a1121211121212211111110110101111110101110
1110a101111111111111111111111101001002102021100221111221102221212111111111111111111111111011a1111111101221122a212120222b1211101100021011011111011011111111111111
1111a111101011111111111111111111010011001120201111112111001212211111111111100111111110111001a1110001111000221b111020112a1212120122101111111011101111011111111111
1011a110001010111111110011110100111021221210211121222221111121101011110111111011111111111010a1100110111121100b202112212a2112221122121211111010101110011111111111
1101a111101111011101111101111100111012111222111221201112210221102111111101101111111111111110a1111111101121121b221022112a1201120012121211111110110101011110101101
1111a111101111011110101111011011101111111111101111011111111111111111111111111110111111111111a1111011111221102a022222110a0120012212222211111111111110111111010111
1111a111111110111011111110110111100111001000110111111100111111111111111011110010111111111000a1101011111101022b211111110a2112110121211111111111011111111001110011
1101a111101111111101011001111110110111011111110111110111101101111110111111110111111110111111a1100011101211221a222212121b2212021120022011111110111110101110111111
1011a101111111111110110111111011000110111101111111110111101110111111101011111110111111111011a1111001111121212b212112112b0221101221020010110111011111010011111111
1111a111111110011110101101010111101111111101110111011111111110110002222122220021101101210201a1111111111211120b212121222b0211002111210110111011111110111110101011
0111a111110111110111111011111110011111110111110111101110111010122122112102212011122112120112a1000110111211021b101112212b1222002220212211101000111111111110111111
0111a111011000111111101111101101111111111101110111110111111101022120220012221222211121112111a1111111111222220a122221222a2212122020120001011111111111110101110011
1001a111111011011010011111111011101110110111101111111111011111221001220110110022000210121211a1111111001011221b010020012b0200212220111211010011111111100111111011
1100a111111111111111111011111111111101001111101111011111111101122120202212122101121120200221a1111111111002012b221111021b2211112120101111001111111101111111111011
1101a011111111110111111011111111111110011111111111111100111111202021111112112111012021210212a1111111111011111b212211222b1001102011112211111100111111100011111011
1111a110110011111111101111101111111011110111111111010111110011111010110222212012111120112210a1100111111121020a221202121b2021112002210111011011110101011111101111
1111a111111111111110100011111111010111011111011110111110010102112212212020222102121022012111a0110111111111010a011101111a1111111111100011111010000111111100111111
0111a101001111111101111110001101011111111001111111010101111112010212111222211121121100112212a0111111111111110a111111111a0111111100111011111111111111111101111110
0111aaaaaaaaaaaaaaaaaaaaaaaaaaaaaaaaaaaaaaaaa01011101111011012112111022201211201222210212222a0111111011101111a111110111a1111101110111110111111011111110101101111
11111111111101101011111101111111001110111111a11111111111011110122202002111012222121222120120a0101111100001111a111111111a1111101011111110111011100101101111100110
11010111111111011111111111111111110111111111a10111011001111101010121111021010212211112121222a1111111111111011a110011101a1101111110111111111011101111111111111001
11111011101110111111011110110111100010111111a01111111111111102212111211211012010221112120112a1111010111001111a101111111a0011001101111011111101011111111110101011
11110111010110111111100101111011110111110111a10110100111111112211212002022102112220201111022a1111101111011111a101111111a1111111111110101111110010101011111101111
11111111111110110111110100111001111111111011a01111101011111100111222101100222101212110211111a1011101111111101a111110111a1111111101111111111111001111111011111110
01010111111111111111111111100111101111111011a11110110110110112110122022212211212000111221011a1111101111110001a110111111a0111111011110111101011011111111111110101
11110110111111111111011111011110111110010111a11111111111010010112212111211222221111222021211a1011111111101010a111111111a1101111111111011111001111010111010011101
10011111111101111101111001111111011111110111a11111111111111112211222121101221111112220202220a1101111111111111a111110011a0001100111011011101110010111011111111111
10011110111111111111111111111111101001111111a11111100111111112221021010112212120221111111022a1110111111111101a111111111a1111111111010111111101110101111101111101
01111111101011111111101101110110011111110110a01101101111111101221110212210202221221120111200a0101111110111111a101111100a1111011001111111111111011100111111111101
11111010111111100010111111010101111101111111a11011101111111111221121001121101110111220201121a1110111110110101a111111111a1001001111100011111111100111110011110011
01101110111111011111100010100111111110110111a11111111111100111022202122211022211010112222221a1111001110111100a111010101a0111111001111111110111111001111101111110
11111111101110111111100111010111100101110011a10101111111111111111022212221002201111200120212a1111111111010111a101111111a0111101111011100111010111111101011111111
11111100111111101111111001011111111111111111a11101111011101110012121122212211121111211102012a1111111111111111a111111111a1111111101111111101111111111111111011111
01101011011011101111111101111111110111111111a11111111111111012112200012111112211211211221100a1111011111100111a110110111a1111011111011111111111111111101111101001
11111111111111001111111101111100100111111001a11111111110111011022210122002022101210112112222a1111111111001110a101110111a1111111110110011101101111111111111101111
11111111111111110111111111111111111011111110a11111111011001112120000210102202122112212121120a1111111111111101a010111111a0111111111111111111011011100111111111111
11101100111101111111101111111111111111111111a11010111111011111200211122121222122222112122222a1111111111111111a111111111aaaaaaaaaaaaaaaaaaaaaaaaaaaaaaaaaaaaaaaaa
10110111101110011111101111111111111110111011a11101111111011102101112201011221210021212112200a1010111110111111aaaaaaaaaaaaaaaaaaaaa111110100111101111111111101111
10111011111111111101101111111011110011111100a10101111101011110010211102201121222012211111212a111111110111011101000011111111111101a111111110010101110011111111111
11111011111111111101011110001111111111101101a11111010111111112100221212000212102112220002211a101111111111111111111110100101001111a111111111101010111110111011101
00111111100111111011111011100111111110111101a11111011101111110111111110111110111111122121110a211212222221221022111110111011111111a111010000011110111111111001110
11001111110111110011110111011111001111101111a11010111111111111110110011000101110111101200002a102212121110112201111111101111001111a111111110011111111111001111111
11111110110111111101101101110111110100111111a11111110111111111100110110101011111101011122211a221111021122110201211111111011111111a111111111111011111001110111111
01111111111111111110111111011111011110111001a10101111001111111111111111111011010012020020012b110112001221221211220111111111111101a111110101111111111110110111001
11111111101101011111111101110001101101010011a11101111111111101101111011110000111101220122211a122102100102120211220111111011111010a111111111111001011101011001100
11111111111111011111111011111111111111111111a11111111110111001111010111110110111112002210111a120121121100210111001101111011111111a101011111011011111111111111110
11011111100111101111111001110101101110100111a11101111011110110111111111110101111112022222102b212001212211212101101101111110011111a110111111111111111110101011111
01111110011010111101111111111101111110110011a10111111110011111110111111011111111112212101102a121211100020211220210110111111111110a011011111101111101111111111001
01111110111110011111111111111111011110110011a00111111101011111110011111110111111012212112211a112111222212210011220111111011111111a111110111111111001111111101110
11111111011101101111101110101111111101111101a10110111111111111111101110011011111010112111101a120210012122102122111110111111111011a111110101111111110110111111011
11111101011111111111111111001110011011110111a10111111110111010101100111010101011112022112222b121212222011010211211111111111011110a111011111111000101110011111111
11111111110001111111111111111111111011111110a11111011110111110010110100110111110111212120222a101201222010211012211111101110111111a001111111111100110111111101111
01100111101111100111111101110010100111111101a11111111101111111001110111111111110112011221121b120110112020221211121101001101111111a111101011010111110001011011111
11111101101110101111010111111111111111101111a11110111101111111100111100111111011112211122211a002202112010212112011111111111111111a011001010111111111101111111111
11101111111111010111110111101011110101111110a11110111011111100111010111110111111101002201011a201121122201221120021111001111101111a110111111111111011111111011110
01111111111111010111111011111111011111111011a11011001111111111111100111111111011110220002121a121221122212121221111111111110111010a111011010011111111111111011110
11111111111001111111111111111100111100111101a10011111110101111111111111011111110111012021112b221122222222210121101111111111011111a111111001111011001010011111111
11111011110110110111111111111111111101110111a101011110100011111111101011aaaaaaaaaababaaaababa121110211212221220221111101001011111a110011101011110111111111001111
aaaaaaaaaaaaaaaaaaaaaaaaaaaaaaaaaaaaaaaaaaaaa111111110111111111111011101a11111110011111122102120101211122212111111111111111111101a111011111111111110101111111111
011011011101111111111111101101100101111110111101110110101111111101111111a11101101011201111221101122211222110212211011111111011111a110111111011111111111110101010
111111111101111111110101111111110111110010111111010110111111111011111101a11111011122021201222110012122122021222210110111111011111a110111111011101110111010111111
011111110011111010110111111111111011001101111110011011111101101111111111a11111111121012020122020211002221111211210011111111101101a110011111111011011111111011111
110101011101011111101111111111011111111111111111111101111111101011101011a00011111101211100002110212122012210221001111111111100111a111001011101101111011111011111
111111111111111110111011111110010010111111111011111011111001111101110101a11101111111110212222111212112210102221121101110111000111a101110011010110011111111010111
110111101111111011100010011011101011111111111110011111111101111111101111a11110101120201101121010122211111211012221111111111101111a011111101011111111011101111111
111101110111111110111111011101101111111001111111101111111111111111111111a01100111121001002201211012211201212012121111111111111101a111111111111011011011111110110
011111100111111000111100111111001011111111111001111111111101111101111111a11011111120211121111121112112211022222121101111111111111a100011111111111111111111101111
011011111111011110111110111111111111110111011101111101111111111010110010a11111111121021111220211122211221111022211110011111111110a101111001110110111111111101001
111011110111111111111110111001101011101111111011110111011101111111111110a01111111112212201212121221221112121220201000111111101101a111111111101111011111110111101
101111110111111011111101101101111110111111111111111111111111111011111011a10100100122012222120110101200222210100101111100111101111a111110111011100110111110111111
001101101111111111111110110011011011101111011111111111111111111111111010a11111111122011021212001212122102101212101111010101101111a111011110000111101111110111110
010101100111111111110111111111111111111111111101111101011011101111111111a11111101110110111111110111110011111111111111111110001111a111110010010111011101101101110
111111111111110111101011011111010111100111111111011111111111111111111111a10011011111111111111110111101111111111101110001111011111a111111111111001001111111111111
111011110111110111101111111111111111011111111111111111110111111101111111a10111110111111111111001100011001011011110011111100111111a111100010011111011011111111110
111011101111111000111111111101111011001111101111111111011111110111110111a01111011011011100101111011110111111100101111100111101111a101011100011111111111111111111
111111001111111101110111111011001110111111111111011011111111110101010111a11011111111111010101101101110111111110110111111111010101a111110101111101111111111111110
111111011111110111110111111111111011110101111110111111011111011111111101a11111111011100111111001111111111101110111111111111111011a101101011101101100111111111101
111100111010111011111111111111011010011111111101111111111100101110101111a10111111111111011110111011010110011111010101111111100111a111111111111101011100111111011
