94 1
50 104
118 42
15 7
76 66
86 2
64 26
50 31
133 26
97 97

2211021222110210211202121110002110010011111010111111111110101001011101102112211211000a212121012122Pb211100011110101111111011111110110101101111011110111101101101
1221111010111122121012102002012101111111111101101101111111110111111111012012102011100a21121201PPPP2P221101011111011111111111111111011111111101110110110111111111
2112121112201220212102102210212111111111111111010111110111011111111111112222021212122b1212220012212P211111111111010110111111110110111101111010111110111011110111
1221112221122101220121222121002111101111111111011000111010110111111111012222110222022b2202122101102P021111101111110111111110111011110101111110101111111111100101
0021222120121020022011222002122111001111110111111111111111111111011110121221120102012a0212122002121P010111111110101101111011111011111111101011011111101111111111
1220100201212022021112021102101111011011111111011110111111111111111111111221111221202a1112122012002P110111011111111111011111110110001101101101001111101111111111
2001112101001110110212010121212101111111111111001100111111101011110101101220200121112b0021121212210P111111110010111011111111011010111111110011111110111101111111
0220211122221222122221101011212111011001111010010011111011101111111111111210112102122a2221002100121P220111111110110111100010011101101100111111110001010011011110
1101100212202021020121222001112001110010110011111111001011111111111011122121111222220a2111121221111P201100111111111110010111000101101101011101111110100111011110
1111221011102001110212112011201101110111101111111111101001010111010110120210212022202b2211121102021P020101101111111110001100110111110111111010111111110111110111
2211222122221221210201102211202111110111111101001110101111101111111111112112200012111a1221111202121P221100101111111111111111001010101110101111111101111111111111
2221020022110211112101022201100101111111111011111122121010211212201211222220222211122b1201021210222P210111111110111110012220012220111121001011121210100111111111
1211210102012020221120110212211001110111111111111110122112202210210002222100020022120b1210110012102P121110111111111111122120112221111110220102222222111110111011
1200121002101211110111210122201010111101101101111020121011122201212221122202202221102b2211122211022P021101111111101011121211112011201111221102102111211111111110
1221122101221211201111021002022111101101101011111201201112112222121222110222001222222a1002210222202P221001110110101111120021002222012221011211221022111011111111
1110220210012112120212111121210110111111111011111121121221221121011121212212111212220a1111201211111P211111111111110111222211211212210220101122101212011011111111
1011012111121222102210210102220111122211210110202122120222222201221110122212010110221a0121111222120P221111111100101111010122111022100020002201012121211111011110
2101021010120122221122220122012111111120211121211222111122022022201222122100222022112a0020121222221P210111110110011101222011112112212100111121122122211111011111
1011222112110122210222121122220111122112212121011222212121121022102120011210120211022a0210011022222P220110010010100101210221122002122221122110212121110111111111
0112012011122012212012111101200110121211110111111120022020012212122011120200212222010b1212212112111P011101111111101101201121021121012211021111221200111111100111
babaabbabaabbaabbabbaabaabbbabaaaaabbbbbbbabbababbbbbbababbbbbabbbbaababbbaaabbabbbbbb2100210220121P101100111111110111222122001220121122011222112021011010111101
222122011220202122212111101211110112221211020122201102202222222022012212222210222122222112112020112P101100111110001111100110210201212221121121012111211001111110
112210121011211102220220202120010111101021212120022022212201122122021122222110201122122202120211211P201111101110111011202112212122120012010212111121211111111111
020002122112022111210210012111111102111112122001122220220222022210110202212221201211201210111111001P221110111110011111221202111222212212111221211102100110111001
222222220021111012212110021102111111210112201102102220221122012210020102222122222211101220221111212P210101110111100101221001201120110020201121011211201111101111
221022121200112120222122011121111012100211201102121022002020200101202102222211211122212112222112221P120011111011111110211222112212211100220abbbbaaaabaaaaaaaaaaa
201122022111010122122022222121201001220211121122221220222220002002102021212202022211212221110121102P201111010110101111210210221211222111120b22120122211011111111
101010111110220102102022020121110012011111202221002200102112122202122112212210221002111022122102200P211101201001111112222112201021212021111a10011011010110111110
121110021122010200122211221211001111201212122111222012222222221222112112222120020111102002101002111P111011100222201021022122212222211202020a02110011111111101111
000211202201112010100201022010101111110220221200121111222220222022120221222220221112011101102221121P111022210210112120122212202222200112022b02202212200111111111
221010021212010112212011221222111111102122212222221222221220112211122012201212202010221221210010021P110111212210121111222122212120122222211b20010220011111001011
101110111110110111101101110111111100012012222212122121222101020212111121122111220011111111101101111P111001211100211111222202221100212200212a22222111211101110111
101110101001111101111011111110111112111210011202122122122202212011200211012201001011111011000111111P111222011011122202020122222201220212112b20102020211111101111
111111111111101011101100011101110100122212021112122221010222212222021121120111111111110101101011111P111111112112022220222221002220222212022a01112221010101111110
101011111101110111111010011111011112112110210012202122202222222112210101021102111111111011110111101P111111112111211011022202022202222202210a12222112111111110111
011111101111111011010111111101111102211212222212022120222211120012120121122222020111111011111111101P111211121212121022222202122010000212201a21222111211110101111
111110111111111111111111011111011011112222110211212221102202212012122111122212021111001111011111110P101211212111100010220222102102122211201b12211011111101111111
111111111111111110011000111110110112221222112112121221222111210120110111212112221101111110101111110P111202211202102222020112222101222221210b22221111011011011111
010111111111111001111111110101111111022011212011112022212122222222111122021020111110100111101111110P111002212212220022222122120222212222111b21222201010111110110
011101101001011111111111111111011102211122200222001200220221220122212122201022111001101111011111101P111112122111021121220222220011022122221b21202012100111101111
011111100111011100110000101011111111220220001012222112121220222222102120122211021100111111001101101P111101221100100111210212112220120211012a21120220111111111110
111010111111111111111111111111111011112000222120022012102112120222212102210110111011111110011111111P111221111212012201212022222022220222221b21002222210111011111
111111010110110101001111011011111110121212021021111101110201001202101111111111111011110111111011111P101122111121121002212112111122010110011a11110111110111111111
111101111111110111111110001111111112121002212100211122111122221010111111101011111111000111111101111P111100221011110100210201020222120111101a11011111111101111101
111110111110000111111111111111011111111022210101102121000211122122111111111111111011111101111111111P111001122122221101112111222012102011111a11110111111110111111
111111011011111111011011111101111110210212211022221201221210121001111101110110101011111101110101111Paaababaabbbabababbbbababbbabbbababaaaaaa10110011110101111111
1111111000111110101111101011111110101122012110012201111202220122111011111111111010111111110PPPPPPPP1111222112201211202000112112122222011111110011111111111101010
111110111111111110111011110001101011101011111101111111111101011111100111111111110110111111P011110111101012221222122110212021012201221201011111110011101101111011
11111011011110111101111111110111111010111111011111111111111110111111101101111101111111111P1110111101011122121011111221210110221212121111100111111111111110111110
1011110111101111111111111011110111111010110111110111111111111011111111111111111101110101P11111101110011220111112112201112210122112111211011011010011011111111111
010111111101111001010111101010111101110110111111110111101111101111111111110111011000111P111111110111110001002221212112221221212011212111100111111111110001101111
11111010101111110011101111110110111110011111110101111010011112112220200021021112012122P1122111110111101111221102102122212122222221111211011111111111111111111111
11011111110111111111111001110101001110011111111111111101111111102120102201221110222PPP21212011111110110222102110211212021221112101211100111111111111111111101111
aaaaaaaaaaaaaaaaaaaa1110110110111111111aPPPPPPPPPPPPPPPPPPPPPPPPPPPPPPPPPPPPPPPPPPP02111021111000101111110121112212002122210202121202211111111101011111110111111
0001111111101010111a1111111111111111111P111100101111011010111221111101222112202b00221100201111101111111121112102102201212222012111122111111111110011110101111111
0111111111111111110a1111111011111001111P101110101111010110011220102102120221212a21121202100011111111111111012120222012112201101111120210110111011110111111111101
1111111011111110111a1111110110111100111P110111111011110011111011202212200022121a12121212020210110101100222122202221210110100121212221211111111111111111110111110
1111110111111000011a1110010011111101111P011111011100111111111021122222211121201b22111222222110111111111012102002112210101212021221122011111111111111111100110110
1101010111111111101a1111101111111111110P111110111111111101111121000101011112112a11212120102211111111101100110111111011111111111011111011111111110110011101011111
1101011111110111111a1101111101101110111P101111111111111111111221022202101100121b12220122112111011110111011101100111111111101110111011111001111100011001111101111
1101101011011011101a0111101011111101011P111110111111101110111112002220100222002a20211221112111111111111001110101011011011111110100111111111110011110011111111111
1111110111111011101a1111111110111101101P110111100101111111011022221221122110222a01211010111211110111110001101011011111111111110111101111110110110110110110110101
1111111001110111011a1111111110111111110P111011111101011111111121222102222010110a02122022202101111100101111111111111111111101111111110111111011111100111111101111
1111100100111111111a1101111111101011111P111111010111111111111221102110121201112b10010222110110110100011111101111111111111111111110111011010110111001111111110111
1011111111111110111a0110110111110111111P011101111011111111101011211021021222222b01112202110110110111111001101101111111111111111110011010111111101111111101111111
1110111111111111111a1111111111010000110P111111111001111111111012112121012121020b12212221101111111111011111111111110100111100010101110101111011111011111111111001
1011111110101101111a0011010101100011111P111111110111111111100210221222211101201b22211100112211111111010000110111010111111111110111011111111111111111110111101111
1101111111110111111a1111111101111111101P111010100101111111111202112222011222111a21121221121200111111111110111111110111111111110111101101111110111111111111111011
0101110110111101111a1111111110110111111P110001011111111111111111112012111212121b11010220021110011100111110011111111111100100101111101011011111111111011001110110
1111111111111111010a1111001111111111001P011110111111011111111110011222111110212b10202202202011100111111110011111111111110111111111101111111111111110111110111111
1110111111111111011a1111111000111111111P010111101001101011011020200021112112022a01111111111101111111111101110111001000011101101011111111111111111110010111111111
1000011111111111111a0011110111111010111P101011111111111011001121022222112112220b11122102110201011111111111111111111111111101100101111111100111101111111110101101
1111011111100011101a1011111111111110111P111111111111001011001112201202000111001b12212101110111011111111111111100111111111101111111011111110011011111101111110101
1101111111111111011a0111101111111100111P111101111111101101101020201002120102010aaabaababaabaaaaaaaaaaaaaaaaaaaaaaaaaaaaaaaaaaaaaaaaaaaaaaaaaaaaaaaaaaaaaaaaaaaaa
1001001111010111101a1111111111111111011P110111111101110111111211212012202101112121211112211111101110111110110011110111011111111011111111111011111111111111111111
1101011111110111011a1111110111001111111P111101111011111100111022012200111221220211122211011211101110111111011111111111110110011111001111111111111111111111111101
0110111111111110111a1111000011011111011P111110101111111111111211221211021212210220111221222211111110010010111111111111110111111011111111111110111110111111111111
0101111111101111101a1111111110110111111P111110111111110101111121221001012112112111111001021211111100111111111111101111111011101110111010111001111111011001011110
1111110111011111101a1111111111101111111P111111011110110001111111211110222212120222202122021110111111111111111111111101111111011110111111111111101011011111011111
1110011111111110111a0011111111110111111P110111111111111111110112121212212210112121112222110210101001110101111100101111011011111110110011110111111011111111110011
1001111111000111111a1000010111010110100P111111110111011111011221111221211101222222112021220001011111101110010111111111111111111011011111111111110111111111111111
1111111011111111011a1111111101111101111P111111111111001111101202010211220121012012202120102011111100101101111111111011111111110111111101111111111110111111111111
0111111101111111011a1011111011111010111P111111111111100010101111111111111111011110022011002122212102211202212211111100101111110111111011111111111011011111111111
1111001011111111110a1111111110111001111P101011111110111110011110110101111110111111211202112012110212102211021000110111101110111111110111111110010011111111111111
1101110111101111111a1111111011111011111P111111111111111011111111011101100001110011221112111022222112212222112221211011111111110011110111111101111101011111111111
1110111111011110111a1110011111111110111P011101111111111011101101111011111110111010011122000212222112221220111100111110101111001111111111111111111111111111100111
1110111110111111111a1010111101111001111P111001111011100111011101111101111110111101120101221202011120011011121112111111111111110101111111101111101110111101101111
0110111010111111101a1011111101011111111P011010111110111111101111111011111111111111212221022201212120120121022022211111111111100111111011111aaaaaaaaaaaaaaaaaaaaa
1111001110111111111a0011011111111111111P110111111111101101101001011111010101111111121210121111100111102101020221211111111011011001011110011a01111111110111111111
0011101101110101111a1111110110111111101P110011110111111100101111111111111111011111121210212001120212222210121222201011111111110111111111111a01111111111100111111
1111011101101110111a1111111110011100111P111111111111111011111101111101101111100111202111102022221102111112111221111110111110101111111101011a10111010011111111111
1111111101111110110a1111111111111110110P111011011100111111110011010110111110101111102021202202022122211212110012210111111001111011111111011a11101111011111111101
1010101111111111111a1111111111101111100P111111111110011011001011111111111101011111122122201000112201002221100202011111111111011111101100011a01101111111111111111
1101011101111011001aaaaaaaaaaaaaaaaaaaaP001111111101011111111110111111001011111011122111221021002211211121210101211010101111011111111111111a11101111111111010100
1011100111111101101011111111011011110111P10011111111111101101110011111111111111111121211121100202122111112212110111001001110111111110110111a11111011011111001011
10101111111100101111100111111111111111111P1101101111011111111111110111111111110100022101211112112201111211100011211101111101100111101100110a11011110001111011011
010110011101111111010110111111111101111011P111110111111111110111111110011011111111102120212222221220221101012112200111111111111101111101111a01011111110111111011
1111100100111111111111011101111011111111110P11011111111111100111111111111001111110200112211021201121212201110201201011110011011111011111011a11111111110101111110
10110111111111111101101101111111101101111100P1111011011111111111111111111011110111100022220012202012011211021121111110011010111111110111111a10111111111111010011
111111111111111110110111001110111111111111111P110100111101111110111111101111111111011222011222011022210212210110111111111101111000111111111a11111111101111101111
1111010010111011111110111101111111111111110011P11011110111011111101110111111011111201211212212122122112221212122011111111110010111010101111a01011111111111110111
10111111111111110111001110111101111011111111101P1111111110111110101111101110111011110211121111121012111211022120111101111101010101111111011a11111111011111111111
101111011011111111111011111111110110111111111101P111111111111111111001111011111011111221211122220022202221012201111110101101000111111011101a11111011110011111111
1111011111111111001100111111111111011110011011011P10111111111110111001010111111011011020121122120212220121022111210111011101111110111111111a11101101111111111111
11111111011111101111111111111011111011110111100011P1111110011111111111001011111110001111220211100201101111021220100100111111111111101111111a01111011111111110111
1111011011101011111111101110111110111111111010111011111011111001011111111110110111212112111110121110122202022122200111011111111111101001011a01111111111111111111
0111011111111111100011110111111111011111111111111101111011000111111100111011101111011211212121101111111101021121201010011111011111111111110a01111111111111101111
10001011111111101101111110111111101110111111011101111111011aaaaaaaaaaaaaaaaaaaaaaabaabbaababbaabbaabbababbabbbbabaaaaaaaaaaaaaaaaaaaaaaaaaaa11111001111111111111
11111110111110011101111110111111111110001111111111111111111a1110111111011001111111101221101200211011222202101222201111110111001011111001101111111011001111111011
10110111111111101111111111010111101011111110111011111111111a0010111001101111111111112110010112111002221122121012111110011111111111101111111110110111101111111111
10011011111111011101111011111110110000111110011101111111011a1111110011111101111111211200221112011111110222210100001001101101011110111110111111100001110101011111
10111111111111111111111111011011111111111111111111111110110a1111111111011111110111121022111212222221200021120222111110001111101111001111111111111100111101011110
10111011101111111100111111010001011111111001011111001101111a1111011111111001110111221011122221112122120111022211211011111011111110110111111111110111110111111111
11101110111111110111101111011101110101101110110111001111111a1110111111111011111011110111111110101011101101101111111100111011111001111101111111111111111011101101
11110111111011111111111011100101111111111111111110111011111a1111011110110111111110111101101111111111001110111011111010101111011111111111110111001111111101101101
10111100101111111111110111110111111110111101111111111101111a0111101111101111111111111011111111111111111111111111101111011111100111111111101111001110101111110111
01111111011111101101011111101011011110111111001111011101110a1111111111110110111111110111111011101111111011111101111011111111101111111110110111111100110111111111
11110101111110111111111011111101111011100101111111111111111a1111111010110111101001011101111011011111011111111111101111110111110111101111101111111111111111101111
11001111110111111111110111111111111110111111011111111111111a1111101110111111111111111111111111111111110100111111010111011110111111010111111111111101111110111110
01001111111111011111111111011111011111011111101110101011111a1111111111111111101011000001110110011111011101111111011111111001111111111111101111111110111111111110
