17 10
132 106
118 42
15 7
76 66
86 2
64 26
50 31
133 26
97 97

0122012212112111211011012011202001111111111011111111111110110110111111111001202a21111120210111022201101011111011111111010111111111111111111111111111011111110001
1021212221122221120100222021102111100111111111111111111111111111111010112121220b02211011221010010102011111011011111110111110101110111011111101011100111111110111
1011200012221210111120101212122110101110111111011110101111110001111101111210102a22221010221221101120121111111110011101100101101101111110111110111001111111110111
2102000121201121112211221212111101111011111111111111111111101111101110121210220a11222211112111210221101110111111111111011011101110111001000111111010101110111111
2122121121121112111012021101211101101100111111111111111110111111101111000111021a12122100220212012112211111010111010010111011110110111101110110101111001111111110
1211220121212210102111022012012101011111111111111101011011011111111111122102112a22211220202122212121210101011111111111011101111010011011110111111111011111111110
2021012121212220021200221202211111010111011101101111111010101110011101102221102b21201121111221002120101110111101111101111111111101110111111010111001011111101101
2120101211102212102121212112212111110111011111110111100111111110111111101222120b21222121002121212110101111011111111101101111111001111111111111101111011011110011
2222000111221210011110211121100111011111111011111101101111110001101101120211101a22012222211221122210101101111111100111101111111111111111111110111011111111111101
0221212221112201111211201222122111111101111010110111111111110100110111121222012a22202201121211210111111111001111111101111110100111111011110101111111110111110011
1221120122111111122012222121020111111111111011110111111111111111111100121012220a22222122221112021220120101011101110111011111100111100011111010111011111111011110
2202021100120020221100001111201110000011101111010001220222012102212221222222022b11022221222011122210121111111101110101120121222122222111221211012221011111111111
2201221012212012122020221001202111101100110111111011202110121122102222100212212a12211112021020112100221011111111111111011121110212021212122101212211211011111011
0002100222201111111212022111121111111001111011101212021121122111112221001220212b01122112201201112012111101111111111101011201002211122020112011112000100101110111
2102020201202221221112212222121110111111111111011101112001100021012221221222222a02101212102111220110110111101111110101221020121212211112122111102200000111111110
0111121111100211101022011111112111101101011110111111020222110110112120221022122b21120121111212212202121110101111111101212112111201210111210221222121210111011110
2212200221111220211021112122212111000012212111121200021202222222211222211222210b22210201220202022010121111101011111111010022121102012212222221210112001111111101
1211100121111121222012222101122111021022121111121211121200000111001100222222222a10222201121111121222121011011110100101002111201111102022122221211112111111111111
1010022222121201220202202222121111101212011121110102112202122220221222222122220b02112111021112212111121111000111101111221112210112202102221112211212111011110011
2112121211212122211021001121221111112102210212122220212221220212220202122020222a22121222121102221211020111101111111111200212210211021211211111221210011111111111
2112112220021101112100211202201101110202122111211122220102111201221121022220022b12221100102221201201121110111111011111221102102121200112202222212022111100110101
2202201111002211222200201122020111111220122200111221222222222222221221120022112b00110221012121222022211111101110011111222202102210112222212110210210111110101100
2211202111220120101220122011222001101111121121122120221122202210021222021202120b20221100112222121212211011111101111111221201201012110121112111111212111110111100
1221222121222022122202202200212111121112101222102222222122220122212112100222220a10011012121122110010101101011111111111221221121121121111121011211112210101010011
1101211011021101020212022002112111021120112202212212101121002222221222202210222b12222212110121221001201111111111110101212020001001011200212110100111011111111111
1022221202121121021100102211201111110112212102201212012102221221201112001202111b12011201200201111121001111111011111111222221220220122212121221212200201101111011
1001222220211212012002212120021101100112111021212221122011212220012120122222122b02102022110220122222101011111101111111020010211112102112212122101022100101101111
1012201212212212122112110221112111110020112002122210201021110212220022122222212a10212122000022122212021222010222210020222222222202121021101221120021111111111111
1012211221011012102021202122112111122010010202221220121202122122221111122212222b11201212112200211212121101200111211211222122102200022202102210221021111101110011
0212122022021120222122110201112110122221111122222222000222212002120211222022222a22112220211001222111101202101012202011220222022221022201122001022121101111101111
1212222021120111221201210222221111122122112011022122212222200220212101221022222b11022212121101120021221111022121201110220122221222212122111012022211110111111011
1110111101111111111011111111010111110222122001012202222202201221021210112122221b11110110111111111111101102102112221002021022022122222022101121220211111100011111
aaaaaaaaaaaaaaaaaaaaaaaaaaaaaaaaaaabbbaaaabaaaabbbbbabbbbbbaa022221222221221112a10110111111011101111001222220121211222221222022202100122021220101002111101111111
110011101111011111111010111011111110120111022121122220122001b011022101011210011b11111011111111111011011110210101111220212202222212202211012202110212101011110111
110101111111110101111011100111110111112021221210012222210020b022212211110012121a11011111111111101111010012100020212111111022211102021202112121201111111111111111
111011110111011111111011111011111101021021102011122212220221b122201102121111011a11011111111111010111111121011102112022222020111020221211002102111122110101011111
101101111111100111101011111111111111002111211122112111212022b220222020202212212b00010110111111110111001201121221011111121222102022221200221112222200110110111110
111101111011100111010011111111111012122002212001122211222222b021222022222102122b11111111111011111101011110212211100201022020021122021112211112022222101101011100
011111110011111111111110111111111102221020120111101022022222b210100212002100001a00000111111111011100000112021220210112202012002122221212002201212220211111111111
111111111111011111101111110111111010000210222212112021120122b220021100120121221b11101101001100101100111022021212121111011211002222222221211121112010111111111100
001111011111111111110110111111011111221222011112122121222222b222012212102122122b11111110101111111111111221122012111212210222222221222210022010111100111101011011
011011010111111010111000111111101111220122220021100222001222b002220121212112221b11111110101111111011010222222221221100002222222222221120220111221022011111011111
110101111110111110111101011111111112111222022222211211022020a122101111111011111a11111100111101111110111020121221111220000202011001110101111010111111101111111111
111111011110111101011111001101101111120022122002212200112112a002021101111111011a11111110111101111111011200021111110111122222222201222210011111111100110111110111
111110101111011110101000011011111101021201112200212221100011b221200111111111101a11111111110011010010011000010101211111121221121221202111111011111110110111111111
111101111111111111111111111111111111011012220200212101010022b111211010111011011a10111010111111011111101222211010112022002201212222112211110101110101110001001101
111111101101111111011010111110111110121022111211021021212112a211221111111111111a11011101111111110101111001220121211210211111220202221101111110111110101111110011
111111111111101101001111100101111011111011111111110100111111a011111111110011010a01111011111101111011100112011222222112120111201021111201111111111011110111111111
110111111111011100011110000010111110110101100111111111111001a111001011011111111a10111010101111111110111120122201221002112121222222122211111110101001110100101011
111011011111001111111010111111111111110011111010101010111011a101111011011111111a11111101011101111111101212222211210020120110122110210111111110111101011111011101
011111111010001111011111111110111111011110111111111111110100a111111011111111111a11101111111100010111000022100201122212100222122122121200111111111101111111111111
110011111111100111111011111111111110111011110111110111111111a120110111221211112b21212122222201011101111021222020222112112011221102211200111111110110111111111111
aaaaaaaaaaaaaaaaaaaaaaaaaaaaaaaaaaaaaaaaaaaaaaaaaaaaaaaaaaaaa221221122202221200a12111111201211111111111110110122002221222111202221221211101111111110111111101011
1101111111011111111111011100111011110101001010111101011111010122202111111210221b01022011212111100111111212122220112111101211111002120211101011111110101011000000
1110010111111111111111111100011111111111111011111101011111111201221211210021020b21221201021101110101111012212122021201112210202221202010110111111110111111011101
1011011101111111111101111111001100101111111110111111111100011021011201021221020b01122201112011110111111122202010121121211122102212120011111111110111111111111111
1101111111011101110111111111111111111111111101110111111101101122222210211122220b20121102122011101111111202201210212121002212122111112110110110010111111111111111
1111111001111111010011101111111111101111111111111111011010111211011202110221212b00221221021111010111111122221010102102110111021012210211111111101110111111111110
aaaaaaaaaaaaaaaaaaaaaaaaaaaaaaaaaaaaaaaaa11110111111111111111200221010222021201a12211211121011111111111011111111111111111001110111110110011101111111011011011111
1110111011001101101111111111111111101111a11111111111011111111122101221020111021a21121211021110011101111111101011011001111101101111111100111111011111111111011111
1111110111111101111110101011111111111111a10111111111111111111112202011222222101a00022221212101111011111110111011110011111111111111111111111110011011110111111101
1100111110111110111111111101111111111111a11011110110110101111011020010221211120baaabbaaababaaaaaaaaaaaaaaaaaaaaaaaaaaaaaaaaaaaaaaaaaaaaaaaaaaaaaaaaaaaaaaaaaaaaa
1111111111111001111111011110111101110100a11101111011111111101021012210101101011211222202100111111011111111111111101101111101111111111111010110111111111111110111
1101111101111111111111111111101111111011a11111110111111011111221000112121111222022112221011101111111111111011111111111101110111111111101111010010110111111111111
1101111111101111011111111111011111111111a11011111101101111011020212110001010212221121122211110111011110111111111110111011111001111111011111011111111100111011111
1100111111110111111111110110111111111110a11110011101101111110012120102101211102002201220212211011110111111111110110110110011101111111101101011111100100111111111
1100111111110011101110111111111111111111a11111101111111011111111022112221212120012112121122201111111111101111111111101111111011101110111110111111111100111110111
1011101101101101011111111010111111110111a11101101111111111101100111222122121211abaabbbbbbbaaaaaaaaaaaaaaaaaaaaaaaaaaaaaaaaaaaaaaaaaaaaaaaaaaaaaaaaaaaaaaaaaaaaaa
1011011011111110111111011010101011111101a11100111001101101001222112222110111211b01012011111111010101011110111100111111111111111111111111111111010111111011111111
1111110111111111111111111011100110111001a01111111101011110111222121221011122212a20122101022211100111111101111101111111111110101011111111111101111011010100111011
1101001011110101111110110011011111111111a11100001111011111110211121212002111012a10121112012010010100101111111110111001110111111111110001110101110110111110101100
1111110011111110111111111011011110111111a11111011111111111111122111211200112111b21201211112201110111111111010111110011101100110100001101101111111111111111011110
1011111111011111111111111111111111111101a10011101011111101111121221220021202212b21222120102211110101110011101011111111111111111000111011011101111111101111011011
1011111111110101001100111111110111111100a11011111111111011111211221212212000222b10221012111201111111111011100011101111110101111111111111111101111100111111101111
1100111011111101111111111111111011111111a11110111101101110111101112211020122221a11221112111110111111011111111110111111001011011111101101011111101001110111111111
1111110101111111111111111111101110111111a11110111111111110111021010211002211121a20102111112111011111111111111111011100111111111111111111110110111111111111110101
1111111111101111101111010111111111101011a11101011111111111101210112220122210200b20011221112211101111111110111111111111101111100111110011110111111111101011111111
1110110111101111101110111111111111110111a01110001111111111111022122212022121120a21222112212211111111111001110111111111101111111111111111101111111111111111101111
1011101110111111111110110101111111111101a01111011101110110111011122101002211220a01212201211011111110110110011111111111100111110111111111111100110111111011110101
1011100011111111111111111111110111111011a01011111110111101111200211111112222022a10110212111211011101010111100000111101011110111000100110110101111111110111111111
1111111101100111111111100111110110111111a10111101111111111111121221210212221211b22120212211110011111111111011101011011111101101110011111111111111111100011111011
1111111110011111111110101111100111010111a11111010111110111011111121011112222122a12211201221211111001111011101111111110111111111111111000111111110111101111111111
1011111111111111101011111100111111101010a01110111011111111111101111111111111111a10201212011221011221211221222200211111011110101100111101111111111010111111111011
1101111111110111111111001100101011011111a10101111111101101011111111111111011101a11212210210122122122111221021222111110111110111111111111011111111111111111111110
0111011101111111101111011111111101111111a11111111100111101111111111011111111011a11211122222212021111212221110112111111011111111111111100111111111001111011101111
1111111111111111101111100111101111100111a11110111011011101111011111111111111111a10212120212101211020121220110102111011111101111111011110100111011011111111111111
1111111111111111111111111110101111111111a01011111111011011101001101110100111110a11000111020210022211102011121220100101100111001111011011111111111011111111110001
1111001101110111111111111110111111101001a10111111111011110111111101111110101011aaaabababaabbaaaabaaaabbbaabbbaabbaaaaaaaaaaaaaaaaaaaaaaaaaaaaaaaaaaaaaaaaaaaaaaa
1001011111111111111111011100111111111111a10111111101101111111101000111110001011011111120212221221211121012212000111111110111011000111101111111111111110111111111
1011001111111111111111011011010101011111a11111101101111111111111111111101111100110122120021020002001122022112111101011100011011111111111110101101011111101111011
1111111111011110111011111101111111001110a10101110111111110111110011101111111111111221222112211200121212112011121110111101111100111101111111111011111100111111110
1111101011110101111111111110101011011111a10101101110111111111001110111111111111111221102210222011111112221111212001111111101010011101111111101110111111101111101
1111010111111101111110101111111111111111a11011010111111101111101111101110010111101010110112121221120110122112201211111111010111111111010111111111100111111101111
1111111111111001101111111110111111101101a01101111111111111110110111011111011111011221111111012112210121112112122101111111111110110110011110110110111111110010101
1110100111111101010111011111101001110111a10111111111111001110111111110111101111001022101201202021111110221221201210011011111111111111110111111111111101011110111
1111011111011011111111010111111111111111a11010111111011111111111111111111011111111102222211220121210110212121010211110101101111101111110001111110111111111011100
1011111111101111111101111111111111110101a01001111111101111111101111011110101111111011111202112111121020112210120111110011101001110110011101101110111111111111111
1111111010111111110111111110010101011111a11111110011111111111101110111110111111110222122221000220222211022110110011111001111001111101111111111111101111001111111
1110110111111111101011111111111111111111a10111111111110100110111011111110111111011121202022202211211111112202111011111111111111111011111110011011101111111110111
1111110011101110111110111100111100011111a01111110111101101101111111111111010111110011211210122212120122002220112101111110111111111111010111111111111101111110111
1111111001111110111011111101101110111001a11111111111111111110111111111011111110111011210212111211001011211110211111011111101111111111111111111111111111111111111
1111111111111111011101110101110111110111a11101010111111001001010100111111110111011011021200110111021210201111102011101111111111101011101111111100001111111111100
1011111011111111100110111111101111101111a11111011111111111111110111110101111011011211021212201002121111211202211001111111111011101010010010101111011110011111111
1110011011111111111011101111110111111111a11111111111001111011111000101101011100111220011010111222201211011102022111111110111111101110111111011000110101111111111
0111111101111110111011101111111111111111a11101110110111101111101100111111010111011012220122112212010221010220222100101111111110111110111001110111010111101000111
1101101111101110111111111111111011011011a11111001111101111011111110111001001111111102120022201202221020211021120111111111011101101101110000111111100111111111010
1011111111111111101111111111111111111101a11001111110110111111111111111111111111011112112222222211121011121102221111010111101111010101110111110110011111101110011
1111101011111010111111111011111111111111a11111101101111111011111111100001111111111112011111112112210120122122212210011111111111111101111111011101011101111011111
0111111111101110111101111101111011111110a01110110011110000101111101111101110111011122021111202212221001210210121211111110010110111101111110101111111111111111111
1101111110111111011101111111111111101011a01111101011111110010111111011101010111111021011221011122100022101111220011011111011010110111101011000011111001111111111
1111001101111111110111111111111111110111a10110101111111011111111011111011111100011201221212220201222000210211222211011111111111111111111111001111111110111111111
1111111111001101111100111111111101111111a11011101111111111111111110111111101101111010122112022221022111001111222011111011010111111010111111110111101111110110111
1011111111111111110111111111101111010111a01111111111011111111111011111111111111111112021210012020120011111112020010111111111111111001111111110111111101111111101
1110100100111011111111111111111101111111a10100111111111110111011110111110110111110111101100111111110111110111111101111111111001111111011101011011101111111000101
1101011000011111111101111111100111011111a11110111111101111111111110011111110101111001111110001101111011101111011111101110111111111111111101110111111111111011111
0001101111111011011101111111110101111101a11111111111111111111111110011111111110110011110111111101111111011111101101110111110111111110111111101111010110111111100
1011110111110011111011111110101011111111a11010010111111011110111110010111110101110111111111111101111111111110110101111100111111111111111110010111100111011101101
1111111111110011111110101111111111111110a00111011111111011101100101111101101111110111010111111011111011111011111100111111011101101111101111010111101000010111111
1100111111001011111110111111001111110010aaaaaaaaaaaaaaaaaaaaaaaaaaaaaaaaaaaaaaaaaaaaaaaaaaaaaaaaaaaaaaaaaaaaaaaaaaaaaaaaaaaaaaaaaaaaaaaaaaaaaaaaaaaaaaaaaaaaaaaa
1111011110011011001001110111011110111111111111111101111101111111110111111100110111111110011101111111110111011111011011111111111111101110101111111011111111111101
