22 2
103 11
118 42
15 7
76 66
86 2
64 26
50 31
133 26
97 97

2011122002220122222120122P02PPPPPPPPPPPPa001011a111101111100110001111111010212120212111110a000211222011001011011111111110111111111110110111111011011111111111111
220022022202121121012202P2PP221111101111P101011a10110110111111101011PPPPPP2PPPPPPP21101111b211111101111111111111111111111110111111111101111111011001111110111011
2110201112220101201211PP2221120111111110P011111a011PPPPPPPPPPPPPPPPP001011P0111221P2221002b121220211101101100110010111111011001011111101011111111111000111111001
2211002210211211122010121201012011011110aPPPPPPPPPP01110111111111011111012110200222PPP2121a100111100121011111111110110101101111010010110101011100011110110100010
0012021202120102211001112121220111111101a111111a11111011011111110011001111022222001122P200a120011121110111011110111111101111110111111001111101111111011111111111
0012112020120122022021122212001111111111a111011a011101111011101111111012011100112221201P02b221212000011111110111011101011111111101110111111101111110110111111111
1001011112122122020121212100011111011111a111111a1111011111101110111110111212111211122222PPP120211122111111111101011111111111011100011110111111101111111111110111
0102022111022122221002101112212111110110a111111a011101111111011101110110222111201110221122P202012120211111011111111011111110011101101110000111111111111011101011
0110120220200212012220122202102100110111a111111a111111111101111011100112221210220201122212P120221222201100111101111011011111111011110111111011111111110101101111
1202212212011211012121012222112010111111a011101a111110111111111111111112012221012111102122bPPPPPP222121111111111111101010111111111001111111111111111111010111011
2110121111120010222210200112221111110101a111110a111110011110111110110101221121122001102112a210220PPPP2P101111110111011101111111111100111110111111111111111011101
2222212012111120212001011212221100001111a100111a122011200011211120220212222022221211012021a2010212112P0P10111111110111122112102121111112101121121222011011111111
1211211221022211211211122102112111101110a110111a101111112212021121222222111211021112022221b220212102001111101111011101201122222211022001122202201211211110110101
0220222201201221221101122122112111100001a011001a120221211121211121112221012220221002002221b021202021001111111110001111222022101102212122212111212021011101111111
1212000211012011112111110222220111011111a101111a112112121122022200201000120002021011110201b120011121121111011011110110121012212021111022221110010110011111111111
0011211102022212011221110122101111111101a101111a111101121011120222122121201222202212111022b222112220010010011011101111212202201211212221102021021202211110101111
2211111212001011122201121222022111122012b112221b122111200002022020211222222120012102222101b221002012121011110100011110021100211212202002111110102012011111010111
0000220012102200222111111022100011011110a211211a022002122122122101221220220212121111012101a201112211220111001111111110121121220011021222111122012022011001111101
2011100021100202211200122211022111121201b122120b110221201202222112022112222011122220201112b210000012111101011011101011012120211222111021120102220120211111011111
2121222011021122010221002222110010120102b210111b122022221201202212120022202222202211112111a122121102120111111111101111111120112020211222122200212101111111111111
0200222011201210122211222210201111111012b102221b221022100212212221100220122020001212222202a021111122221110101101010111112021221001111201220201121121211101101111
1121201112201012121020121212220111012120b122122a121222220212212122222200022122201111222102a121221212201110111100101111121122022101111121211112121220210010111110
2110102110102122011220122111221011111211b212211b022201222222222202120202221022222221212211b221010122010111110111010101102212021210222111101200122122211011111111
2022120222210121200122122022112111120112b012220a210122202002222202110201222020111011110200b221220122011111111111011011122122212122101221101212102122011011111111
2212121102201122122020211012211111112022a210111b110222021222212102120111220020202221101112b202221120101010011110111001201221221211102212220211212112211101111111
0022211012211100111201201211122111112211a112202b122122121002021222221120212200021010220202a121111121201101111100011011122121111221121112122001112122211111111011
1112212022022111122202221221122111121010a120020b222110202120210112111212020120201212111221a111211212221111110111111110021220221122122202222211122022001110111111
2201222110102201211201202212101111122200b221121a121120210011122221220212212120122122110011a120210112210020112212112222012102202021202222021112112120110110111011
0201012101222211212112120221122111110202a211112a122020120222022221120111222222101212021200b112111122111000101001121111222222221202112201101102010122210111101111
0211121100221211221012122222212110122220b112122a222222220021212202202002022210221211012121b112111111210022122212012211022200201022222212221101221122111101100111
2110122122201012101110011202002111112111a212222b002112222220210110201222122212222102212021b111221100121221101201222201022222201222122222110201011211111011100111
1111101110111111111111111111101111002022b111210a122002220102212200221222202112210111110011a111110110111102221121211122210212220120222101102002112211110011111111
1111011111111111101111111011101111101212a100212b022202112122222222112201200011101111011101a111110111101022221002220222221212212202222102120211120200111111111111
1111111101110101111111111011111111110022a220212a221020202220222222222110220022101111100110a111111111010211111101121122120221222022122020220201021222210111111011
1110111101110111011101011011110111111001b022221b100222222122201201110202111111111111101111a101101101111102111222100120220211102221002212202211022111011111111111
1111111110111101111010111111111101112210a212222a100022122221122121112222122120211101111111a110110011111221200111222211211112220212220110222010221121211111110011
0101111011111101011111111111111111122212b211110b201222222202212212120112122122201111101101a110111111011221212020021211222120220021200212101121112222101111011111
1111110111111011101111110101111101010012a120221b121202112222222222221112112202221111111111a011111111001102211200102202202222112121222220222020101122111110011111
1111111111100011111111111101111111100200b211221a121021222222020121122112122202010110111111a001101111101111112220202012220202221202222122211121121211201011111011
1111111011110101111111111110001101111112a112001a102222221222200222210011210101121111111111a111101100111021122021112102112120222220200100110212022022210111011101
1101011111111111110111011110110111102201a201221b101121220202122002100221012012201111011010a011111111011202122120212222221111222120121012021210012221211110111111
1100111110110111111111111111111111121222a102122a120222020221222201111122021212211101010111a111111101111210011022212211012222102210022212122122112022100111111110
0011100110001111011110110101100101111012b220222b212212102111120010111001111110110111011111a100110011100210202001121122112012012120112211111111101111100111101101
1111110111111111111110011111111111112210b111102a022001002121121221110111110110110111011111a111101111111112102022122121110120120211201111001101111111101101111010
1101111110101101111110011111111111002220b110112b121111221100112211110111111111011101011111a111111111011212222021102221222210102221211201111111111111111111111111
1110111111111101010000011101111100022211b120200b221110101212111121111111100111111111111111a111101111110202222111222112212222201111011110110111011101111110111101
0110111011111111111111101111111110120012b222211a222121210222220121111111011111101111111101a1110111101012121111122112110babbbabbaabaabaaaaaaa11101111110111111111
1111011111001011111111111110111000111011a111101a111010010111110111111001101011111110101111a1111111111111211212222220102a2220020222111111110a00111111111111111111
1101101011110111111011011011111111111101a111111a100111100110011011011111111111111111110101a1110111111111112010222112020b2120221211112101111a11011011011111111011
1111111000111111111111011111110111110111a110111a111110110111101101001111111110111111110110a1111101111110212111212200201a2122221200222211010a10010101111111110011
1111010111011111111111111101111010111111a110110a111101101111111011011011111101111111111111a1011101111112212102002001122b2121111221022011111a10111111110011100101
0111111011110111111111111011111111101110a011111a111111011011112011021002112210211112120211a2110111011111220221220112112b2121222201122211111a11010111111101011111
1111101011111111010101101100111111111110a100111a101110111101122120102012112120211020001200a2001111111112011221122212101b2221211112122111101a11101111111111110111
0111111111011011111111111101111111011011a111111a111100111011112111021221220111022222011221b0010110111111202102202122022a2221002112121201111a11111111111111111111
0111111101111111001101100011111111111011a111111a111110111111121211000122221222000211111211b0110111011010102121110220102a1222121202102211110a11011111111011111111
1111111111011111011111111011111111110111a011111a111111011110100020012112222122000202101110b0111001011112211012111220102b0210221010112211111a00011110010111101011
0111111111001111111111010101111110011111a011111a111111011010121212211100202211122021120121b1011111111112212012212222120b0101212121111010100a11111010111111110111
1111111101111111111111101010111011111100a111000a110101001101101122221112221121110112101122a1111111011100220122122212012a1121220211120211001a11011101100111100111
1111101111011101110111111111111111010111a111110a111011111111111111001221110122221202222022b0111011100111111111111101111a1110101111111111111a11111101011110001111
1010011111111101111111101111111111111111a111111a111110001010111102212212211222002122101100a2010111111111111111111111101a1111011110111111111a01111111110011101101
0010111111111111011111110011111111011111a111111a111101011110021021221211122011111112221121a2101111011111101011111110111a1111011111111011110a01111111111111111110
1111111100111111111111111111111111111101a111011a111011011111110221120122121221111112112121a0110111101111111111101010110a1111101111011111111a11101111110110011011
1011111111011111101111010111101011110111a111001a111110111001102202122022102221120022122022b2100010011101111110111011010a1001111111111111111a11111111110111111111
1110011110011111110011111101110110111101a011111a111101000101101112022221222212022112100211a0101110111111111111010001111a1011001011111101110a11111111011000111110
0111111111111011111101001101111111111110a010111a111101110011112101120221220111020121202212a0111110011101011110101110111a1111111111111111101a11111111111101010111
1011111111011111111111101111111110111101a101111a100111111010001212112102022111212202110221a2111110101111110101111011010a1010111101101111101a11111111111010111111
0110011111111011011011111111110111111111a111111a101011111111122011112112121022212202020102b2001111001001011111101111001a1011101100101111111a11101111111011111011
1111101011100011111110101101111111111001a111111a000111011111010010211202011222221102202222a2111111011111111111111011111a0110011111111111111a11111111111101100111
1111011111101101111111111111111110111110a111111a111011011111101020211201122221100022210012a1111011111111111111111111101a1111111111111110111a11011111111000011110
1110110111111110101111111111111111110111a101111a111111001111111111221200220121222221110111a2111111111011011011001111111a1111111111111110111a01110111110011101110
1110101011011111111010101111100111111010a101101a111110110110122222211021011112221111112221b1111111101011111011111110011a1111101010100111111a10111101111111111111
1101000111111111111111111110111111111111a111011a111111111011120100002221111101221200221221b2110110111111111111101111111a1111111110111101111a10111110111001111111
0110111110110111101111001101111111111101a111111a011111111111021211222111000202211121211222b1101111111011111111111111111a1111111111111111111a11110111101111111011
1001101111110111010111111101111111110111a111101a111111111111111111212220010212102122221122b2111111110111111001101101011a1011111110101101101a11101110111111111011
1111111111111101111011110111111111100111a111011a100111111110112222100102110221101221121221a1111011111011111101111111100a1110111010110111111a11111101101011111011
0110101111111111110111110111111111111111a101110a101111110111122110222020011222201011121110a2111001111111111010110111111a1101101111011111111a11110001110111111111
1111010111101011111111101101110111111110a111111a111111111101122221100021012222101020010212a2101111111111110111111011111a0101111110111010111a11011111111111111111
0101011011111111111011111101111111011111a010110a001011111111121120021221110002120011120121b2110011111111011111100111101a1101111011111110111a11111111111101110111
1101110111111111011101011111111100101110a111101a101111111111001211121101202211211211112111b1111111110101110111111110011a1111111111111111111a10101111110111111111
0110111101011011011010110110111111111011a111101a001111110111122222112210221221011012011120b1110101111011111110111111111a1111111101111111111a11111111111111110100
0110001111111011111111101011111111111011a111111a011110110111111112221112111122211112120121a2111111011111011011111111111a1010011111011110111a11011101111111110011
1011111111111111111111110011111100101101a111101a101111111101112111111101111222101222121222a1111011011111111110010111111a1110111111101111111a11011111110011111111
0110010101111111111110111111011111111111a110110a101101111111011111110011111011110101102102a1121111222021210121012101101a1111011111111111111a11111111111010100101
1111011111111111111011101011111011111011a010111a110111100101111111011111001111111120111211b1112101112112111011122110011a1110011111111110111a11111011011101111111
1101011101111111001111001111111110111111a101011a011101101011101111111100111111010122102212a1122111100210211112221110111a1111001111011111101a11101111001010110100
0111111111101111110011111111111110111100a011111a111111111110111110111111111111011111201221a2122202101122101110212001110a1110011111101111111a11101101111111111110
1111111110111110101111100011011111111011a111111a111111111111111001110101110111111111122121b2021212211102112101201110111a0110111111111111111aaaaaaaaaaaaaaaaaaaaa
1100111111110001111001111111111111010110a111001a111111111101111111111111111101000121112101b0112221121110112101102111100a1111111111011010110101100111111111011011
1011001110011111111111111110101011111110a110111a111110110111111110110111111101111121212122b2112212222010101210200011111a1111111111111111111111110111111011111111
1111111111111011111011111111011110111101a111101a111001111111110011111110011111110111211222a0110111022012022120110010011a0110111111111111110011110101111111110111
1111111111001111111111111100111101111110a111111a110111111110111011110110111111111112110111b1111102210221221102111111111a1111111111101101110011101110101111100110
1111101111111111011111111110110111100001a111111a101111111111111111111110111111111112201111b2111110221221011211010110110a1101110001111111101011101111111111111001
1101111111011111101111111111011111011101a111111a111111111111111111101111100111111112211212a2122021022112112021201111101a1111111111111111110111111101111111111111
aaaaaaaaaaaaaaaaaaaaaaaaaaaaaaaaaaaaaaaaa111001a111110111111001110111110111111110112111111b1112222111211102212010111110a1011011011111111111011111100011011111110
11111111011011011110001111111110111111011101101a111111111111101111110101111111011111121020b2122212121220201122121111111a1111011111111111111111101011111101111111
10011011111111111111011111110101101101101111111a101110111011110111011110101111111120220202a2121211111002100122122011111a0110111111111001101101111111111111111111
01101110011111101011100111111101101111111011011a101010011111101110100111011011101111120012b0012210221202121022101101111a1101111110111110110110101111011110111111
11011111111001111111110111101111111111111111111a101111110111111011111001111101011122221121a0101020112112122101021100111a1011011111111111111111111111111101111111
11111110101111111111111011011111111101110111111a111101111111111111111111111111111111111212a1112111201002022222222110111a1100101111111110011101111011111011111011
01111111111110111011001000111111111111111010111a111101111111111111110111010101101100211011a2211112112112022112120001100a1011110110111111111111111101111111111111
11111110001101111110011111101011010111111100101a110111111110101111011111101001110111012110a1202022111110212021012100111a1101111111101111111111111111111101110111
11111111111110011011111110110111111101111111110a101111111111111111011111011111110012120212a2221021121111212212011111101a1110110011111111111111110111101111111110
11101111111111010111111001101011111101111111111a111111011111111111111110111111111121100211b2110112211211120101200100111a1101100110011100111001011111111111001101
01111110010111110111111110111011101110111111111a101011111111010111111111111101011121122111b1112111220211202012101100111a0001001111110111110110110111010111101111
11101111111111111001111110101111111111110110111a110111111111111101111010111010100011211121a1202211002121122121201000111a1101101100111011110111001111111111001101
11101010110111011111111001111111110110111111101a001000111111111111111111110101011012221121b1012222120211111101102111010a1111111011111111111000111111111101011001
01111101111111111001111011011111111111101101101a111011101110111111100101011111111011102000a2120221201101221200222111111a1110110111011110110101111101111111111110
11111110101111010110111011101011101011111111111a111111110111111111001011101111010102222022b2120122102121220122211110111a1001111111011111111111111101111111110111
11101111111011111011110111101011110111111111010a101111111111001110100111100111011122121112a1102012112102201121221111011a1001011111101111111111111111111100101100
11110011110010111011111111111111111111001110111a111110101111101011111101111111101111221210a0111221210002211101202011110a1010111111111111111111101011011111111011
10111110011111111111101111101111111011111010100a101011110111111011111110110110111112111021b2211212122222121120121011011a0101010111111110101000111111111110111111
11111111111011111110111110111111011011110111111a101111111100111011111101101111111121101122a1201021120111211211221111111a0010111110111111111110111111111011111111
10101101100110111111111111111111101111111111111a111011111111101010101110111111110100221111a2211112011121210201211011111a1111111111010101110111010100101110111011
11110101111011011111111111111111110111111010001a001111111101111110011111110111111101111111a1111100110111111111111111011a1111111111110111111010111011111111101111
11111101111111110111111111101111110111111111110a111101011110111101111011111011111111111111a1111111101101111011101110111a1111001101110111110111111011111111111011
01011110101011101101101100101111111111111111011a011111110111111011011110111111111111111011a0110111011111111111001110111a1111111011101111111111011011111110101111
11011111110111111100111101101111100101111111011a111111101111111110110111110111111111111101a1110111011111111011111010111a1111111111111111011111111101111111111110
11001111111111111100111111111110010111011001011a101110011101110011111111111101111111011110a1011111111111110111011011111a1101111011110111110111111111111011111110
10101111101110101110100011111111101101111111111a110110111111111111111111101111111111111011a1111111011110111111010101111a0101111011001100111111101111101111111010
11111111111111111111101111111111011101011000111a111111110111111101011111111010111101111110a1111011111111011111110110011a1111111111111011111101111110111001111110
