9 77
148 5
118 42
15 7
76 66
86 2
64 26
50 31
133 26
97 97

12201110002100222012110021112211110111110111111100111111111101a1110101122021222121201100220200011210021111010111111011110110110101010111110110101110101111111111
21112122212101210221212102211211011111011010011111011111111011a1010110112210111120212001220122022122210111011011111001111110111111111101101111101011001100101110
21222221022211212121011111212210111100110110110110111110110011a0111111102121021211211100112212002211010000101111111111110111110011111111011101111111111110111111
10022021202111112021221112122010011110111011101101111110111010a1111111112112101121222221221002221212110111111111111111101111111101111111111011001111111101011011
12202011121111112210110121012121111111111101111111111111111111a1110111111021122011202120112110112122210111111111111111011111110110111111111011110011111111111101
11200121012111111111202120211011110001110111110111111010110111a1110111120122201211020222120121220110220111011011011111101111111111101011111111101011111011111011
21021212022020122011121101112021110001000111101110100111110101a1101110100200121121012022222122122021111111100111111011111111111111111111010001111111111111111101
22111210022101000221102211222120111111011011101111101111110110a1011111121000210101011122221112122012221011111111111101111011111111110111101111101110011111111011
22221020122110112220121212222101011111001010111111011111111111a1111111012212022201012120112122112212011110011111111011111101010100110001101111101010111111111111
12102020221211002022222111122111010101011111111111111111111111a1111011120210022112110211222112212112001101111101100111101110011100111111110101111101010111011111
12222112200211221121100120111121101111111111111100000111111101a1110111101211212022021211212120112120111011001111110110111000011111011001111111111111010111111111
22202121112201012021112221211121110011110111110111212212211021b2001222222221110112000201210221222210221111111111111111020111122221202212101212222111210111111111
21102100222212112221222221121111111111111110111101211111222201a1022210120010222202120222120010111221021111110111011111111212110211112122122112111211101101111111
20212012102101101122002100010010110001111111111111211220100220b1200220121212122021121221212111122101211011111111111111111000210021222212102122222122211110111111
12012102012011001201222001011211110110111111111111002211112220b1002100122212212201102212011222102201211100111111111110201202101211211102122100121210211111000011
02221021221101222021111102121211111110111011010110212101202211a2222100020122022220122112101022102201221111110110101111201122122001021212212122220220101111110111
22111001121121222221201111211121111211212122212220101020222122b1012122222212222221122012020111210120121111111101111111210202221220212012120022111112111111110110
11112010112122202121201012020201101112122101220222222022222202b0002221012222222021121211220202122202221111010101110101110102111022121211001212201101111111011111
02002111121110012212221101211101110121101122002210222112222021b2022111112112221111222012122210012202120111111011001111112221001120011122122210221212011011111111
11201222222111111022111101222211111101022112122101202020222020b2101212122202121110011120221110201121121011111111111111202021021122222212120112110211011111111111
1112210112122122212221baababaaaaaaaaaaaabaabbaaabbbbbbbababbbbb20221021020221221202012002111101222111011101011111111111112bbabababaababbaaabbaa10012100111110011
2121111112020121201020b222222121111210200221012201122000211212022011021221212222212120210212202210121211111111111111010121a2121102212001212122a00122011111011000
2111121101121012121222a222211210100112121222210010121012222222222122121122112200122222121112212112111110111110111111012112b2222222210102021012b11022011111111011
2111202021101210121121a221112010111012212101000121122011221222222211122002111112120021222202111210210111001111110111112201b0222012212022010222a21120211011011111
1211021021102112022121b002012221110212221221210100012222222222101001101022220222012122102122112122210211011111111111110212a1211102002221112111a01122211111110111
0111102122020101202211b020120201001111121111122221122202122202222220200122222222212012002221120221101201110101001111110202a1122021021212211112b21002101111101111
1200012212222122102202b021212101101101110212220211022222222222220201221222222220211011211020102110210110111111101111112021a0102210021110122011a22022111110011111
2101112222110102120221b211102021010211101112212221222222012222222222021212202022101111011012222101011111212200202002212122b2110020212212122112b21201210110111111
1212101221120110211121b120101220011201011001122001222202122222201110210222210012021001221120122101212211212122111122122212a2112202222222111111a11221001010011101
0102111020220221112222b112201211101111012111121112222210222122010022001222222211221010122111120122010210101211000101002222b0201202021211111112b12122011111111111
0121220102112021212000b021120201111122121111111110120212212212212202121221212022211122212102221210202101001011212021102012a0102122222112221201a11222211110111111
1111100111011111011111a001101001011121112212022200222222222122010221110021212102111111111111111111011111121211211211012021a2111222220201122201b12212211111111111
1111111111111111111111a011111111111111201111222121020221201222202002102211212021110111111111111011101112211221122021121112b2212222222101011211a00202211111011111
1111111010111111111111a111111111011212221202012122022022020210100211110111121212111111111110011111011112022101101121122120b2110220102011211211b22201111110110111
1011011111101110111101a011111111010111111211202202221022220222212011112121010221101111111111111111111012021202221111222002b2101222222210201000a21102011111100110
1110111111111111101011a111111111101111222112222110222122212222022122212211210021011111110111111110010110221122122121101022b2022222212211220101b22101111111011110
0111011111101111101111a011111111110010222022121022221212222220222222210220112211111011111111011111011110221021011010012222b2221122022212112122a21112000111111111
1111101111111111111111a111011111111211002211112202121212012002200011202001001121111101101011111111111100122221121100011210b1222201201212210101a12111211111011100
1111101110111111111111a111111111000212220021102021212222000220120211120210101221101111111111101101011001002112211111012121a2012122002221122212a20010010101111011
1011111011111111111111a111110111011202110101212121202102100222122021201100012012111111011111111101111112101021111122222121b0012221021211102211b10111011101110001
0111111111111111111111aaaaaaaaaaaaaabbbabaaabaababababbbbbaabbbbbbbbabaaaaaaabbbaaaaaaaaaaaaaaaaaaaaaaaabbbababbbbbabbbabba0222202122122112212a20022211111011111
1101111110111111101111111111110111012222121101211000220212222112220211101211202211110111111101111111010202211001012101102012222121122222210121a20221111111111101
0111111111011111101111111111101111122212201122012122222211211111110111111111011111111111101101111010101010111022211021021122212021010111111111a10111110100111111
0001101111111110011100111111110011111222112110102022122121001102111001101110001111111111011011010110001222021222112202111121120222021211110111a11110101110101011
0101011110111101111111111111110111021221122012220022022122212121221111111011111111111111111111110111010211100211110122102110222100121011010101a11111111011111111
0111111111111110101111111011111111112121222012201212101102220201010001011111111011111100111111111111011122212111022120212222120211211111111110a11011111111111111
1111111111110111111101100011111111112222020212122021111020120120101101011101110111111010111011011111111111122201222111102221201101212211111111a11110101101111101
1111011111111111111101111011111101111101111110011100111111011101111110011111110101000111111111010111111201101111110122111022021201001211111111a11111110111110101
1110111110111011111101111011110111011111110111001111011111101111011101101111011111111111111111111111010102121012101112111200121021010111111111a11111110111110110
1111111111111100011100101111110011111111111110111110111111111111110110011111111101100001101101111111101111001012210211111202021122222001110111a11101111111111111
1111011111101101110011011111111111111011001011011111011011110111110111101011111111111111110111111110011222111122212121111111100222211211101111a11110011111011100
0111011110110111111100111111111111110101010111100111111111011122112220101011202121111010221111111101110202222102112222200221222102111210111111a11101011111100111
1111111110100110111111111111111111111111111101111111000101011111212212211112112012121212022211110111111021122210022121211212101211201111100111a11101111111111111
0111011111111111101111111011011111111011111111111011111011001210202112100120222111102211100101111110110212112212102002221110222111021211101100a01111101110100011
aaaaaaaaaaaaaaaaaaaaa1111111011111111111110110101111110101111120112211110110110021110120111211100111101121121222000210110221210111222111111111a10101111011111111
01111111000101011111a1111011111011101111111110111111111110011211222212102002111111021220101211110111111111122201220112221112112101202111011111a11000111111110111
01111110101001011110a1111111011111010111011011111101111111111121122011112222111221212200211001111111101212110201212111121011121211101211111011a11111111110111100
11110111111111011111a1011111110111110111100110111001001110110121021110110022222211202221111211101101111221010101212222121112111212121011111001a11111111111111111
11001000101111011111a1111011111111111111111111111111110111111221102021111111121021101121210210111011011101101101101010111111111111101111001111a01111111111101111
11111001111111111110a1111111111111111111011101111111011111011120221211221122110111111220111011111111111111111101110110110111111111111110110111a00010110101111111
11111110110101101111a1110110110111111110011111111101101110111001221112112201021021001101111211111111111101110111010011111111001001111111111111a11111111111110111
11101101111111001111a1111111001001110110101111110111111101011220110111121202122210202110012111011111110011111111111100100100111111101111111110a11111111110011111
11111111111111111110a0110111101110111101100111011110111111111002202220211110121212212122222011010011111111111011111110111011111111001110111111a11111111111111110
11011111110010111111a1001000011011111101111111111111001000011101101210122101110022212022120210111111111101001111111011111101111111111101101110a11111011111111001
11111111011100111011a1001111110111111101111110110101001101111212122221220012222121210221021211011110110110101101011111111111111111111111110111a11111111110101100
11110100111011111111a1111111111111011001111111111101011001111222022222011220011111222110112211100111110110111110011111111111111010111111011111a11111110101111101
11011101111110110111a1111111111011111101111111111111010111010200021102212011111020112101202011111010111111111111001110110111101111111111111111a11111011110000101
11111111111111011111a1110011111110111101111111101001111110110212020022121111221000222000120211111101111111111111111011011001101111011111111111a01111111111111111
11011011111111010011a1111101111100111011110110011111111000101002021100012111121211222201022101011101111111011111111100111011110110111110111001a11011011111110111
10110111110111111011a1111111101011111111101111111011111111111212221111020201112021221202121101111001111110011111110011111111111110111111001101a11111011101111011
11111101111111110110a0111111011011111111111001001111111111110212121121200222101012102112211211111010110111111111111101100111111101011110011111a11011111111111011
11111111111011001100a1001111111111111110101011101110111101010220212122111211121121121110112011111111110111101111111111110110110111111111111011a11111111111111011
11111111011110110110a1111101111100011111111111111110101111111122022112001202221111022021122210111111011011101011101110101111110111111111111111a11100111111101111
11111101111110111111a1111111110110011011011111111111101111101200111100101221122122102112222111111111101100011110010110110101111110101111011111a11111011111111111
01111011111111111111aaaaaaaaaaaaaaaaaaaaa01100111111111110111020112222211111221222102112122201011010010111100011111110010110011110111111111111a11111111111110100
1111101111111011110110011010010111111101a11110100110110111111211022121201210022102111121211111101101110111010111101011111111111110111111101110a11111111101111110
0101111111110110011111110110110111111111a11110110111111111111111011112221212202121110021102011110110101110111000110010111111111011101111101111a11111111100111001
1001011110101111110111110100111111001111a10010111110001111111011112221202011222210222111221201100101101111110101101111111111010010111011111110a11111110111111111
1111110111111111110101011011101011111101a00111111101111111011112211101220021221120121021210101100011111011110110111111101101011111111111100000a11110011111111111
1110111110110111111111101111001101111111a11111011110011111011111101121111221122112011220121111111101111011111111101111111111111101111111101011a11101011101111111
1111101011011110010111111101101100111111a11111111101111111111211112121010112202121221010212001110011011101110111111100111011110111111111011011a11011111101110110
1111111011111111110110111111111111111111a11111111111110111111220010112121012120112121111120211011011101110111110111101011011011111101111111111a11110110101111111
1111111111111011011011101011110100011111a11111101111111111111110010111111101011111212112120002221022121120201201201111111111110111111101111111a01111111111010110
1111111110111111101111111111111111011111a11011101111111111111111111111111110110111121012202202221022221112022121111110111011101111101101110111a11010011111110111
1111111010001111111111011110101111111101a11111010011111111111111111111111111111111022211122221112002202010212012011111110111110111111111100010a10101111111110001
1111111111111111110010111110111111111111a11111111111110111111101101100110111011111212112122222112110210221122111011111101010110111110011111100a11110111111011110
1110011101011011101011011111110110111111a01011111001010111111111011111101111110111221211202111222020210211201222211111101111111111101111111111a11111111111101111
1010111111111100101111101010011111110111a11111111111010110111110111111111111111111112122120212021122122210020100111001110011101111110011111010a11011111110111111
1110111101011111101111111010011111101111a11111011100111111111111111111111011111111021212121122210002212110010221011110111110011011111111111111a11111111001111111
1101110111101111101111111011111111111111a11110111110111011101010111111001111111111200010021121102002211122211211211111111011111101101111111011a10111111111110010
1010010101111110110101111111111111111011a01110111110111101111010111111011001110011101201122122121011222121202111111011111111001110111111001111a11011101111110111
1110111101000111011011111111010110111111a01111111101111111111111111010110111101111001100012212211121212222111100001101011011110111111101010111a11110110111111111
1111111111111111111000111011101111011000a01110110101111111111111111111110111101011121021212222220121211222221022110110111101110110111111111001a11111100110111110
1110111101111011111111111111011011111101a10111110111100111111011111111111110111111211011202111222212022012011002111111111111011111111010010101a11000111110010111
aaaaaaaaaaaaaaaaaaaaaaaaaaaaaaaaaaaaaaaaa11111111110011111011011101111111001110011201122102100212101022121202010111110111111111011110101000111a11100111111100100
aaaaaaaaaaaaaaaaaaaaaaaaaaaaaaaaaaaaaaaaaaaaaaaaaaaaaaaaaaaaaaaaaaaaaaaaaaaaaaaaaabbaaabbabaaabaaabbbbaabbabaababaaaaaaaaaaaaaaaaaaaaaaaaaaa00a11011011011111110
1111001001101011111110011101010101111111110101111111111111110110111111100101111111210122221122211222202022221110211011110001011101110111111a01a11111111111111011
10101110111101110111aaaaaaaaaaaaaaaaaaaaaaaaaaaaaaaaaaaaaaaaaaaaaaaaaaaaaaaaaaaaaaabbabbaabaaaabbbbbbababaaababbaaaaaaaaa111111111110111111a11a11110111111111111
11111101110111111011a111111111111111101111110111111110111111111111101111111111111111021111211221002112202220221011110111a111111101111111111a11a10101110110111010
11111111110110111011a111110111000011111111011110111111110111111111001101110111111112101122122122200122002122211220111111a110011110111111011a01a11101111111111111
00111101110011111101a101101101111111111111111111110111100100101111011111101010111021202011212101121102002011220201111111a111111111110111111a11aaaaaaaaaaaaaaaaaa
11111101011111111111a111010101011101011101111111111111111110011111101111111101110111112221222110011102122212022121110000a110111111111011111a11111011011111111101
11111111111111101011a110001111110110110001111111110111111101111111111111111101111121222101121020121112220102201211111011a011111111011101011a11011111110111111100
11111111111111111110a111100011000011111111110111110111111011111001111111101111110101222222012221122222220221020111011111a111111111101111111a00111111111111011101
11111111001111111111a111111111010110111111011111100111111111111111111111111111011122020212112201110111112201111221110111a111111111010110110a11010101111111111100
11111111101111101111a111001111111111111101111111100111111111110011111101111110111101121212112101102212121120120211011101a010110111111110101a11101110010001101110
11111111011110111110a111111010111111100101111110111111111110001101111110111111110120111112121120221011110221220211101111a111111111011111111a01111111001111101101
10101111111111111101a111011110111111111111110011011001101111111100111111010011111011111102211222212112112010211121011101a011111001111111111a11001111110011111011
01110001110011011000a111111111111111111111010111011001111111101110111111111101111112102112221111101212120212012201111011a011001011011010010a01011111111110111111
11010011111111101100a110110101110111111111111010111110110100111111111111010111111101120112000121111100221122221021111011a000011111011011111a11110011111010111111
11101111111111111010a101111111011100001101010111111111110111111111111111101110111110212111110112212221101112212201111111a111010011111111111a01110111010111111101
10111111110100111111a111101111010111111101111111111111011110111111111101111111111102111110022112220221202221122120111111a111111111100111111a11111111111011010101
11101111011111010001a111110011011111111101101111111001111111110111101101111111111112022020120010221112212112111121111111a111111010111101111a01011101110000111110
10111100110111111111a110111111111101111101111111111100100110111111111001101111011111111111111111100110011111111001111011a111011110111101111a11111111110011111111
11111001111111101111a011111111111111111011111111100100111110111111111101111011110111111111100110111111111111011110111101a011111111111111111a11110101011101111110
11111110111011110111a101110111110111110111101110001111111011011101111001111101010110111111110100111110111011001010111111a100111110111111110aaaaaaaaaaaaaaaaaaaaa
10111111110111011110a101111111111111110111101111001011111111111111111011111111011001011100111101110011111111110110111101a111010001010111111101111011110111110101
aaaaaaaaaaaaaaaaaaaaa111110111110111100100010111001001000111111111111111111110111001101111011111111110011111101111111110aaaaaaaaaaaaaaaaaaaaa0101111111100101100
11100111011111111011111111111011111111011010111100110111000101111110001101111110011111100101111111111011011101011011111111111111101111111011a1101010111111110001
11110011111110111011111111111010011001100110111011111111101101101011011111111111111110010011001011111111111111011111101111011110111110111111a0011101100100011111
