10 104
107 13
118 42
15 7
76 66
86 2
64 26
50 31
133 26
97 97

2110021221211212111121012122111111011111111111111101101111111111101111121201001112122212222201100121b21110101011111011111111111110111a1111a111111010111111111111
2202212211222122112112112111001111111101011011011110110111010011111110101220102222112221012020110222b01111111111111111001111101111110a1111a101111111111111111011
0122202001111121212221212200020111110111101111110100101111110111111011122012221112121200011120120212b21111011001111011110011011111111a1011a111111100111011101101
1121110112122111212212021212110101111101111011110111111111110110011111111212222202220211112200111012a11111101010101110110011110111110a1110a111111011101110111011
2112112112121101101111212011010111011111111111110111111011011111110011121111021222110111101220222121a11111011010111111011111111000111a0111a110111100111111110111
2111220002210110112011110110111111101111111101111111110111101001101111120011221112121111212200212221b21111011111111111111111111111111a1011a101111101110111011111
2200101102221212211021211122111111111111011111011011111011111111111110121121221102222110222120211102a11011100111111101111111011111100a1011a111111111101111101100
1101011121122122021022121212221101101111101101101101111111101101011110112010221112222000111111122112a21101101110100111110111111111111a0110a111111111101111101011
1221021112121012121210112111201101111111001110111011111110110011111110122211210121021211212121110211b01011111111011111111111111111110a1110a111111011111111001111
0202201211211011212110102022221110111111111111110111101111011111101111012211201022120212211120121122a11101111101111111101111110001110a1110a111111111111011011110
1212222022222100022102201222102111101101111111101111011110101111111111122010120221111022000222210212b11101111111111111111011110011111a1100a110111111100011101111
0120022112011101101002012102110101111101111110110101211202012111122210221220112212212012211221212211b10101111111111011110100022201202b2221b211011111211101111011
1222002212112010110222122112211111101010111111101012121222202111212222122221021221112020112221022221b11111011111111111111112221222012b1012b212122101211111001000
0110112212221122021211212220122111111100111111111002022222201122201002022012002221222221221222220021a111000P1011111011020022022222112b1112b111222122200111110101
0111112211221221201110212221201111111111011111101121120112001022120121222022222010120112102122212200bPPPPPP11110011101110121002112101a2001b120121120211111100101
0211220201222102222120122212120111101111111000110221022220112202101022122120222012211111012222122120P21111110111010111111020212112202a1122a111112022001110111111
2001210222202222102000011022212111010112111211211120022221110202022221112001022202101111102102211022P21111111111111101012102002112212b2112b121122221011111011101
1110220210112112221122021121221110111211201121012221202220222212021111222212022000112121202121112102P01011111111111110222211012101102b2222b112022122011111111111
1201221121200212120121021101121111111221221111120221121112122022122112102122222111102022112211212022P11101100111111111210021112212100a1120b020221111111111110011
1212010110121210200101212221010111101101220221121200010020122222220200022111112112222112121010111111P21111111111100111222011212121112a1211b212120012211111000111
2210222211112011120211222102121100121112221221122002100222212221222221122220112201000112110121021121P10111110011110111221220220010212a0120a211121121211101111111
2111120220122202022221222211212110011121222122121022021022212212222212222222202012221021221112221001P11100111111111100112222112021011b2221b212101110111010011111
1012111221111201110102211221220111122221121210202002222222222211202112212222220212212222212120110211P10111111111111010011112102210122a0001b121111211101011100111
1020210221120021220222021210212011111211211112121122222202011022021110212122100222211001221021022112P11011111110111100221112122011022b1220a022201211111111101011
0112211220122112212010111211001010112211021012021221212222222212221102111022221202102112221002222111P21111111001101111211122202222202a1220a120221211111111101110
1021110122012201010121012101111001121021120201211022222212202222222211121202212002120212010211020212P21000111111111110110222112111121a2121b012222201111011111111
bababbabbbbbbaabababbbbabbbbaabaaaababababbbbbaabbaaababbbabbabbbbbaabbbbbbbbbbbabbaabaaabPPPPPPPPPPa21110110111111011221101122101102b1110a200222202201111111110
122021010222221121100200201220211110111111001221220202222202222111102212221120122212111000P122222212111201112022210010222120121212221b2101b221022010101110111101
200222210102020110221122110102111000111122222221012220222222222202220222222212121101122202P111202112000200012122001122221211220221202a2010a221012011211011111011
11221212211200202122220222122211111212112122202222210222222222020012201222210212222012222P1011122000111001212211112111122222221022022b1222a211202221210111111011
10122211120210122220000211121201111222222220200122202020222221122220111212212021020211112P2200212200121112222211011012011120202102122b1002a112212222011010111001
1111010000111111011111111111011101122222222221112201200222222110220110211221111111111101P11111011111111121211211210211222212201212200b1201a020102212111111111011
1111010111111111111101011111001111121221120220111122022222211220022221211111111011111111P11100110110111222211101110202212012202222201a2211a102121111010011111111
1111001111101111110011100111100011121122120101121021022012010212121021101211221011111001P10011101111011221212111121212012121100122122b1202b112122121210111011111
0111011100111111111111100111101101022221221220101212221012212022121122221021212211111111P10111101111111211220220120222222120222212222a2211b222222102111111111111
1111011101100111101111111011010111101021112212211222200121202212221110012011012011011111P11111101111100122111202211102222222021221202b2112a222222002211110111011
1110011111111000111110111111001111002110102012201002120222222212102111110220210111110101P11111111111011111111001121122022122221202221b2020a021012222211011100111
1011101111111111100111111101111101122021121221101001221201222222222101122221202111111101P10111111111001111200121201112211222012002012b1001b012022201111110001101
1111001111111111111111101101111111122111101221200222022202201222111102200202010011111111P01111001101111121121220001112222211122022210a1110b102100202011111101010
1111100111111110110011101111111111aPPPPPPPPPPPPPPPPPPPPPPPPPPPPPPPPPPPPPPPPPPPPPPPPPPPPPaaaaaaaaaaaaaaaabbabaaabbaa012022220202222222b1111b011110010111111111111
1101111111101011110011111001111111P1122112202221020122222122202222121211212212201110111011111110111011102221022222b112012112222221222b1122a022200222001101110110
1011111111111111111111111111111111P2220000220002002020120022010202102120221222010101011111111111110111112112202201a022222222220222221b0102a022202221001101001001
1011111001110111111111110101111111P1222112112120212111210002122102101111111110111011001110111111111010011002221222a112111211022021111b1011a111111111111111011111
1001101101111111111111111011111101P2222222212111120111212022020111001111111101110011111101011011110010112022020220a210211222122010201b1011a011101101111111111110
1111111111111101101111101111110111P0221222111110100222101122200222011101011101111110111011100011011111100210101022a100020121122102102a0111a100011111111010101011
0111110111100100011111101111111110P0212221111222112122120221002212111111101001111101100111110111111011120022021211b022221222211111121b0101a111111111101111111111
1011111101110101111111111101111111P0212112212122221220111122222120011111111111111111111111101111011111022121011011a020112201110210221a1111a111111110110110111111
1100110101111111111111111010110111P1111111010110101110110110111111101011001010111000111110110111101111121112122111a012120212222100222a1001a001101101011100111001
0111111111101111011111111011111111P1111111111111011111111111111111111111101110100111101111111110111111101212221122b021210121121120121b1011a010111001110011111111
1111100011110111110110101011111111P1101111111111011111111101111111111111111111111111111011011111111111010010212111b211122122122022211a0111a111101011101111111111
1111111111111111111101101101101111P1111100001011101001101011001111101111111111111011111011110111011111022222121221b112101002221222111a1111a111010111111111111101
1111101011011111111111111111100111P1111011111011111011101111112111011220001112110102112112220111111111112012221222b012111222020011120b0111a111100111101101101110
1010110111101111110111111111110111P1111110111011010110011111012121212121012202002122202212121101110110120102011210b121111101101220221b1111a100111111111111111111
1111011111011001110011111100110111P1111111111000111111111110111201112122211212100110221111111011111111111022201000b211222022112111121a1111a110011110111111111010
1011111101111110011101001011010110P1110010101011101111100111101122122020211212222101111212221111111111112211101021b021121201210011120a1010a111111111101111110101
1011111111101101111000111111111111P1101110111011110111111111121122110022221212000110121110021111111111011212222122b200220221122200222a1110a111111111101111111001
0111111011011111011111111111111111P1101101111011111111111111001212112102112221210210011111111111011111122122121001b120201211112000221a1110a111111110111111011111
1011110111111111011111111111101111P1111101101111111110101111122212122220022011012122011112211111111111121222120122b221222202012211210b1110a011111111111101111111
0111110011111111111111011110111110P1101010111000011111111101112022021120221222211011110011111011111111110100111110a111110110011111111a1101a110111110111110101111
1011110101010010110110011111110101P1110111111101010001111001101022212022112220011121222112101101111011111111011001a001111111111111111a1010a111111010110101111111
1111011111000011001110111110101111P1110111111011111110111111120120121121120021000110211111121111111101111111011111a111111111111011100a1111a011111111110011111111
0111111111111011101111111101011001P0011111111111011111101110102221221222121111022221121220010111110011111111011111a111100111111111111a0111a010111001111111110101
1011101111111111111111111111111011P1101111011111001111110111122212111212211021220111102022201011110101111101111111a111001111100111101a1111a110111011101010011011
1111001110111110111101110110111111P1111101011111010101100111110111111201221012022012221120221111110111011011111001a010111011111110111a1011a111111010110111101100
1111101111111101111110111110011111P1111111110111101001111001100111211212101121021202212120210101101110111101111110a111111110110111011a1101a111111001101101110101
1111111111101111011011111111111110P0111111101111111111111111101210221222111120202102110011111111111011011110001011a111111101111011100a1111a111111111111111011111
0111111011011111111111101011111111P1001111101010111111111100120212021121220110022102202102111111111111111111111111a001101011111111011a1011a101111111111111011111
1011111110111100100111110110011101P1111100110111110110111110112122102111011121111011112121111011111111111111011111a110111101111011111a1011a111111111010110111111
1111110101111101011111111111101111P1111011110110011110100010012012201121220212120201201102201110011111111101110011a101111111011110111a1011a111111101101110111110
1011111011011110111101111001111111P1111111110101111011011111121111220122212101021112211221021111011001101110101111a111110110111011111a1101a111111111101111011111
1101111111001110110111111111111000P1111101111110011101101110122011201121021020201210011121211101111111111101101111a111011111111101101a1111a101111101111110100111
1011111110111011011111101111111111P1101111111110011101111010111221220112102201210211211211121110111111111111011111a011111110111101011a1110a101111101111111111111
1011111111111110111110101111010111P1111111111111110110111111122102222001202122211121212201111111101111111111111010a111110111111111111a1111a111111111111110111111
1110111011111100111111111101111111P1111011100011101111111000102121222121021211221010111120121111100101011011111110a001011010111001001a1011a011111110011010111010
1011101011011100111111111111110101P1111111111001101011011101111202112100102212112221221121121110101111111011101111a111011111110110111a1110a111011111111111100011
1110111100111001111111111111111110P1101111101111111111011101121221101121201202122221210121201001110111111000111111a111111100110111011a0111a011111011111101111100
1111110101110111010111100111101111P1111010110101011011011111112221010110111010121102021012121111111011010111010111a111111111111110011a1111a111111111011110001011
0111100101011100011110111101110110P1111110111111111111011111110011212022112121010102112121121111111100111111110111a111101111101111011a1111a111101011110111111111
1111111111111111101111011111111011P1001111011011111011111111120222211101022222010121122221201110111011110111111111a110001111111111101a1101a111011111110111011111
1101111111111111110110100011110111P1101111010111111111101101121112222122221010121211212010111101011111111110111101a111101111011111111a1111a111111111111011001111
1011101111011110111111111111111111P1100011111111110101011010121122112222012202212211212111110111111111100111111111a011101111011111001a1111a101011111111110111101
1111111111111111011110111111111111P1111011011110111110110100011022021220212022222210111111211111110101011001011010a111111110011111101a1111a011011011111111110001
0111011010101011111111111111111111P1111111111111111111011101111111111011111111101121121202102112120122111221001211a111111011111101111a1111a111111111111011111111
1111111111111100111111010010111111P1101010111011111111001111111111110111001111011121001122200111120111112121011211a101110100011101111a1111a111111111110111111111
1111101110101111111101111111101111P1110111110111110111101111010111111011111110111112210021211110111021011022210210a110101100111110111a0001a111011011111001010101
1111011011110111111011111110111111P1011101101110111111111111100111111110010111111022210222011212111220210102012101a011011101111111110a1010a111001011110101011111
1010110011111111011111100101111111P1111011111011111111011111011111101101101110111111211210002201111222001111102111a111111111100101110a1101a111110101011111100101
1111111111101111001101001111101101P1111111111100101110111111011111101101111111111120100212112021221022221120121201a100100111111111111a1111a111111110011011111111
1111111111110011111111101010111111P1011101101011111011111111010111110011111110111111212121112201122112012022102221a111111111110110111a1111a011111110111011101111
1111111111111100010111011111111111P1111111011110100010011111111110111111100111110100222022112202211102120202111101a000011001101111111a1111a111101001110110011111
1111111011011111101111111110111110P1111101111111101101111011111111001111111110011100121222102112220021202121120021a011011111101101111a0111a111111101111100100111
1101011110110111111111111111101110P0111111001111101011011111111111111110111110101111221212120100222010121211222101a101111110101011111a1011a111111010011011101111
0100111101111111111111111101111111P1111111111111111011110101111111110011111111110120021120020222011122012120221211a111011111111110111a1011a111111101111110111001
1110011111111111111111111101111011P1010101101110111100110111011101111101111011111121211221121121021212121200121211a101110010011111100a0001a111101101110110011011
0100111111010111111111110111111101P1010110111110111111110111101110101101011111100110222200122221012211221121211120a111101111011111110a1111a111111111111111111110
1111111011101111101111111111011111P1111111100001111011111011111101101101111111101100121110122002111111112122012221a101111110001111111a1110a111111010111110111011
1111101011111111011101101111111111P1111111101100111111001111110010111111111010111120222120001102110012121112212121a111111110110011001a1111a111111111111101111111
1010111101101111111110111111111111P1111101011010111010111111011101101111111111111021201010101121222021212112112210a111110001011111101a1111a110110011111111011111
1111111110111111111011110110111011P1111111101111011001110111111111111111111111111111021111122122111201111122211211a101110111011111111a1111a101111110000110111111
0111011111111111111110111111111111P0111011001111111011101111001010001011101010001100111110201110112112100120021101a111101111101111111a1111a111101011101011111111
0111011111011101111111111111011111P0010111101101101111111001111111110111111110111111211210111020220111021101221221a100101101111111111a1110a111101011011011011111
1111111001111011110111111PPPPPPPPPa1111110101100111111111111101111111111110111101121211221121121211021202111112111a111111111101101110a1111a101110101111111101111
11111111111110010101111PP001111111a0110111111111111111111101111111100111011101111011121222122122121222221110010121a111001111111110101a1011a111011111111100111111
1111101001111101011PPPP00110010110a1111110111101001111101101111110111011111110110110111121202110102222211112112211a111111101011111110a1011a111111110111011000111
1111111111PPPPPPPPP011110110001111a0111111010011111111000111110111111111111111100111002022220111201211221122211211a111111111110101111a0111a010111011111111111111
1111111110110111111111110101111101a1101101111111111111111111110010011111111110011011010111000211222110011112101021a110111110111110111a1100a011101111111111100111
1111110111111110110111111111111111a1111110101111010111111111110110111111110101111121012211222102022210211022220211a110111111111111100a1111a101011111111110111010
1111111111111111111111111111111111a1111111110111111111100101111111101101111101011120212011121101220212022010220221a101101101111111111a1101a101111111111111111011
1111011011110110110001111110111011a0000101101011011111111011110100111111110111101022220122220201001102112122111121a110110111111101111a1111a110101100001111011111
1100110110101111111111111111101111a1111111011110110001011100010111111100111110111110112210101222221221102112222221a100111111110110111a1111a111111111111011101111
1111101111101111111111111111011111a1101100011011001111110111011001111111001111111121212202202222121211110221222021a111111111101111111a1111a101111111111001111110
0111111011101011100111110011111011a1111110111100111110101111111011001100010111001121011111212202201011120202110211a101111101111111111a0010a111111111101011101011
1111110010011111110111111111111111a1011011111111111101111111111111111110010111111122222120112112101211012212222221a111111100101111101a0110a111111111111100111010
0101111111000111111111111111101101a0111111100001111111111110111101111111101100111111101110110101111111111110111110a111111111101011010a0101a111110111111111101011
1111111111111111011111111111011111a1111111111100011111011111111100111011111111111111011111101111011110111111111010a110101111111111111a0111a011111011110111111111
1111011101111111110111111111111100a1110101111111111110111111010111110110111111101111110101111011101011110011111111a111110111111011100a1011a101111110011111111111
1110111111100111011111011111101111a1111011011011011111111111111111011101111101100101001011110111011100111101111001a111111011011111111a1111a101100111101111111111
1111011110111110110111111011101101a1111111111111101111111111111111111011111011011111001111100111111111111011111101a110111101011101011a1111a111111111111111111111
1110110111111111101111101101111110a1110101110101010010111011110111100101111111101011011010111111111111110101111111a100101110100111101a1111a111111011111111111011
1010111111111111111111111011010110a1111011111101111111111110110111110111100111111111011101111111011110111110111011a111011110111101111a0111a111110011111111111111
