66 100
26 8
118 42
15 7
76 66
86 2
64 26
50 31
133 26
97 97

202212220122001111221210122211210111011110110110011011111110a011111111112120112020022200102220110001221110101111101111011100101101111111111111110101011011111011
012110221102102121210102120011211011011111101011111111111100a111011111021222120202112222111111221110111101101111111010001111111111111111111001111011110011111111
210121101012122222112222210120111110010101011011111111101111a111111111112021112101221220220112211110001111111111011110001011110110111111111111011110111111111111
222122220111222220222120102112211110111010010111111111111111a111010111110122112112211202212122001000120111011011101111010111111111111111111111111111111111111111
210112102111011111221210102221111110101111010111111011111111a101101111111110201222221211212110212112011011111101111101111101111011111010111101110111100111111111
212222220222111122211222012101111111111110111111101011111111a111111111122112201001010210211210210211201011111111101100101111111110111111111011111101000101101101
012100222221102210011122212222011101101011111101111011111111a111101111021110222212112020221122121121111011111110101011101101111011111011111111110101111111111111
220221201201111222222222221021201101111111101101011111101111a111011101021121021222111211120211112112101111001111101111110001111111111111111111111110111111110111
112012022112111221121212002212200000010101011010110111010110a111111111101012102020122102122122121210221011101111111111110111111110101111111111111111111101101110
101012101210101112002210002210200111111111110010111111111111a011100111100210211122112200120111212102221001111110110101111011101111111101111111111111011111101010
110122112000002021011221120210111111111110111001111111111011a111110111100100221222011112202121112211111011111011011011111111111110111111011111111111001111111111
121201221122222211020120221221211011011110101111012012112121b222220110102122222211121112222101121221221101111111111101112110212000222200200021012110201011001111
002121121211122211122010212221210111111111101111011102202222b101210221122221021211122120111022120202021111111111111111211121012201021012121220112010211111101111
121120121121210211121200120011211110111111110110110221111021b022012220200122220022210221002012110121111101111111111001011220221100122220210210001202210111111111
201020212121121011022220222002211111111111101110121101102211a111121110222202122211221121001111111212221011111110010110211201122101102021001120202111211111011110
211111122012122112110221111001111110101011001111100111121210b110101200222202020122022221112222220221111011111111100111111102221012210210012212202112211110011111
120021122012121122112112112212111110211002120121002120110211b222221220212110222010120222122211221011121111111111111101111111210212121111222112110011211111110011
202221212112222112111010101021011112221110211101222112222221a222122110021212212211021111122210112122111101101111011111202011211021021111222122201122111111110111
122202121022111020001120122022010112100110221112221222222022b211221111112021211210201222011120120010101111110111110111221220212102222101221100000022111111100101
111112221121020001120110012120210110211221022202022202220222b20102222211102bbbbbaaabaaaabaaabbaaababbbaaaaaaaaaaaaaaaabbababbbaababbaaababbbbbbabaabaaaaaaaaaaaa
220111202122222110121221211102211111122011102111022212202111b10021200111002b222222122111221122111212111111111010111111200012101022111212120212022122211011111111
101120111221022111121122222002100110101012221210222012020122b22222110120222a220220121110212210002221011111111111111111221110200221121112211111212121011101111111
010211202012102112110212211121110011212110220212202211122222a11212122212221a222210202112110120022211211101110001011111121101211001121101112222211211211111111011
022201121112101111201202121122110100211121001222222112022212b00222121002222b222221212201111101121120211101111101111001211000201002122221022122102120210111111111
212112222200021201220111221212011111111112122001201210100222b20222120210122b220111211221011101112221121111111011111111201221222220111020221200111011111010110111
211011122221122210012112222201211111121122222222112202222221b12220122201022b011122110222221111122100211111111010111111200122111221220211110112121011001111111111
111101211122022022222221111022011111122211122122212201100102b21022021222122a122011210012222102211112221101011011111111112011211221112212100200022002200111111111
020102122122211012020121112221111012012111220220212222022221b10002021112221b102011221101110121112221211201211222221112122222212222222122122111221110101011111111
122122010001210012121211120220210111221222022222112020122022b22112221120022b022210202200112202220201101222221122111220221212021011222221120202022122111111101111
112022120222122120010202212111211012111212012122122202012201b22000121111221b221212020112221212211112221100200122111201222220021222200210110210120001211111101111
120212022011122022111212211211011111022220221101122222112222b02222201222022b221220022212121221222120221102122221101122221212221221122210222221111011001111011101
111111111111111111110111111111011002112101210121121220002012b21222102212111a212211111111111111111111111221122102112210212010020011220121022121222021111111011101
101101001011111011000111011111000111020221212111110210021011a01212212122211a200111111110010111110101111122121021110101121022022222020222221012122112111111011111
111111111101110111101111110110111110021011220101200212122022a22112111120221a221211110110111111101111111102121221212201121222221221211212110102221021011111111110
011111111111111010111100111111011112212102021111220102012212b22022122202011a112011110110101110100110111112121221112101222122222222122212212202020221210010111111
011011111101111111111100111111100111122101122112122212002020b22110111121200a011211111110111000011111111012121221222220202222212222220221101102110012201011011111
111100101011111101101111111111010111201210221000112222222221b22220212110222b221211111111110111111111101201120100212121221021212120022200121102102112111111111101
101011111111111111111111110101111112112211211110120221222222a12200222112112b121211111111111011010111111002221211221120202202012012222200101120221011211011010111
010011111011110101001010110011011111121020112222201222221020a10201211211220a222211111111111101110110111122212220102220220002010212222211210012111110011110110111
111111101101010111101010111111100112222112222100022222122221b22210112212112a221100111111110101111111111012002120121112221121000221222201220212101211111111110110
101101111011111101001110100101111112202122112121102222200202b00202121110111a011001101111111100100011101211002220111000222202122022022011012220112122211101111111
111111111101111111100111111010110112122211221222022021212120b10210221111211a211211011010010101111111111100121220212120112220220021212222221011211220011101111110
101111111111100111101111110110111101120111021102002112220222b22111101111111a111111111111011110110101011122121112220212111222212221222001001011110111111110101111
101101111101010111111111111101101012211201221121110220201110b12121111101111a110011111111111111010011111212222000022022212112012121202011110111111111111111101111
aaaaaaaaaaaaaaaaaaaaaaaaaaaaaaaaaaababbbbbabaababbbaabbbbbbaa10010101111110a110111110111111111111011111111120011212212112202001022212201101111111101011001101111
110011111111110101111011111111011111200211112122221122100122110211011101111a110001101110101101111101101212121122222022011122110211121210111111111111111111011101
111101110010100101111111110110010112102212221112111112121220010021111111101a110111111110111110110011110221222220102211221220111210021011111011111101111111111101
011111101110111011111110100011111101111111111101110011101101011111111111110a111111110111101111011101111212202201212020201121012221122011101111011111111111011110
011101011101101111010111111101101001011111111011101111000011111111110010111a101110011111111111111111011222202010211221021010221012200111110011101011111111111111
011011011011010101110011110101111100111111010111111111110111111111101111110a111111110010100111111110111211122121200112022120222202211110110111101011001111111110
011110111111010111101101111111111100111110111111111110111101111111111111110a101001111011101111111111010221210120101001220222211211122011011111110111011101111111
100111111110111111101100111101011111110111111111101111111011121000211221112a111011112121222211111101100110201121010211022122212202110101100010111011111111111010
111001011111111111111111111111101111111110101101111111111101122120122212202b011022212222012211100111111202112122202022000012112211112110100111110111110111111101
111111111111111110110110111111101110101100111011101111011111102111212222022b211111121012222201001111111111111122122110222121021111222001111011100110011110111111
111111110101111010111101111101101111110100011111111111111111120202122102220b111222112220222111111101110211220112021101211122212212112200111011111001101111011011
011111111111111101111011111111001111110111110010111110011111022202121122211a221011022222111101111011110202212011012222111011120222212110001111111100001111111111
111011111011101111111011111111111110111111011110111111010110121202212222022b211001120112110010111111011102011121111111211211222202212101111111101100111111111011
111111111111111100111111111111101001110011111110011111110111121112122211202b121220102222002001111101111121211110222022101121002022111111001111111101101111111011
111110111111111111101111011111111111001111111100101110110111111101202221222b121211210222122101101111111001111110101111110111111111110111111011111110111101111111
101101010001101111011111101101011111111111110111111111101101110121212202202a222102102212012211111111111101111111110101111111111101111111011111101011011110111110
111110101111111011110111111111101111111001111111111111111111121120222120111b011212111011112101111111111111111111011101101011110111111111111111111111111111111111
101110111110111111111111111111111110101111111111101110111111122102211212010a001200221112201211110111110111111111000111100111111111110001110110011111011011111110
111011111111111101110111111111011110111110001101111101101111112111011002122a122212011020111111101111011111101111111101111111101111111110111101100111111011111111
111101111111011011111111101110011111111111010111101100101111111021202122012b111021222211100211100110011110101111111111111111110100110010111101011111111011110111
101110110111010101001111111111111101100101111101101101110111112220202002121a002222022202202011110011111101111111011111111001111111011111111111111111111110111111
011110011100101111001101111111111101111101101100110111110011121012112212122b221222202022011211011111111110111110110110111011011111111111111111010111011111011101
111111111111101111111011111111111111111111011111111111110010112121122111101b221022121102212201100111011111111011111111011110011110011111111101111111101111111111
011111101101111101110111111111111111110111010111111111111101110022012101212a202221101021111210110011110111111001111101111011110111011101111111111100111111001111
111111101001101101100001111011111110011111110101111011011111122122211222211b22212122222110110111110aaaaaaaaaaaaaaaaaaaaaaaaaaaaaaaaaaaaaaaaa01101110011011111110
101111110011111011011111111111110101111011111111111010010111101220221011221a12111202211222201101111a111111011111011111111011010011111111111a11101011111111111111
101111110111111110100001110111111111011110111111111100111111100220122120122a20102010120001211111111a111110110100111111101101111101110111111a11110001010111001111
111111000111111101011101111111011111011010111111111110011111111011111221122b02110220120002121111011a110111111111111101111011011111011111011a11111111111111111110
000111111100011111110111111111111100100111010011101111011111002121222201112b02220122220110111111101a010110110011100011111111011111011111100a11111111111111111111
110111110110111101111111111111111100101111110011111110000111111021211111121b21121222222122211111111a111001111111111101101111111111111110111a11111011111110111101
111111111110111101100101111111111101111111110101111111101011101111211111121b22012122122201210111110a111101011101110111111111111011111111111a11101101101100011101
111111110100100111111011111111111110110101111011111111111011102112110121111b22222220121011121111111a111111111110111101011011110101110110101a10001111111100001111
111111101111111111111110101110111111111111111110110001001111112211100211111a12111212222222201011101a111011111101011011001111101011111111111a01011000011111111111
111101101111111101100111101011100111111101110011111100110110021021121120122b21121212212001111111011a101011101110111111101111111101110111111a11110111111111111001
101111111111111111111111111101111111111111111111111011011010112221212222122b22111221121111221011111a101111111011111111110111101111111101111a00111011111101101100
011101111111111111101101111111111101111111111011111101111111122222112010101a11011001012211200111111a111111111111111111111111101001110111110a11111111111111011110
010110001111101101011111111111111111110001011011111111111011112220121011212b20222121211200211111111a111011111111101111101111111110111111111a11111101011111011110
011011111110111111111001101111011111001111011111011111111111111121210122002a12121101011222211111111a101111111011101101101111011011011110110a10110111111111101111
110010101111110110011111101011011111111111111111110111111111111111011111111a10111022112021112121212a112212011220110111111111111110111110111a01111111111110101110
111110011111100111111111111111110111110111110011111111101010111011111110011a10111011021121101220221b020221020201201111111111111110110110101a01111111111111111111
010101011101011111011111111110111011010110111110111111111111100110011111111a11111121112122102112101b111111211221210110010000111111011111111a10111111111111110101
110111011110111001011011111101111111111100111111111111111111111111001011111a11011121111212122122112b111021101102211011011111110111110010111a11011011111101111111
1111111111111111101111110111111111101011aaaaaaaaaaaaaaaaaaaaa11110111111110a11001112022012212222111b212211111110011111111111111011111111110a00101111111101011011
1001010011110011011111110111111111111011a1011111010001111111a10111101111111a11110121122220210222221a212122021222111111111111101111111111110a11011110101111110111
0011011100111001111100111111111111001111a1011111110111111111a11111111110111a10101110121210220112211b101210222210111010111011110111011111111aaaaaaaaaaaaaaaaaaaaa
1111111111110111111111011111111111101111a1111100111101111110a10111101010111a11101121221101021112122b111101111111211101011111110111101111100011111111101101111111
0100110010101110110111101101111111111111a0110111111111111111a11111111111111a11111100121002022100111b220020112012211110111111111101100101111001101111011111111111
1110111011110110111101110110111001111001a1111011111110011111a11110111011111a11110122111022101101111a011110110200111011111110111111011111111110111111010100110011
1110101111111101111111111111111111110101a0111111001111111111a11111111111010a00011001021211102102112b201112022012011111111111101110101111111110000111111111011101
0101110111111111011111111011111101111101a1111111101111111110a01111101111111a11011121110222221222021a212022100102200101111101111111111011111111111111011110111111
1111101111111101111101011110111111111111a0101101110111110111a10111111111111a11111122021121222110022a122222222102201110111101111111110111111111111101111111111111
1111101001010011110011111111100111111011a1101110011011111111a11101111111111a01111102011102211221012b212011111221211101111111111111101111110101111111101110111111
1111101111101011011111101110011111111100a1111111011111111011a11101010011011a11111022210211220022020a212202102111111010011111101111111111111111110101101111111111
1101101101010011110111110110111011111111a1111111011111111111a10001110111111a01110112202221111220122b211220112212211101101111111011110101111111001011111111110111
0110100111000110101101101111111110111011a1111101000101110001a01111111111110a11110112020111120111121b200222101212011111101011101011011110111111111110111110110110
1111100111110111011111111111101110111110a1100111110111111111a11110011111111aaaaaaabbabbbbbababbb222a212122221102111111111001011011110111111111110111100111111110
0111110111101111111100111111101011111111a1111110110011101111a1101110111111111101111122220221122b201b120212122002011101111111001110101010001110011111000110101110
1011011100101111111111101110100111111111a1110010110111101010a1111111111101101110102222001122112a201a221122211110101111011010011111111111111011110001100110101100
1111111111111001101100111100101111111100a1111101111110111111a1101111111111111111112221112222021a020a001202111021211111111111111111110111111110101111110001111101
0101111010001010110100111110011110111111a1111111101111101111a0111111011001111110112011211120120b212b121012102122111010011110011111111111011000111111111001111101
1111111111111111011111111100101010011111a1110111111001111111a1111111111110111111101110102121201b012b202211111211111110111111110111111110001000101111111111111111
1110111011110100110111111111111111111101a1111011111011101111a1111111111110010111111102001200221a202b001121210111211111111011111111111111011101011110011011111111
aaaaaaaaaaaaaaaaaaaaaaaaaaaaaaaaaaaaaaaaa1011111111111111010a1111111111111111100012201210111222a110b201121211022111111111101111111100011111101110010111011101100
111001111011011011111110111110110111111111111111111111111111a1011111011111111111102012211021221a201a122212022001110111110111011100111111110011111100111111011111
110011111101101111111111111111111110110111011111111111111111a1111011101111011111110212222002212b222a011211211222211100101011111011111111111111110111111100111111
111010110011100111111011111111110111011111100111100111111001a1110110111110111011111200111021102b010a102121002222210111101111010010111111111111101011111011110111
111101100110011111111111111111100110111101001111111111011101a0111010001011011111112102211112221b122a110221220220201111111111011111111001101110010111111111110111
101111111111110111101010110111011101101111111111111111111011a0111110111110101111111021122122220b020a011212001212011111111110111101110011111111111101110111111111
111111001001110111101000110111111011111110111110111011101110a0111111111111010111111221200212211b102a021111220122111011111111111111111101110001111010101111111110
111111111101111111101111001101011101111111111111111110111111a1101010101111011011001111011111111a111a110111111111111111111101111011110101111111111111100111111111
101111111111011011110111111111111001110011010111111111101101a1111111111101011111101110110110101a111a111100100011111111111101111010111111111110111111111110101111
101111111110111011011111101101111101011110011011111111111111a1111111111111101111111101101111111a111a011110111111010111111011010111101111111111111101111101111101
111111111110111111110111111011111111111011111111111110111101a1111111111111111110101110101111101a110a111111110111011111111011001111111111011011111110111110111111
111111111111111101110011101011110111111011101101110101110011a0111111111111101101011011111111111a110a110010101101111101010111111111110001111101010001111110110111
101010111111111101111111111011111111110101101111011111101110a0011010101111111111110111111111110a111a111111110011111011101111111111111110111111111110111110010101
111111011111101110111101011101101011111111000111011111111111a0011110111011011101111111111101111a110a101111111011101010000111111101111101101111111111101111111111
