94 1
50 104
118 42
15 7
76 66
86 2
64 26
50 31
133 26
97 97

2021121012201120212102111001220101111101111011111111111100111111111111011102021101212112221111021122111001101100011111111110101111110111100111111011110110101011
abaaaabbabbabaaaaabaaaabaababbaaaaaaaaaaaaaaaaaaaaaaaaaaaaaaaaaaaaaaaaababbabaaba2112120220211P21111101111010011110111011111111111111111101111111111111111111011
22102111220222121122121011112120101110111111110111101111111111111011110022202121a0220011012022P21210201111011110111101010011111001111111111111111111111111011001
21211211211110112111222120211111110011111111111110101111001111111100111011111102a122000220110P012022210111111011111111111111111111111111111010111111011110011111
10220222021022121012211101011111100111110011101010111111111111111001101210221210b222112200112P202101120011111001111111011111111111111011100110100111011101111111
01011112121212122011121201102120001011101111111111111111110111111111101121222200b111111002120P210021210111101111111010111111110011110101111011011111111111010011
12102111111120221112020110201121110011111111101010111111111111101111110011011111b0120122220100P22222121111011010100100111111111111111111111101111111010011111111
12222102222211200120022120011211110111111101111111111111111111111101111100212112a1212212212201P21211101111110111110111111110111010101111100101111101111111111111
10222222212022211201222120221110111111101101111111111111111111101011011212201221b12211201122220P0210221111111011111011111111111111011110111111100111101111111101
12220112021100222222111222011220111101111101101111011111100111111001111221100211a1222212222212P11001211111100011111101111011111111111101111111111100110111101011
20212220022102012121011111020111011111001111111001111111111111011011111222211122b110111022112P110112101111111111111111100111100111100001111011111011111111111111
02101200211121211220102101022021111101111111111012120112122212202212222222222021a10022210212P2010112111010111110110111201020120101200100112121112001211111111110
22122122111111122100121121121201010110111001101101221211201212212222211201012101a2120120012P02111112111110010110111111101202122021201111111022201110111111111000
12211102010220001212211102102201111111111111111011120110222211121210022211112222b011221121P012111201220111110111110011122110212011211011122111110122210111101111
12021121022122110211220201211111111111111111110112211212121011220111122021221221b11102210P1122021111111011110111111111212220201201121111102200022120011111111111
22221121201111021212221111011121111111111100001012022221210121212022122212212222b22112211P2101211221221011011110111110001121112112210120112111111022001110100111
21221100112001212102221121112121111021021101121212222002120220222211022222221020b2111120P01212211022220111110000110101112110102112122211211101022111001011110111
02210222112112222220202111112200110121111021212212110020220120001222122122111120b222222P211221012221221011110111111011121221112112021110211112110112110111001110
02201100210212122121121002220120111211200212102022222220022011222222212222110220b221111P020211101221001111111011110111211101111222012211101221212222200101101110
21001222112121012121112212121120111212220200210222202222022022020222101212222120a121022P212112212021021111111111111111120120001111112122111101002011211111011011
12122112112121012011121120120101111201010121212202220222202220222102222120222221a101111P021222122002221111111011111111101201222102111211211122211122011111001101
02120120110202101200111012212121110222021012112122200222222022022202012202202022baabaPPbabababbbabbbbaaaaaaaaaaaaaaaaaabbbbbbaaaabaababbaaaaabaabbbbbaaaaaaaaaaa
201101010012121210010222210010210112212112121011122201200201222220112222210022222201P201112212200021021111110111110110111002210221212101112222112122111011110110
22010110122111211220022112211121101112120001220210101222022222222110211210221012000P0122021200221210101111101111111110211111200100121110221012212212011110111001
2211122212212222121212121220021011010212122021122222122212212122221112210210222000P22010012222020122101111111111011111222212112000111202202110001021110011101111
2212111110111121112011212121122011102122211211212211222202211221122121221012001221P22110122202221100101111011110010111221111010222021021011112210112111011111111
1212210020011221202112212121211011111011222020220222222212222121021111212220221202P20210121211001201121111011111111001222211121102002121122122211121100110001111
120002121111211110022111110122211111011122100101010201221222202022211222001012221P221001221022120211101102112112001212212222202201221222210112122211001110101111
aaaaabbbbbaaababbbbbbbabbbaaabaaaaaaababbbababbbbbbbbbabbbbab202022201121222122010P10112221211121220211110112220012122121201221222122110222210222221111011111101
012211021212121101101222212220111010111001111012212122121220a222202222122112102122P21112111121222221220001220212010222121122202222221221101212122002211110010111
211220122220121110122111121000111101120121200111122212222200a2122200111202020202020P2101111110211220211122111012210212220102221222211102201111121122111110111111
111111101111111111000111010110111111111110012210010221222212b220022220212101011211P01111111101111010111111220211202112222202022122220212100211211201201011111111
111111111110111111110111011111101101020112122021122222201201b22222101121222112011P011111010111010111111110222022120121012121101011212222220112012221211111111111
111111111001011111111111111111001111100211210211111120200022b2211222211122221011P1111111111101111111101022012120111210222022202222002022211012111111210111111110
111101111111101111011110001111101112000111012220122202201222b2221121211011022210P1101111010101010111110112021222120212201211211222222202022011111210111110111111
111010111111111111111110111110111112211022211211220122222220b221221001021022211P11110011111100011111110212122211122121002022001021021222012112211211111111110101
110111111101111110110111111111101112122212020112110212022121b02022012210122022P010111111101110111111111221211211120112122112212201222212012221021102101111101111
111101110101111111111111111101101011212221222211122212022222b12000122011011211P111011111110110111111111022212202222121222202012022212222122202022220111111111011
111111111111101111111101111111111110211002201111022222222222b12101022102200010P101111101011011111011110112001121111221122022222212022212221221211121200111101011
aaaaaaaa0110111110111110111111111112222111012112112212221020b1222201210200102P2110100111011011101011111212210210121212220200021022021201122112202221201110101101
1011101a1111101111001111111111111100122122120112222222102210b020121012110212P12211111011110101111011110202012112211222220111222022122000020120211100110100100111
1111111a1111011111111110111100101112101201202110120202120211b22012012112020P021101111111011111111101111122022110121020122212222211012201121002120121111110111010
1111011a1101011101111011111111101112211012201212102211001211b21101111011110P110111111101110111101111111221122120211211210212020222001111111111111111111001110111
1111110a1001111111111111111101100111121201011121202102000120b0122011111110P1001001011011011111010111001212110012122100212212110120121201111111111110111011010110
0011111a0011111011011101111100111112012210222001112010122020b111221111111P11111011111111111010101100101222212220122212210202111012122211111101111011111111111110
1111001a1101111011001111101011011100012121222210112022212121a02121001101P011010111101111111111101101111202221212221122222101011212211010111111101010111001111110
1111111a1111111101011111101101101111111201122121212120222121b11121111110P111110111110110111110011100111222102121111110122221221010021211101111101111111111101110
1111101a1111011111101111111110111110111111010111110101011010a1011110111P0111111101111111011011101111111212221222102001212210011011200010101111101111111111101111
1111111a1111111101011111111011111110110101100111011111111111aaaaPPPPPPPaaaaaaaaaaaaaaaaaaaaaaaaaaaaaa102220220202011120220121211010100111111aaaaaaaaaaaaaaaaaaaa
1111001a1101111110100011111111001110110111111101111101011111100P100111111100011011011111111101111101a111121021222111112000211212012211101011a1001111010111111011
1111111a111111011111101101110101111111101111111110111001001101P1101111111011101101111001110011110101a110222101222210121022121021111210101110a1110110001010111111
1101100a11111110111001110111111111111111101111111111110111101P22102122000201210202021111122101111111a112111111112222111212110111111110011111a1001111111000110110
1111101a1111101111111010111101111111111111101100111111101111P212211120022211112221122111022101101011a111000222111010222221112220021212111111a1111011111110001111
1111101a111111111111110011110100111111111111000111111111111P0020112202122021212211222220221101111111a011222111220022020012212222021222101111a1011110111110011010
1111111a11111110111111111011101111111110011111110101111110P11211001111011212022112101112212211101011a110200212122012220111211112212200010111a1111111111111111111
1111101a0111111110111111000111111111111110111110100111111P111110122012211112211200020011221211111111a112022122020011220212121221011222110011a1111111111110110011
1111101a111111111111111111111111111111011101110111110111P1111102121122111111210112212222221010101111a111111100012000222120201112121211111111a1111111111111111111
1000101a111111110001011111101111111111111111111111111110P0111111101021111111010002222112110210111011a011111121012012121012121220202111111001a1111010011001111011
1001111a01110001111111111110111111111111111110111101000P10111212102211211002212112221112120211001110a011010101111110111001111111111111111011a1110111110010110110
1011101aaaaaaaaaaaaaaaaaaaaaaaaaaaaaaaaaaaaaaaaaaaaaaaPaaaaaababaabb21012221211202212222210000111111a100100101111111101111111111111011110011a1111110111010111111
1111111111110111011101111111111111111011011111111111111P11111021212b22212120221101000100210011111111a110001111111111111101110110111111101101a1111111100101110111
1111011111110101111110000101111111111101111111110110111P11111211122b01222101011211122212011010111111a111111011111111011111011111011110111111a1111111011111010111
1101111111010011111110111111101101111111110111111101010P11101022222b12011012012112212120211211010110a011111110111111110111111111111111110101a1111111111111110111
0111111111100111101111111111110111100011111111111111110P11011220111a11221111122120102021121211111100a110111111110101110010111101111111110111a1111111111101111111
1101001001111111111111111100111111001011111011011110111P10101021202b12110200222200211221111111111010a111111011110111101101111110110100111111a1110111100111111111
1110110111011101011111011101111110111111111111111101111P11101202122a00112121201121010012112111111111a111101111110111011011011101111101011110a1011011111111011010
1111111111111111111111110111001111001111111111111011111P11111012110b11211012010020122221121211111111a111111101111101111111111111011111011101a1101111111110101111
1101111111111011111111111111100010111111111111111111111P01111022222b11112010021212212220122211110110a111011011101101110001101011101101111110a1110010111001111101
1110101111111111111111111011011111111111101111110101011P01001020101a22211202211021212111102111111111aaaaaaaaaaaaaaaaaaaaaaaaaaaaaaaaaaaaaaaaa0111111011111111011
0011111110111101010110111011111111110111111110011111101P11111202211b00212020121101120212211001101111001011011101011111111010110111111101111101111011011111101001
0111111111011110111111110111011001111111110011111111110P11111112120b12210121122102211202002000110000111111111111110110111111101110010111111000111101111110101111
1111111111011110110110011110011011111111111110011101101P11010222222b10122222112102211021220211111111101110111001110110011110111100111111011111001111011111010111
0101111111111111111111111111101011111111110111111111110P11110122001a11010012212211111221221101110111111111000111111101101111110111111001011111111111111111011111
1110111101111111101100011011111011101101101111111110101P11111102110a12222021210121211221122201111110110111011101110111111011111111111111110111101011111111001111
1111111110111111111110111011110111111111011101111101010P10110102021b22100110111212212012111211010111101111010111011110111101110111011111111111110111111111111110
011111011111011111111111101100111101111111110110001111P111101210101a10211222020201111102101110111111101101011111101111111111111111101111011101111110111011111010
111111111111100111101101111101111101110001011101110011P110110121222b12212211202101222202222111111111111010111011111111111101110111100111011011111111111110011111
111011011110101111111110111110001111010011111111111111P111101112111b11021210222222222021000111101010111111110011110111111110111101110111111111111111111101100111
111011111110111111101111011011111111111111101101111111P111110200012b00110220211101221112211111101001011110010111111100111110111100010111111110110111111110111111
11111111111111111100111aaaaaaaaaaaaaaaaaaaaa1111011111P110111222101b22110101111101020221111011011111111110111000111001011111111111011101111111010101001111111111
11111101111110101110101a1111111011011111100a1110000110P111111011121b10222122121220122022221201011111011111111111110110110110000100111111111110010011111111111001
01111011111011111101100a1110111111001110101a011111110P1111111111220a11111111121122221221122211111111011111111011111110110111101011100101011010110110011111110101
01111001111011001111011a1111111001111111111a01111111P11111111111101a11101111100111221022202111122012221201011121201110011110111101110100110110110110111001111110
11110111111111110101111a1111111101111111101a11010111P00111110001111a01000111110111122111112221110122121202012102011111001110110111101101011111110111111111111111
01101110110111101101101a1101101011100111101a01100001P11011111011101a01111011111111221022210122122112020100101111010101101111111101111111001111111111111111110111
11101111011111111111111a1111111101111110110a11011110P11111111111011a01111011111011000222222212102202221020122211011111101110111111111110111101110111111111101111
11111111011110101111111a1011111100101101011a1001110P110011111111011a11011111101111112121001221121210001111122000101111111111111010111101111110011111110111110010
11111011111011111111111a0111100111111111101a111011P1110111100111111a01111110110011101112121021210212201122110002111101101110110111111110111111101111111111111011
01101111111000011101110a1011110101011110001a011111P1110111110111101a11111001111111011220111221212110222011101111011111111110111010111111111111111110101110010110
10010111001111011110111a1111111010111101111a111011P1011111100101110a11111111111110112121021012122201212020222221210111111111111011111011110111011111110111111101
01111111111111000111111a1111111111111111101a111001P1011111111110111a11111101111110221112120121021221012100012221210111111011111011110111111111101011111101111111
01111110111101000000110a0111011011110100111a111111P0111111110011111a11101110011111021102122101101111211122212111211111010100001001011111110111111011111101101110
01101010001111011101111a0010111111111111111a110111P1111111111101110a11110101111110112211202212102120021112220211211101011101111111111111110001101110111011111111
11111110101101111111100a0111111111011111110a011100P1010001101010111a11111111100111010222222021222001122122120220201111110111111111100101111111011111111111111111
01111111111011010111110a1111101110101001111a111111P1111111111111111a01111111111111220020112122111221221222011221111011011000110101111111111101011101111111111111
11111111011101011111011a1110101111111110011a100111P0111111111111001a11110111111010121112122201110210020111212112001001101111101011111111111101111111111011110111
10110111111011111011101a0111100111111111110a111000P0111111101110111a11111010111101111101120111011100112112202222111101111011110111111011011111111111011011111111
01110111111110111111011a1111111100111110011a111111P0101100101111101a01101111011111022110122210011201121211111021201111001111111110110111111111111111111110111101
01111111110110110110111a1010111101111111011a111111P0111111111110101a11110011111111112021112112002011202011002222211111111111101111111110111111111111110111111101
11111010110111110011111a1111001110101101111aaaaaaaPaaaaaaaaaaaaa101a11111110011100122102020102121112112101121120011111111111110111101111111111111111111111111110
10111100101111111110111a1111001110111011111111110P1101111101101a011a10011111011111111121021120211211201022211211111111101111111111101111111111101111110111010101
11111110111110111111101a0101111101111111101111111P1011111011101a111a11111111111111102221021101011221222211211210211110110111111101111111111011111011010011110001
11101111101111001111101a1101110111011011101111011P0111111111111a110a11111111101011221111200122112222001222101121211111110111110111101011011111110011111000111111
10111111001111111111011a1111010101111111110110110P0111111101110a111a11111111101011112201220222201211112211121212001011011111111111101111110111111111101110111111
11111111101111101111110a11110011011010111110101111P111111011111a001a10100111101111110002111120122020111022100011211011111111111111111111111111110110111111110101
11011111111111111111110a101111111011111111011111110111111111110a011a10111101110111212112122022222102122212121221211110110111101111101111011101111101111111101101
10111111111111111011111a010010111111111110011111111111110111110a111a00101111111110122212222221112122121222212111210111111111110111001111111110111101101100111111
11101111100010111110111a111111111110101111101111111111111101011a110a10011011101110122221202211101201211112221012011111110111111001111111010111111011111111110101
11101101111101111001101a111111010011111010111111101111111111011a101a11100110101110121212201121110120102221222121211111111111011011110111111111111111111001111111
11110111000011011111111a001101111111100111101011111111111111110a111a01001111111111221112210201021111211111212112111111110111111111111111101111110110101111011111
11101100110111011010111a101111111011110110111111001110101011111a111a11111110110111012010011221200221200022102212011101011111111111101111110111111111010101111111
11110001100111111111111a101111011111101101011111111101111011111a111a11101111010111120011221121011112012122120222211101111111111110110100111111111111111111110010
11110111111110101101111a111111111110111111111111101111010111101a101a01111111110011010101222201210021111121122110211001111101111111001111110100111111111111011111
11111111110111111111110a111101101101111111101111111111011111101a111a11111111111110100101111011011101111011011111110111111001100111011001111110111111110111111111
01011111111000111111111a111111010111001111101011110111010101110a111a00111111110111101111011111001111111111101110110111110011111100111111111011111111111001011111
11011101111111100011101a111101111111011110101111111111111101001a111a11011011111111101101111110111111011110111101111110111111111111111111111110111110110101010111
11111010111111101111111a011111111111101010101011101111111111101a010a11011111111111111110111111111111111111110111011111111111111111111100011111101111111101111110
11111111010011111011111a011110111111110111110101111111001001111a110a01101011111111111111111111110011111011111011111111111111011111011111110111011111101011111111
11101110111010111111111a110101110111011111111101111011111111011a010a01111100110010111011111111111101100101011001111111101111111110111111111111011111111110111111
10000111111111111010111a011111010111110111101111010111111111101a111a01001101111011111101111101111011111111111110111110111111100101111011111011111111100111110111
