147 49
12 54
118 42
15 7
76 66
86 2
64 26
50 31
133 26
97 97

20121110222202211122a211112212111111111111101a1011111111111111010111101111212022121101222001112221012211101110111111111a1111111101111101111a11111100110111111010
22210122012122111220b110200112111111111111101a1011110110011011111111101120202111111211122222121101210211011111101101111a1111110111111111111a11010110110111111111
12211111221202212221a211221120201111110011111a0111111101111111111111111011110111210121122112111211220211010111111011110a1011111011111111110a11111100011011111111
11210120001220121110b212012221110111111111111a1111111111111111111111001211200211220111212122121221011111111111110011111a0111111111101111111a11011001010110101111
01210211111221022112b202122220211111111111101a1011011011111111111111111101021212020121221112111210122110011011111011111a1110111110000011111a10111111111101111101
02111121101121220202b111122111210011101001111a1111111111110111111111011021100122121222100110112110210111101111111111111a0111101111101011111a11111111111100101011
11122100120221122110a002221011111110011111111a1001011101110010111111111022101222222222021201221212212211111110011111011a1101100111101111101a11110111011101111011
11222122212212112202b021122121111111111110101a1111111101111101011111111021222011121212121011112012021211010111001111001a1110101100111111111a01101001101011110011
11002222121220122122a021212012111111011011111a1011110111111111111111110010120022122111122121111111212201111111110111111a1110010001111011111a01111111111101101101
22221021222122210211a110102221101111101111011a1110111101010111110111101111021102021222020102001211122110111111111101101a1110111010011111111a11111111111111111011
01111112122211001111a121220002010110111111111a0011111111111101101110101211222001111112111101021011110100110111111010111a1011111110110111111a11111111111100111010
11202212202111210111b220202122110101111111111a1002021210012012101221222220012222221112221021211212122011101110111111100b2111201220022212121b11121210010111111111
22121021211212212111b111221211010111111001111a1110101222201011201002122022222222221112212110211012202111111101110110010a2000211220120221221b12100210201111101111
21120122011210102112a112110212211111110111111a1112212211021112001202110221010210021110110102010111111101010111111111111a2111221101211221112b22111121211111110111
12111021210211122220b002222112111000011111111a0110220000220211001111202022220110222121010202221022220110101010011011110a1102121212212221012b11002221210111111101
11222222012120011112a011222112011110110001110a1102120020120111121211211201000002112122022200211212112001011111101111111a2000221211221012211b21120120211011111110
02022111212022102101a120212002011012121020201a2002212212222122012211211210212211011012212211111021201211111110110111111b2111002101211201222a11011202011011001111
22022222212022212122b022120211211111201112122a0222212022212222121212121222120222201022010110222112212210111111111110101b1112210021101120210b22102221000011101111
22122112012112111102b120201011000012012122011a1210212222200222212212022012201022111211111111221101211200111111011111111b0012111222012122111a22221001211111111001
02122212212212212120a112201222111110122211220bababbbbbbbbbaabbbbba21102202202122102220120210210012111211010101111110000b1110121022202202112a11200100011101011110
21202102220021022111b00201211121101222222222011122222201221222002b22101222212222201121222111202122121210101111111010102b2222210122011121221a21122111211111111101
00222001102201021112a21111121201111212212111101012222220222022220b01111122222002022120101201211111022211110111011111112a2021212100022102200b21122121211011111011
12121121111112111112a01112202111111002021010211001222222212222222b12122202212020212112111111012112222111111101111011110a0121012112211112221a10101120110110111111
12012222112122200122b02011201221111221222212210212221122112222112b12210022222222212201101222101112110111111110011011100a1200122102221202102a11221222011101110110
12102012211112012201b12222211110110011010222121212212222122222121b12020121122222221020012222211120211111011111011111111b0221221121211022210b21021222011111111111
21112102022221001201a10012120201010212221210201212220211122122212b21222122122222220211021220220212011111111111110101111b2220111110122221122b21221221000111101010
22122212222120122021a12001111211111111002211012202222210020221222b21120221221221222012222121212210202210111110110010111b0221221111112110221a01121111111101101111
02212010122121122122a01212212211111020111202211211221022222202220b20111212222222121122111210012221010010111020021222222b1222111220202111121a21212111111111110111
22121100112121012202b10222012010111101101110012112012222221221222b21221222121020000220211121122020221211212212101111000b2112112220202222110b01221111211001111111
00121102222000110020a10212210110111011212121111022222022212222011b20121220222202212211210120120222221110211221222221220b1222212202200210212b11201000211111111111
12120202221112211000b12001222101111221111212102122220222102102100b20122202102200212221122012212011220010111211102211212a2210221220222221202a21022111211111111101
10111111011110111111a10001100011110102110212211212221222110102222b22021122112201011101111101111111011112020012111010010a0221221212201211022a02122211111011011111
11110111111111111001a11101100111111111010201011201222112012221212b12110201111201111110110111111111111101010221202111102a0022022212202111221b20201022211010011111
11111011111111011011a11110111111011121121110220111211122222222021a11211011211211101111011111111111011110012021210221112b0202222120212111000b01122221211111101101
10011110101001110111a11011111101110210021112211120200202200222201b10102111022220110111100111101011001110110211112102202b0102222212221220111b12222211210110111110
11111110011111101101a11110011110111202111012122110222221212022122b02111121021101101011111111111111101111211221112122212b2202222120211021111b12221221111101011101
11100111110011111101a11111111111111021212111202202012022212222222b21102102202222111111111011111111111001202022110121112b2022100222222020222a21211001111011011111
10101110011001011110a11111111111101122122011212212112220222222122b02201012212110110011011100011011111002122220021011112b1122002222102211102a21220211111110110111
11111111110101111111aaaaaaaaaaaaaaabbaaaa222110221022220220021220b10110101012210101011101110111111001112122212110001212a2022222021000122110b01221121200111111111
1111110111011111111110111111110110122122a12201101101202201211202PPPPPPPPPPPPPPPPPPPPPa011101011111111110121010212210222b2200222021222002112b11122211211111111111
1111110110111111011111111111111110112011a2220220120122222212200P222111221002101211111P101101110111011111211101210111112b2210102201120222221a21100111101101111011
1101111110011111111011101111011110122222a2212111222202201211PPP2122222111111221111110aPP1011100111001111111221121202122a2221222121222212122a22120102111111101111
1111111111111111101111100111011011111202b021020111021212222P2200000101111111011110111a10PPPPPPPPPPPPPPPPPP022PPPPP21212a0202120221112111111a01010111111111111100
1111111111101111101110110101111111100122b111222001102112PPP12212101111011111111011101a11111101110111111120PPP10012PPP12b2201211122222211110a10111000001111110111
1110110111100111011101111111111011122222a22111122022122P22222222001111010111111101111a1011111110111111102212110022212PPPP012P12222110011111a11110111111001011111
0001111100111110111111111011110101021221b22122101212222P01012220011101111011011111111a010111111011001111120121111111011a2PPP2PPPP2022211111a00111111101111111111
1011111111101111011011111011011110111212b00012012202PPP122022122110111111111110101110a011111111111111002012212111122122b212222200P202211111a11101110011111111110
1111110111100111011011110110110111111111a1111101PPPP111111111100011111111011111111111a110111101111111012002111021121110a0220021211P22011111a11110001011110101110
0101111010011111111011101010111111111111a101110P1011111101111111011111111010111111001a111111111111110101122102001120002a12022110212PPPPPPPPa11111011110011000111
1011011111110101000111101111111111111101aPPPPPP11111101101101111010111011111001101111a110101111111101110201112212111221b0220012212122111111PPPPPPPPP110011010111
1111111111110111111111111111111101110111P11001111111111100111001011110111110101011111a011010111111111112001120121222222b1022112122011211111a01011101111111110110
1111111011011011111111111111111111011110P11111111111111111111122122010221222011120012b112122111111110112201112020102212a0212121210112211101a01110101111111111111
0111111110011011111111101011111111101111P10101111101110101111220121122111222220012121b211220111011110101021221002212011a2211221120110201111a11110110101010011111
1111111111111111101111011110101111001111P01111111111110011110122210112022212110021022a111202111111111011211112101122212a1201112110011111111a01111111111011011111
101111111111P111111110110111010101110111P11111111101111110111220121021210222112211121b211020011001101112212122212112212a1201201021102101100a10100110111101101101
001111111111P101111110110010111110111011P11011110110111111110211121012121012221222212b012222111111101112011021211221022a1022111201012110111a11101011111110101110
011111001101P111101011111010011111101110P11111110101111111101100112020201020210012221a211121111010111110111221110121111b2121212111210111101a11111111110101110111
111100111101P111101111001110110111101110P11111110100111110011112110120110120221022212a201122111111101112122112121222222a2112220111111111010a10111111111111111111
aaaaaaaaaaaaaPPPPPPPPPPPPPPPPPPPPPPPPPPPa10111111011111101010111121221111112100212222b202222111010111101111111111101111a1111011111111111110a11111111111111111110
1101111100011111110111101011111110110100111111001111111111101022112221111211111212112a012221111111111111111111111001111a1111111110111111110a10101000111100100111
1011110101111110100100111111111111100011111111111111111110111011220012121121100121221b212221101111011101111111011110001a1111111111111110111a11111010111110011111
0111111101111111111111111011011010111111101111111111111111101211102202110111211002122b221111000011111010011111111101101a1111011110111111110a01111111111111011111
1101111110111011111010110111111111111111011111111111001111111112122222222022202002021a212221110111000101101111111101110a1101111111111111101a11110011111001111110
1111111111101101111111111111111111111111111111111001111111111020210022101111112202121a211122111111111111110111100101111a1111111111111111111a11111111011111111101
1100111111101111111101101100111011011111111101111001111110111212010022121212200122010b201022111001101111010111111111101a1011111110110011111a11100101101101011111
1011101111011100111001110111011110111111111111110101111111011210111100120221222211001b110121110101111101111011111111101a1111111111111111111a11110111101111101111
1111111011111111011011111110010111111011111111011101111111111122202222222101122121122b002012111011111110111001111101011a1111111011111011111a10111110111111101101
0011111111111111111111111111110111100010101111111101110101101121120122011111102121222a000021000111111011110111111111110a1111011101111111110a11111111111111111111
1110011101111111111110100100001111111101111011010111111110111221120021211111011211021a212122111101111111111111101101110a0010111111111010111a10111001111110010110
1110100111111111111101111111110011111010111111111011011001111211011012211021122221120a002122111110111111111100001110011a1111111011100111111a01111011110111111111
1100111111111011101001111111111111110111101111110001111101110020110011122010211202222b220111011110111111110110111111011a1110111111111111111a01111111111010111111
1110010111011111111101111100111111111011101111000111111110111011011101110101212110011b112221111111111111111011101011111a1111011111111101111a10111101111011111100
0011110111111011111111011111011111110101111110111001111100111211112012111220212212110a221211111101101111011110011111111a1111111111111101111a01111111111110111111
1111001111111110101111111111111101011010101111010111001111011121210112211201212112112a222222110011111111111110101111101a1011111111111111101a11011110010111111111
1111111101101111111111111010111101111110111100111111011111111221102220201201212000210a221110011111111111111111110110011a1011111111110111110a11111111111111111110
1111101100111110011101111110101011111001111111111011111111111211201220012111212121121a022222101111110101111101111110111a0111101111011111111a01111101111111111111
1111001111111111111010111101111111111101110110101111110011011220011111100102202111020a221122110111110110001101111111111a1111110111110110110a11101001011111111000
0110111111101111111111111111111101101011111111111111011011101221100201122222111001222b211111111111111111011111110111111a1111111001110101011a11111111011001011111
0011111111011010111101010110111111111001011011111111111111011101221222110202212221212a221101111011111111111111111011111a1111111101111110110a11111111011111111111
1110111101011101101100101111011110111111111111110111101111011022211221220111011102020a221100111111101101111111111011110a1101011110111100111a10111101111110111111
0111111111111101111011011010111111011111000110011011001111011002021122112221112211222b202002011111111111011011111110011a1011111111101111101a11111100111101011111
1111110100111110101101111111111111110100001101111111010111110220122122202021111122201b220011111111110111110111111110111a1110111111111001111a11101111111111111111
1101111111111101110100001111011011111011111101111111111110111011101111011111100111222a121121220212111012122220212111011a1011101111111111111a11111011011111110011
0111111111111110110111111111111100101111111110101111111111111101101111010111101110110a201112002002210121111021220111110a1101111111110001111a10101110110111111101
0001011110110010011011011110010111111011111100100011110111111110111111111111110111111a112000221112122201201111002100101a0010111111101111111a10111111111110111111
1111111111101011111110110100111011111101011110110111111111110111111111110101111111220b220010212220112221112120012111101a0111100111111111101a11111110011101001111
1111111101101101111111110111111111111111111111111011111111111100111111111101111111112b200120122121212012212002200111011a1011111111110101111a11101111111111111111
1111001101101111111100111000111011101111111110100111011111111010111111110110111111212b200122111121112012112210221010111a1110001101011111111a11011011111011100111
1111111010110111011111111110111111111111111001110101101000111111111110111111011111111a200011222111121012202222200101011a1111101001111110001a11111111101011101001
1111011111111111010110111111111111101111010000111101001111110011011111101101010111212a121111122220021101222121221110111a1111111110101111111a01110111110010111111
1111111111100100101111011111111111011011101011111111110101111101110111111111100100102a201012112211112202221222111111111a1011001110011110111a10111011111110100110
1010111000001100111111100101111111111110111111101111111111101111111101101101111000202a211221122211021122121221112000111a1111111111111111111a11110111110101011110
1101111111110111101111111111011001111011111001101111111011101111101111011110111110110a111122012212011212201212112111111a1111111101011111111a11101111111111111001
1111110111111111111111111110111010101011101101110111110111111110111110011110111111122a022100111120002102221111021111111a1101111101111100111a11111111111111111101
1111010011111110111011110111101011111111111111101010111111110101101111111111000111200a222110001121212200122202101111111a0111111101111111111a11111111101111111111
1111101101111111101111110110111111111111111010111111101011111011111110110101111011221a221110112121110112110121021111101a1011111111101110110a01111111110111101110
1111111111110001111111111011001110111111110111101111110100001111011111100101101111121b201112221211022122111222110001111a0001011111010111011a10001101110111010010
1111011111111111111110101011101110111110101111111111111110101111111110110010101111012b022012201122202121211100012110111a0110111111100111111a00111111111011111111
1101100111110110011110101111111111111111101110011110110111111111110111111111111110212b222121022022101221221101222101011a0110100111111111111a01111011101111111111
1100111111111111100111111111111111111110111101100011010011111111111111111111001111220b122120212211011101012120111110000a1111001100110110111a11110111101101111111
1111111111111011011111111111101101111110111101101001100111011111111111111111111110202a211210021120011211202112112110111a0111111111110011111a11010111110110110101
1111111111111111111001110111101101111100000010110111111111101101111111110101111111012b210121111221222120221212122101111a1111111011110110111a11111110111111111111
1111101111011101111011101111001111001101101101111111111111110110111111111101111111222a221111210200222222201211222110111a1101111111101101011a11011101001101101110
1110101101111101111100111110111100111101111111111101111110111011110101110111111111210b012201102112121012202220100110111a1001111111111111111a11110111101111110111
1111111111111001111100111001110111111110111110110101110111011111111111111111111111012a122021212020122211222111200111110a1111111111111011111a01111111110011101011
1100111011111110111101001101111011111101010111111001111111100010111111111111011111211b022211002210120220120211222101110a0011111011011111011a11101111111000110110
1101111011011111111111111111111011111110110101111111101111111111110111111101111111202b122022201111022200111010002111111a1111111011110111111a11011010111011110111
0111100011111111111011111101011101110011111111110101111111111111010111111111111111002a211200200201110201022111212001111a1100010111110111011a11011101101101010111
1011111111100111110101111111110111111111111111111111101010111111011111111011100110222a021222020102022110222121001101101a0011111111111010111aaaaaaaaaaaaaaaaaaaaa
1111111111111110101100101111101011001110111101011010111011111111111100100101001110012a211022021112002121121212212011011a1101101110101110110111111101011110011111
1011111111111111001111011100111011110011111011111110011101011111111111101111101011121a222021212101020122102221200111111a1111111111111111011111111001011111101111
0100010100111111110001011111010111111111111100111101111111100111111101110011011111112a220211012221122202211210121111111a1111110011110011111111111001111101111111
0011110111011111111111111011111010111111111111001010110111101111111111111110110110120a121222202222221111221200122111110a1101111111111111111110101011111111111111
0101111111111110111111101101011111101011101111111010111111111111111111011111011110100a111111111001111111111101110110111a1100111111011111111110110101111111111011
1111111111111011110111111111111101111110101100111111111111111111111010010110111111111a111001100011110011011110101111101a1111111111111110111110111101110101111111
1111111101111111111110111111101110111101010110011001111111110011111111111111111111110a110111110110011111111111110111011aaaaaaaaaaaaaaaaaaaaaaaaaaaaaaaaaaaaaaaaa
1101100110110111101111111001111111010011111111111111000101110111111111111111111100101a11111101101111011111110011111111011111111001111111111111100111101110101001
0100100111111110111111111110111011101111001111110111111101101111111110110001101101111a11111111111111111011011111111001101001111111011101101111111001111111111111
1111110011110111111111011111110111101111111110110101111111111111011011001110111011010a11111111110111101111001111111111101111110111111111101101111101110111111101
1100111111111111110111011111101101111110101011111010001111101111111111100110011111111a11111011111111111111110110111111111111101111011001111011111011110111111111
