11 33
155 80
118 42
15 7
76 66
86 2
64 26
50 31
133 26
97 97

021010211001122102011120111111211001111111011101a11110a111101011111011111111011221021112122222111221211111111001111111111111110110011110110101111110110111101110
122211111201222221220211222011211011011011011111a11111a101111111100111012221121010120221201212111121011111111011011111111101011111011110111011110101111110111111
212212021000112112121212121211200011011101111101a11110a111101111111001121221102110022222211221212121101010011100111110111111110100011111111110111011110011111111
111121112022222022211101221011111010101011111111a11111a000111011101101111110212121111110020112222112221111101111111011010101111011111110111111111001101111110111
212021122112200110220121121001211011101001101011a11111a110111011010001000121122201212110220212212221020111111101110111111110110111011110111111011111110110110101
011011011201111212210210211202111101111111111101a11111a011111011111101121111221012110122202110011202101101111111111101011110111101111101100101111111111111111111
211112222220101121112122021202211111111111001011a00111a111110110111111112011101201121111122112112212011111111111111111111111111111110111100101101110101111011010
110122222222021112000121021210211111110111011111a10011a111011111111101120212221212211111021111222211200111111111110111101111010111111111000001100111001111111011
221211222211112221212121112022011111110111111010a11111a111111110101111012121112200110110102100220221211110111111111111111111110111111111000111110011101110101001
202112021011212211121012220001011111000111010011a11110a111111111111111101222011212212200121020001201121011010111111110111111011111110110111111111011111111111110
201220211021122221221120222202001011111001111111a11011a111111111111101111112020020220111222211111221110111110010011101111110011110011111011111111111111101111101
221111220202112010211122220112211111111110011111a11200b122212102121111221201021220121022120212120201221101111111111110222111110212121110222111021222211110110111
012111212212211121112111122211111111101111011111a20112a121001220202111201022211122122201112212212112200101111101111010020222011220112102221222211000011101111111
122212112220211021021122210220101111111111111111a12101a110021221121220222222120222111210221102110021011111111111111111122011212210112211211101111212001111101111
221120112211122112222221112211000111111111111111a22222a110222111212222122122210201222112111020202000221111101111011100101100122120211111100102121201111111111111
222102202211122212121211222210001111011111111011a00222b222020001212210022102022221210221202211120222011011111100011111111212212211021211110102110011111110111011
011100211022211002102011021222111101100201221220a21221b202210210201112122221220212211212222222120111010110110011001111121222122122221111221221112121201111000111
211112102212201102121101111200201112021111012110b21111b221020111022112202022121212122112221220211212211111111110110101220202121201022012101221100111111111111111
212221121122221012200220211121111111112210101002b21102a022222202221012022222222011112220110001210202211111111111111111102120100211201121110112221202210110001101
221211112022220122120102111212111011011010210020a21010b222122222212021111022122012121001201211022200211101111011111110111221201222221201110121021022210111101011
220212211211222012100101202111111101111210212221b20212bbabbbbbbabbbaaabbabb2022122212222222200012202210111011111101111102021102101201221210100120212211111111111
101111122021110221122000202201211110022100122110a2222221122212221222121122b2222001212111112112112011110111101011110010222121200121221122002011211121111111111100
baabaaaabbbbaabbbabab212211200201112111110021200b0222222021221122220011220b2222222121120210202112222201111101111111011022222121112222020121211221121211111111111
21120121102210211102a011101010011111211112012221a2111022222122110210001112b1022220120112210022220021211111101111111111111200112222111121021021221221010111111111
00102020221210021212a222210120211010200222210121a1222212002212122000220021b2222200211120121222122221221011111111111110202122212201221210211212212101111101110111
00111212220202220111b011120012211112122202221000a1221022120012200222110200a1221001112220120022212200211111111111011110121012112222121122222222112220011111100111
12002001022120021121a112212121211111110220102211a2201222222002121212111222b2112100001210022112221122211111001111111000111202100100212111201021222011011111011111
10222121001112220022b102111011011101112112011011b1202122222202020110202102b2221220120122011101211201111122210121001220012022222202222211122222210021001111111111
21010001010221212102b112122021201111102222001220a1201211212212220020121121b2200001101122222211222212101112000211201210221211222122221111121201011120111111101001
01122221201111100202a221011122211001220220112022a1010210212212222201222120b2210220121211011111221102120210211210122102211122012222222222212211112112211101101101
00021212022201120210a022221120201102011010112222b0222222200221122222220020a1112021111011222122010112121112212111212102222022221122002201200110121212211101111111
11111111011101111111a111111111111011022022220121b1222222222222222002110221a1001111111110111011111011111021022001202122022222212222221210011111021111111111111011
11111110111011111101a011111111101112112200121111b1220010222121102212021121b2101211110111111011011111111022220100222101202210222222102210110122102022111111111111
11111111100PPPPPPP01a111110111110112210011101201b2222122201222221222222122b1001201010111111111101110101122210012110211022001121222112101010110221122111011111111
111111101101111110PPa111101011011101210221101221a2222221212222111121112121b2200011110111111111111111101112212021121110122020211122020111102020121012211101101111
01011011101111111101P110010111111112121002220222a2202221220101221011210021a0011111111110111110111111011121111212212111202222211122211200212001110201010111111011
11111111111110111101P111011101111100222011221121a1102010100222222111211221a1221111111111011111111011101011002112102212222121212212002202112100101112011111110111
11111111110100111010P111111101110010111122111222a1212220222222022212222212b2121211101111111011111101111222222102221222212221002212021202111100212201111011010111
10011111111110110001P111111111111112100110121221b2102022202002222121220211a2111011101101111111100011111200202021202201202022021221222210122222120220111110111011
11111111011111101110P111001111111012222102212221a2122110212122122222112120b2211101111111111111110111111221111212011010122021021102110112201211220222211111011110
11110110111111101111P011111110111101020220201201a2021200122021020011221012a1001111111101111100111011111100201112011121202212221002022102211110201211111100111111
11101001111111011111P111111111111110220111221021a2210112220222021210022110a1210211111101111111111110110001220121210012112212212221220200121222102111201110110001
11111111111101111111P111110111111102012120210112a2012112101101122011011110a0111111101111111111111101110011221221221122212221112002210011101011111111111111011111
11111111110111111001P100011110111101222011002222a1000022120021121211011111a1111111111111010101111100111112111212111220120112201111112101110010001011111000111111
11111111101111100111P110011001101012021122012221b1222100201210002111111111a1001101011111110111011111101211111202110120211212212101212210111111011111111111110011
11111101111110010111P101111111111112222121210021b2122210120000112111101110a1111111111111011001111101101202202202222110212121112111222211101101111111111101111111
11111111100111011110P111111011111010011101011110b2222120102110111211111101a0111111111100111101011111111220111222201102202221021221201111110101011111100011111110
11111110111101011111P111111111110111011111111110a1111111111111110101111011a0101011011101111111110101110122211121121220110112012221121211110011111101101110011101
11011010111001111111P111011111110110111111010111a1111111110111111110111111a0111111111111110111110110111102121211211211022212212212111201111111111111111111111111
11111100001101111111P011100111111110011111100111a1111011110111100111101001a1111011111101111110111101100222202222211210221211222021122111111111111101111111111111
10111011101011011110P111011111111111111111111011a1111111011111111101111110a1111111101111100110000111100110101202212212012101201121021011111110111111111101111101
11011111110111101101P101101110111111111101100101a1100100110110021221212100a0222122220121202101111111110221200212010021022212101101220110001001111111110011111111
11110010111111111111P011111111111110111110111110a1111011011111211101111221b1201012211221221211100100011111211212011212021020000212122111111011111110100111001111
01111111111111111101P010101111111101111101111111a0111101101112212221121220a1201211101111201210011011111221202012222111110200021110211211101001110111011111101011
10111111111111010111P111111101111111111110100101a1110101011011102210010221b0222221211111220210110111111120122212122220221101211011122211111111011111010111111110
01111111111111110111P111111101111110111101111111a1111111111100200122220212b2100100112221101000111111011120222011110220112021222121121100101111111111101101110001
01101111111111110111P111010011101101111111011011a1111111010011212022200121b2112112011201220211011111111010112002011112121221101122222110111101111101111011111111
10110111101111111111P111111110111111111110111111a1111111111101022001120122a0201110110121200210011011010101102121210111220221111211111110111111110111101011111101
01111111110010111111aPPPPPPP01011101011111111011a1110111111112212221220222a1211122101221210211111010111111011111110101001111010011111110011100101011110101100111
01111111111000110110a1111101PPPPPPPPPPPPPPPPPPPPP1111111111112202222122200b0112112202211102211111111110110101110100100111101111111110111111111011111110011010110
10101100111111111111a1111100a11100011011111111111PPPPPP0111102210121120000a0111122212002120000101111111111011111111110111111011111101011111111111110011111001110
11101111111010111110a1111111a10110111111111111111111110PP00110212012210221a2211222221212200211100111111101101101101101111111111101110111111101111110011111110111
11010110111111011111a1111111a1110110111111111011111111011PPPPPP21P00212201a1212200102212112111111111011111011111110101110111111111110101101111101011101010111111
01111110110111110111a1111111a0111101110111111110111111111111021PP2PPPPPP0PP2222101122202102211111101111111110111111111111011111111000111111111111111110110111111
11101111101111111011a1111101a0111101111111111011101110001111102111202102P0P2011201210221021111001111010111111111110100111011101011101111101111110111101111011111
11011101011101011111a1100111a111101001111101110111011111111111222212022110PPPP2200221221111211101111111110011111111101111001111111111111100101111001111111101111
11110100110111111101a0100111a111111011111101111111111111111101210122120110b212PPPPPPPP01210111111111110111010111011010011111101111110011111111101111101101011111
11111111111111111111a1110110a101101111111111110111110111011112111121022112a22221220121P0212210111111011111111011011111111001111111111111011111111110111101111011
11111111111111111111a1111111a111100111110111011111110111111112201121222121b212111220202P110111110100001110111111100111111011001111001101110110101111110001011011
10101111111111101111a1011111a111110111101111111001111101101012122221212221b0102210122221P22211110111111011111101111101101111110111100111111110110010110100011101
10011111011111111011a0111101a111111111111011011111111011011010122120221202b12012120121222PP211100101011101111111111111111111111011111111110011111111100011110111
10110101111111110010a1101110a101111111111011011011111101111111212221222101b0211022221020121P01111101110111111110111111011101111111101111111111101111111110101101
10111111111111110111a1011110a111111111111111011101111111011012112221121022b22211110102222201PP111111111111111111100111100111111010111011111110110111111111111010
11101111101111111110a1111011a110101111111011111111111111111110211111222111b1212221202121201111P00011011011111101101111101111101011111111111011111010110111010111
10111110111111101011a1110111a111111111111111111111111111101112010110012221b02110112212100121111PPP00111111111111001111100101010111111111010111111011110111011111
11101011111011001101a1111110a111111111111111011101111110111110212110221111b20110222212220120111111P1010111101011011111011101110111111111100101110101000111111111
11110110101101011011a1011111a111111111011111001111011101110111222120121121a112220211122111201110110PPPPPPPPPPPPPPPPPPPPPPPPPPPPPPPPPPPPPPPPPPPPPPPPPPPPPPPPaaaaa
10011011100111011110a1111111a111011101001111101100011101111101112210122122a102211212112122021111111a0011111101111011011111111111111010110110101011111110110P1111
11111110111111111011a1111011a111111111111111110111011111000111122211221200a221010221101120100101111a1111111111111111101101111111111111010111110111111001111P1111
11000111001111011111a1111010a111101101111111111111101111111112211111121212a102211221102212101110011a1011101111100111111101110111111011101111111100011101101P1111
01101111111111111111a1111111a111101101101111111111011110110002022102222220b211211220100201111111111a0111111011110101111111011110110111111110111111111111111P1111
11011111110101110111a1111011a111110101101111111111111111110101112210111222a001212211120111011111111a111111101111110101111111111111110101111110111010111111111011
11011011110010111111a0111111a110011010100111111111111101111111110001011111a001011121112122121112020a021112211022201111111111110111111111001111111011110101110111
10011101101111110000a0111111a110101111011010111111110111011111110111111111a110111110211012110102111a012111010220211011111111101001111110110111011111111001101011
11111111110111111111a1111101a111011111101111111100101101111111110111111110a101100112111012022111101b222111122002210111101011101111011111101011101110010101101011
11010111111111111111a1111111a101101111111001111101111101001110111111111111a110001121221021111222021a111022100222201101110101111100111011101111101110101011110001
11111011011111101110a0111111a111111111111011111011110001010100111111111111a111101120221122211022121b212100110120211011101111101111110011011111011010111011111111
11111111111010101011a1111111a100111111110011111111111110101111111110101111a111111001122101201221020b110112110111211110111111101111111110110111011111111111111111
11111011111111110110a1111111a101001101011100111111111111111110101111111111a111111111012022112212111b112001112110010011111111111001011111111111111011111111110111
11011111111111111111a1111111a111111101011110111111111111111111111111101111a011110122021111122112222a122111112122211111010111011011010111110111111111111100011111
11111111111111111111a1111111a101111111011001110111011110111111111111100111a101111011120112210112112a222110012201001111101111111111111111011111011111110111111101
01111111110111111011a1111111a111100101110111110101111101011110111111111111a110111112122201212111222a221102111201111111111101011111001011101110111111110110101111
11111111101111001111a1010111a011110101101111111011111110111110111110111110a010111022220022211001121b121111222011201111111111111110111010011011111101111111111110
11101110101111111111a1100000a111111111101101110011111111101111111111111111a100111121021022110102112a012011121102200111110010111101101111001111010111111010101111
11001111101110111001a1101011a101101111011001110110100011111011111111111111a101110101211112212221110a211210220001211111010101110111111010011111110111111111111111
11111111111111100110a1111111a111111111111111111110101111001111111111111110a011110111110121121200100a011120221022111111101111101111111110101111101111101111001010
10111110110110101111a1111110a110111110111110111001101011111111111111101011a101111111212112112211000b110201201210111101111111100111011111110101111111111101101001
11111110110100111011a1010101a111111011111011111111111111101110111110011111a111011121021100202102221b102112010212210011100001001101101111111111111011110111111111
01111101110111011101a1101111a110000111111110011111100111111110111111110111a111111111202011122211122b022022120122211111111111101111111111010111110101101010101111
01110111111100010111a1111101a111111111111111111110111011111101111111111001a101111120211220122222121a001112111022211011111111111111111111001111111111111010111111
11111011011101101010a0011111a1111111111111101111101101aaaaaaaaaaaaaaaaaaaaa111101012211000002122222a122022202001211111111010111110111100111111111011110111111111
10101011111111111111a1111000a1110101111111111101111011a11111111101111111111111111122211122122221222b112111021122011111110111011111111111111011011100111111101110
11111101111111111111a1011110a0110001010101111011110110a01110110111111100111111011002212111021202200b001222211111211111001111111010111111110100111111110011111111
11111111111111111111a1011111a1101110111110111111111111a11110111111111111111101101121121110221102210a221020020201111111101011111011011010111100111111010101111111
10011011111111001101a1111111a1111111111010101111111110a11101111111110111110101111012112202211121122b221212221021211110111111100111110111111111111111111011011110
01110111111110011010a1011111a1111010111111110111111111a11111111111111111111111101121112222121022120a221022111020011110111111111001111111111011111111111111101111
11111110111111111101a1001111a1110010111111111111111100a01111110101111101111011111121120100110021210a121021012222211010111111111111111100111111111111110111111110
11111111111111111010a1111111a1111101111010101101101111a10111101111111111111111111111202212221110002b212222102200211101101111101110010111111101001111101111111011
11101111010110101011a0111101a1110111101111011111110111a11111111111111111101111101001102111220221122b202222210221201110110111111111110111010111111011111111100111
11110111111101110111a1111111a1001010111111001110111111a10111011111011111110111011112102021112212121a210011111101111111111111111100111111111110011100111111110111
11111110110101111010a1110111a1111011111101111110110011a11101011111111101010010111100212200222212122a201121201011011001111110111110111010111101110110011100111111
01111111111111110111a1111111a1110111111111011111001111a01001110111111111101110111122221012022212011b121111111222011111111111010110111111011111011111111110011111
11111111110111111110a1111011a1111101111011111100111110a11111111111111110111101111112212121222110202b120021201112001001010111010010110111101111011111011010111111
01101010111111101111a1111101a0111101111110001101111111a11111111101011111101111111111011110111001110a111111110111111000001001101111001111110101111110111100111111
01011111111101001110a1100111a1111111111111111101111111a11101101111011011111111011101011111010111001a110101011011111110101111111110111011111111111010111111111111
11011100111111111111a1111111a0010111110111001111111011a11101110110101111111111011111111101110011011a111101100110101111101111001111111111111111111101111111111111
11001111100111110011a1110110a1011110111111101110110111a11001011111111101101101011111111110111011111aaaaaaaaaaaaaaaaaaaaaaaaaaaaaaaaaaaaaaaaaaaaaaaaaaaaaaaaaaaaa
01111111111010101111a1111111a1111111111010101111101101a111011011010111111111111111111111110111111001101111010111001110111001111111111011110001101111111110111111
01101111101111111111a1110111a1011110111111101001111111a111111110001011010101011111011110111011111111101101111101110101111111111111011011001111111111111110111111
11111011111101101111a1111011a1111111111111011111010001a011111110111111001111110001101101011111111110011001101100010111101111111111011111001111111101111111011111
