9 77
148 5
118 42
15 7
76 66
86 2
64 26
50 31
133 26
97 97

1122211101220100222012220120221001001111110011101101011111111a1111111102122122101b122202210201021212201111111111101110111101011001111011111101111101010111111111
0101001211222120122002111222111101101101111111011111111110111a0111100111201120122a121222101201211111210101111110111011101111111011111111111101111111111111111101
2212121210010102121011120212020101111111111111111001111111111a1110111001100211111a020222111210111221200101111111110101011110100111111111110101110001101111111110
2212211121222122001001221102221011111101111111001011101110110a0011110112211222022a120121100202221012221010110011011110111011111011101110111111011111011110111111
2122112221212022021121021001202111111111011011110111111001101a0011111111101202222b122222120121110012011010110111111101101111101111101111111111111001111111000001
1122011101112101122121111202111111111110111111111111111110110a0111111111121211211b201021112212111210021111111110110111101110101101111111111111101111P11111111111
2210211211221210210012200210011111011011111111111110111111001a1100101112201222221a0122121222221220121211111111111111011aPPPPPPPPPPPPPPPPPPPPPPPPPPPPaaaaaaaaaaaa
1111122212210222220200220200220111111101010001111110111001010a1110011111121002120b1112222212201111212101010111101001111P0101101011111011111111111011101111111110
2210111212220112121212020221222111111110111111011111111011011a1111001102211112012a1221022102201200210211111111110101110P1111110111111110111111111111111111011111
0111222111112112211220121211012111011111100101111101111110111a1111111111011111221b2202221110010112211211111110111101100P1010001101111111111110011111101010011111
1201211011112011100111211122122111010011011111111111011110111a1111111110211200222b0211121221122210122011111110111111010P1101111111011111111111110111111111011101
1222121001102100122021021221211011000111111111001111201211112a0111220212211120121b1111011121112120211210111111111111112P0221210110202111012112221211011101111111
1212201222012221222200122120202111101101110111110112222221211b1222111122120212111b1112121211012212201111101111111111110P2211211121121200122122011022111111111110
1120221002112011210011011100001101111111101101111121012112221a1120121212011212221a0112111212212212221211010111111011100P2211112102200012221112222222211011111101
2002222122122202111021020111222110111111111101110102221221211a0112202110221202222a1222222012110022201111001111110111010P1011110021210221211221202221011011001111
2121021111020122102210112212101111111011101000111010121111211b2121212200022212202b2210200221222022102111111111111101110P2011022111012202211222111101211011111111
1100122102212111202202202222100111011222111211122022220222022a2001021102102220202b2122111200211012211111110111111110112P1212012120221022202210120222210111111110
2222021220021022111210102222111011101122011100211222121102202a1022002021120202121b2221221110201222111011111111111011111P0122102222020110210121210112011110101111
1022111122022021112111121121121101120111221012222212212202222b2211210221221220202b0210101212200200112211111111011110111P2112110112220211200120000121210011111111
2021121211102211221211000021121111112121011221101221120220122b0112121222212202122a1101210201012222110111011101111111112P2101212112222102212122122021001111011111
1201122212122112012012222112022111121122110021221022112021012b2121020110202211122b2222102212120011100211110111101101111P1102202022022202001212012221011111111111
1211212110112112011112002120112111111111211212010212222222120a2102221211112222112a2112112102212121211211111111111111010P0221110002112212221001200210211111111111
1222110211212121122122112211222111102222211222221200210202022b2212222021012122221b1021202122212102202101111111101011111P1121021022121212211222111121111110111011
0112020212111121211221222020122011022221220222101022220220022b1220201111222222221b1001122222010201222111110111011101112P1000122201110112111111212111111111111011
1211001221012221201211101111021011012100022222121021202111122b0222000112202212022a1121202222011022020211101001111111112P2120122222212110111121010211210111110111
2211100111220020202120212112211011012021101222102220021220021b0021201010110220122b102221022001010120011111111111111101Pa2002011211100210102112222200011110001001
2122102212102011112120222122011111020122222202211222222222020b0010001202202222222b2112102022022212002211010111PPPPPPPP2b2221211201002110112baaaaaaaaaaaaaaaaaaaa
2121020112120221021211021010001111120100010221120211202021221b2222100121221222222b12212221211122001222122112PP212201210a1102022120220202120a21211211011111111111
2121022102000121021021112000021110111120221212222212121202021b2002010222221112222a1202211211221022021210221P21220122212b2221222122022121111a12012022211101111110
2012112221122102222212122211110100010022101221122002222220221b1012121111222021221a222221220111122112120222P002111112111b2222202002222222122b20220120211100111111
1202202202121111020121210102021011022102220122121212201202210b2122101210212121122b111102220222122212211222P222210102212b2222222212222211202b20101121111111111111
0111111100111110101111011011011111102111210221121120122221220b2222121122012210011a10111111111111101101022P0010021201222b2001122122002220200a12212120201111111111
aaaaaaaaaaaaaaaaaaaaaaaaaaaaaaaaaaabbababaabaabbbbbbabbbabbaaa1201000112222012211a10111011111111110111PPP21222222110122b1221121211120220211a10001111211111111110
111011100111111111011110011111011112121221202212112222212201ab1122101111111211211a1100111111101011111P01212212111112110b2202222201122222011b11212122110111101101
111111111011111111110110011111111102222012210212022122202222ba2201221022121212120a11001110111111111PP011110110102112212b0221201120120211112a11212021011101101111
111111100111110111011111110111001100221022012212122222021221bb2001021110221110221a0111101111011101P01110011211120212222b2202102221122212221b02102011211011000111
001111110111111111111111111111111010100200111022112222212220bb0222120220112212110a1011PPPPPPPPPPPP110110211210002222121b2022021202222022211b21110201201111110111
111101111111111011111011111111111111222221111202120212102212bb2220112020012212201aPPPP011011110001011101220102010220012a0222112200220221221b22120010010111110111
111011111111011011001101111110101111122212221221120221021220bb2221221020202211211P1111111011011110111101021121111112212b2002101202221221212b21020120010101111111
111011111111111011111111110110111112221211100112220021222212bb1222121112121121111P1111111110001101011102212222222200112b2211221121122011200a21222220201011000111
111111111100011111111111111101111112111120001111120202212222ab2210211122000102011P0111111111011111110112112010111121200b1122122010222211012b21211220001101111110
111110101110101111111110111011100012221201220121222221012202bb0202101112122221021P1101111011111001101112111121120022020a2222122221202022210b20110202101101010111
111111111111111111011111111101011110112021111211222210110120ab2212111110111111111P1111110111111111110100122211122021112b2112011220111011111a11111101111111110011
011111111101100101111110101011111110110012011012010212212122aa0102111111111101011P1111011110111111011111200210222100221b1212211111001211111a11111111111111111111
111011111100111111010011111111010112221222221012202021221122aa0021111111110111101P1111011101111101001111210101212002122b2212212202111110111a11111111101110111111
111100110111011110111111011111111112022111211121120011112112ab2101111101111111011P1110111111111000100111210222222101010a2021122111012210110a10101111111111111111
101111101101111111101101101111011112021021121101211112202002aa2021111001111101101P1110110101110111111110212110221111120b2102112102222110111a10000111111110001111
010101101011111111111010111011110100111111111111011111111111aa0111111111110110101P1111100101111111111102122112112201120b0212121202211111111a10101101111010100001
111111111110111111011011111011110101001011011111110100010111aa1011101011011101110P1111110111111111111112211012002121121b1111020120121101111a11011101111111111101
110111101101111111111111111111111110101101101100100111111110aa0111111001111111011P1011011111111111111112221211221121200b2200212201212211111a01111111110110111111
111001111011011110110111101111010010111110011111111011111111aa1110110111101111011P1111101111111111111111211202111221210b0111021112200211101a01110111101011111101
110111111111111110100111111101111111111101111101110111101010aa0222011001211221002P2121120122011111111110101112211122111b1111101102112011101a11011111010001110111
110100111010011101111111011111111111111111111111111111111111ab1120200122121220010P1101122022110011111102222202112012111b1112212111012010111a11101110110111110111
011111111001011101011101111111110111110111101111110111111111aa0102211112021120110P0001202020110111111112012102102101122a2201122022021010111a11111101111111101011
111111111111010010101010111111111101111111111111111111111011aa1220221222212220210P1212222212111110111110022212120212110b2201012020221200111a11101011110010111001
101111111011111101110110011111111101111111111111110011011011aa1111221202202112122P1211202121111011110112112202201012121a2222121222111111111a11111101101111111111
101111111011011111111110111111101101111011000110110111011111aa0221221202021110112P2121101212111111010101111122101202111b2220112001222100110a00111011111011110110
011101111111001010110101110110111111111111011111110111101011ab0211010112210221211P1021102212101111111111221012221111221a1112212200102111111a11101011111110111011
111111101101001011100111101011001111011101101111110101100110aa0110212100101222121P1022000220111111101111111110010111111a1011111101111110111a11011111101011001101
110101111010011011110011111011010110011111010101110111111110aa0212121120212112222P0002011212101111010110110101110101111a1111111111111111101a11011111110110111111
111111100111110110111111111101110111111110110111100111111011aPPPPPPPPPPPPPPPPPPPPa1010111122111111111110111010111110011a1101101110111111110a10111111111101110011
111111101110110101111001110011110111111001111111111111011011P1121021112211012112222121211222111011110111111111101111111a0101111110111011110a01111111010111111111
101111001101111111011111101111100111101100111111111111111011P1011212012221110011221121112222101111101010111110111111010a1110111111111111111a10110111010111111011
111101100011100110111111111110111101011111110111111111111101P1222222221112211210122011110122110111110101111011111011110a1110111111111111101a11111101001011111011
111011101111101111101101111111111101111111111011011111110101P0211220022210122210010002112002111111101100100111111111101a0111111010111111110a01011101101111111011
111011111111110110111111111111111011000111101111111111111111P2111022110012212110222110121102100111111011111111001111011a0110100111111101111a11011011101011111111
111100011011101110101011111110111001111011111111111111111111P1201121012001222012121222211202011111111111010101101111111aaaaaaaaaaaaaaaaaaaaa01111110111101101001
111101011111011001111111011111110101100111111111111111111111P211211122112221222021022111112111110101110111000111111111111111111011111111010111111101111110111111
011110111011111101110011111111111101111111011110111111111111P211111102110112220011012122112111111111110011111111111111111111111111111111101111111111111111111101
110111101111111111011101011110111101111111011101000111110101P112020220102120010222110111202111010111111111110011111111100011111111111010110111111111111111101110
111111111111100101101111111111111011111111111111011111101101P210200111020022121212001020100111001111111110111111101111101111111110111111011101111111110111111111
111010110111111111111111110111111101111101011101101110111101P022202112021121021010021212002111111111010111111111101111011010011111111111010111110111111110111101
10001101101111111111111111101011111110011111111PPPPPPPPPPPPPa222120122122021112121021002122100011110111111110111111111011111110111110110011111110111111010111011
1111111111111001011111001101011101110111110111P0011111111111a022112111112120021122111220111211000111110111111000111111111111110101110110011101001101011111111100
0111110101111101111110101101111111110PPPPPPPPP01111110010111a012210122221222002101211021201211011011111111110101100110101111011010111111010111111111111111110111
111110111011011111101011111011111110P01101000010011110111111a120112021201010010211112212222111111111111001111101110101111111011111111111011101011111110111111111
111101011100111111111110111111111PPP011111111111011111001111a200212202222021211122011201222211010111110011011111111011101111111110111010101111111011100110111110
110110111PPPPPPPPPPPPPPPPPPPPPPPP011100000111111111111111101a122122012122122211120211111102111111111011111101101000001101011110111111011010111111111010111111111
111111110111011100111110011101111111111111010111001111111011a110021212222102211220101121122211111111110011111011111101111111111111101101111101111011010111010111
111011111111111001101101101111111110111111101111011110101010a02102111011220120221121211201211101aaaaaaaaaaaaaaaaaaaaaaaaaaaaaaaaaaaaaaaaaaaaaaaaaaaaaaaaaaaaa111
011111111110111000111111110011100111111110111110111011111111a21201221211102102121022111102111111a11100110111111110111111110110110111011001111011101111111111a111
100111111101011111111111110111110111111011111111111101111011a22220011222101212111121212012121101a11011111111110011111111111111110100111111011010111011101010a111
111110111011111111001110111010111101111111001011100111110111a10101110111111100110111202211112111a20220111121211010111101110111111111111111111111111110100010a110
110111111011110111100111100111101101111111111111011011111101a11101101011011110101102012212122221b22211111112122221011111011111111111011111111111111100111111a011
101111011011011011111111011101111111111111111111111111101101a11111110101000111111002201122222010a21112000121202121111101110111010101001011111111111111011011a111
111111111111111111111101111110110111111111111111100111011010a11111111101111101111010011122121210a10211122221022201111111111110011111111111111111011111110011a110
101111101110111110111111111100111111011101111011111110101111a11101110101011001111111121112211021a21121100202220211101111111110110111011001101111111111111111a111
111111100110110011101111111111111011111011111111110001001111a11111011111111111111111100121222222a21120201201212021100001111111111111111111011111111011110111a101
111111111111110110011111111001101100111101101111111111110111a10001110111111111101011211012122211b11022012221211211011101111011111001111101101111100111111101a011
111101111111111110110111111111111011011011110111110111111010a11111111111011111110121221222110112a10112222202200011110111111111011001101111111111111110011111a111
110101011111111111111110111101010110010001101111101011110111a11100011110111111110121212221111111a11022122220202211111101101110111111111101110111111111101111a111
111111100111110011111110011111110001110111100111111111110111a10110111100111011111121201201011211a12212221002212011110110111110111111111111110101110111111111a111
111111011111111111111111111110111111011001111111110111111101a01011110110011111011100111110210220a22201211221010201111111110111111111100111101111111111010110a111
101111111001101110111111111111010111111111011111010101011111a11111111101110111111111021221212120b22112221111112210110111111110110111111111111111010110111100a011
011101011111111101111100011101000101111111111110111011111100a11111111111011110111021222120212022a12222001212111221010011111110001011011101111100111111101111a111
111111111111111101111111101111111110111101101101011101111101a00111011101011111100120112111211121a11012222212222021011111111011101111111111111011101111111101a111
011111000111111011111111101011111111111111110110111111001111a11001101111010111100112202201111122a22122112221222211111111111110111011101110111110110010111111a111
110110111100101011111110111111011111111111111011111111011111a11101010110111110111112001112111221b22122110012211201101111101001011111110111011111011101011111a101
111111110111111111011101100111111110110111111010111011111101a11111111010111011011111202121212122a22121220202221021110111011010011111011110111011011111111111a111
000111111111111110110111110111101001111111111111100111011111a111110010111111aaaaaababbababbaaabaa22121211212222211111111111111011111111111001111011110110100aaaa
101111101011111111111101011011111011011111111111101111111111a111111111011111a11101122002121121122110202211121001210011111100111111111111110111111111111111110111
111111111011111111101111111111101101111101110111110111101101a111101111111101a11101211120222201211022212222021222011111110111011111111111011111111011110111111111
101001110111110111111011001111110111111111111111111111111111a100001001111111a11111212122112121202012121122020211111101111111111111111101110111111111111100010110
110001111111111011111110110110111111101101111001011111110111a101000110101011a11111111201222111220112022221122122111111110111111111111111111101011110111111001011
101011101111111111111111100111111011011111111101001011001111a111101111001101a11110012212112221112211112211112111211111111111110101010011011111111111111111101111
111111101111011110111101011111111111101111111111111101101010a111110101111111a11111122011122102222222202220220221111110011111111111011111101111111111110010111111
010101110100111111111111111110111110111110101111001101101111a111111111111111a11110212211211222012100001112022201111111010111110011111101111110111111010110110111
101111111111111110111110111111111011111110010101111111111110a011111111111111a10111120101202121110011021212021001111111110011111011111111111110100110110111100111
111110111110110111101110101001101111111001111110111111111111a101110011111111a11011221212111121212212101022212120201011010010101101111111111111111111101110110111
110111010111011111111011101110101111110111111111000110110111a101110110101101a00011211212110112100102210021210211211011111011110110111111111111111111011111110011
111001110111111111111110110111111111110111111111101101101111a111011111101101a11110212111212121112200111112212101000001110011111101001111111100010100110111111111
111001111011011111111101111110111111111111111110101111111111a110111111101111a00011202211212112112111210122220122111110111111111111111001100101111111111111110011
011111111111111101011111111111111101011110011111111111010111a111111111111101a10111222122120122202021211212202021211111111111111111111110111111011010111101111111
010111011011111111110110010111111111101001111010111110111111a111111111110111a11011101111111111110111011111111111111101111111111111111111011011011111111011111111
111111111110101111111011111000111110101110111111101111111111a110001111111111a11110111111011111110111111011111101111111111111100101101111111111111001101111110111
111100110111010011111111111101101110111101111011111111111101a111111111101101a11111011011111011111111111111111000110101111111100111101111110111110100111111111111
101111111110111110011101110101111110100111111101110110011100a111111111110111a11111111110011101011111101010111100111010100111111001111100011110111111110011011111
001011111111111110111011111111101011111111101101111111110111a111111101100011a11111111011111111011111111111110101101111110111111111111111111011101010011011111101
010111111110111111000111111111010011111111111111111111101111a111111111111111a01101101110111101111111010111111100111111110111111110111111111011011110111111111111
110110011101111111111111111111101011110011011111111111111110a101111111010101a00111111011101101111111011011110111111001111111111111111011111111110111111111011111
