66 100
26 8
118 42
15 7
76 66
86 2
64 26
50 31
133 26
97 97

2012102112102212a1110012102120111111110110111001011101001111111110111112121122211121121212b0102021121111010101111111a11a1111111111111101111111111111111100011001
2110212212222200b1120210121221100111101110110011111110111111101001010111222112212101022002b1022211122011111111110011a11a1101111111111111110110111110101101111010
1220002121221112a2122122102212111101100111111111111111011101101111111110022112111111211002b1212202022101111101011101a11a1111111111101111111111111111101111011111
2211120222122122a1202022022111111111001111111111011101111001110111100111012102222121112121a2102222122210110111111111a11a1101011101111101111111111110111011110010
2222021212112222a0200121110121210111111111111111011111111111111110111111120021101121111222a0101110112201110101111011a11a1011011111110111100111111111100111110111
1212002111222111b0122221222002101111110111111110111111111111111110111112001101112121021021b2220121102111111111011001a11a1011101111111110111100111111111101111101
1102121110210112a2210220112112210111101111111110111011101101111001111002100022202222201121b2211211000011111111011111a01a1101111111111111111011100110111110111111
2201221202220211b1202120120212101111111011111010111011111011111111010012021201121222011020b1111111002201111011011111a11a1111111111111111101110101101111111101011
0221222111110222a2101001110222211101101111001011111011001111111111111011212111101112120211b2122120112111111011111111a11a0111111111011110111011110010111011011111
2122020021111100a2222221111111210111111101111111011101111100111101111010221100000101021122a1001110112111111111111101a10a1111111011111111101011111111111111010111
0122102211110212b2212111121221011110111111111101111101110111111111101112202021101100112222b1220112110100111110111111a10a0101111111011111110100101111000110110101
2121122221012222a2122101211211211101111011110111111112122012120212121120111222221202122101a2100201020111111010111111a11a1120210211121122021222121110111110111011
1221122122220210b2121212210110211101101001011111111221111222221121200012112121221212221111b1102022210111111101011111a12b1121222111202202112202220220211110101111
1212122220210111b1102112102212110111111111101110110012112221212222121202221222221111122222a1211222101201001110111111a12b0110121122022120201201002212111110101101
2100121102111212a1212102010102010100111100110111112121200120210122222112122022012222201111a0111211221211110111101101a11b1111112211220202201112112011211111111111
1220120111012212a1122110200100210111010011110101022011100111101210122222122112112011211222a1111002211211111110100010a11a1221220122021121211211011111111110111101
2022121212210022b2120101110112111002122012011220202220221022022222211112121022220111221110a1002212112211111111111110a02a0021021221211211202101102100211111111111
2020212202121212a1202111102221010111102111010212102222112211012122010122201002222001002201b0120012122100111111101111a11b2111001011110211122102212112210100111101
2111112122211021a0212110111012111011120122111010202022212021022210122202211002222111021122b0112212101111111111101011a12a2201102212121021101121110222011100111111
2202110001121102b0021222211200211110112111210022122222212000202212022212202222220201200012b0221222120211111111111011a12a0121222211112111112220122012111111101110
1221120021021122bbbbbabbbaaaabbaaaabb02100111210122212010120202001201111002020120200221112a2211122101011111111111111a12a1212221101222022221211201211211101011111
010020021020211122111001122120211100b20112010201222210102220122222202012220222221222101211a1210202121201011111111111a12a1101011111122122021120121122111111011111
221120222121211022201211212210000111a00121222210222210212122122122121222222101222121201211a1210021112111011001111111a00a1012101222201022020111111201111111101111
101112220202112110011021012012211112a21021112112222222010222222222210222210022121122021021a2221121022201110011110111a12b1212111210112111202101201121110101111011
111212020012122222120111211212101110b22011011111201022220202222212111200012221221210022120a1112212021210011010111101a11b1222221212100111220001201200111111111000
112202122121012202011211211101201101a22220111201221222222220122220100022010102100112210120a2220210102001111110110110a12b2021022111122212100022222101111111111111
110022212110112111212102121200111111a20112021222112110222021122001011122022022220101212211a1001121021211001111111111a11b1112212210000121002111211201111111100001
221011202010101022000222010221111111a02012002202222020020121222222102002200222111221102110a1221020022212202220222020b20a0212022202222121211100222022111010110111
202112120212012120022122111122201112a21201221002220222222222222221111110222222211111211010b0101210222202200121221112a21a2220220221222211212201021111211101011111
210121110002222011222012121122001111a00020121121121110212002222102020122220222121011121012b1210111111211121121020110b22b2222222202101212121121110212211111111110
222112221112112022112020002210001112a01221102011222112200222222002201222022222021202212112a1012211011211111120012211b12b2222202222201010021111111211111111111101
101110011111110111100111111011111102b22221111120022122202222222012202122012022121111101010a1011011111102011122022110a22a0221222221122210122122101011211001111011
111111111101111111110111011101011112b01201112012221020001222222122122111121202011101101111a1111111111112122000221211b01b2002000022220100022120221222211111000101
111111011101111111111101001111010111b10212210122221221112222112201212222210210211111111111a1111101101111112201112002a22b2022002222020210202111222111211010111111
111011011111111111111110011111111110b21220002111222222110102201222011120122112101111111100a1101111101112220220120211a22a2212212222212210211022121111110101100111
101111010100110111111111101111101110b20011011211221220022022212112201212021011211100111011a1111101111110221122101112b22b2122121122212111010122111012101111111001
111111111101111110110111111101011111a10220201112221012212220121112222220112110111111111011a1100111111112112220022122b12b1121000221121211222011211220111101101011
011111111011101011111101111111111110b21000022102110222222002222202121112001112221011111011a1011110110002110120211111b10a0100222222111221210222011221011011010111
111010011111111111111111111101111111a11200122221202122212222212222112001221121101111111101a1100111110110012112102122a22b2222200212202222022122121210111101111111
010101111101111111111101011101111010a10222122220122012222102220220022220212020111111110011a1111010011011222221122102b20a2222222220222201211221120111201111011001
111111110110111111110001101110101112a02122121200122010202222222102122011210202121111011111aaaaaaaaaaaaababbbaab20000a12b2221020222222102211021022110111111111011
111111110100111111101111111111111002b2101012212021222221201000202021120011201112111111111111111101101001212121a12211a20b0212221122202111200211111102010101110111
101111111111111101011011110101011111a2120112121111201200221221221111011111011101101111011110111111101111101222b22022a21b0102202111221111111111111011111101110110
111111101111111111110111111110111110b2011112112122111111222122021111101011111010111111111111100110110012220211a20210b22b2102102122100211011110111110111111010110
111111111010011110111011111111111010a2211212211022211120212222021210110111111111111111011111101111110110222120b11222b12a1022101002011001111011111111011111111011
110101000111111111111110110111100111a2120121012011021121002111211211110111010111111110101111011110111110101022a12210a21b2111210102112101111101011010111110110110
111111110111111111111010111111011012b0112122212111112121021020111111011111110011110011111111101111111110211212a10202a12b0021202221222211110011111001111111111110
111111110110100111111101111101111111a1011101111100110111011111001101111111111111111110011111111111011102001111a22222b01a2112210012112211100111011101101100111101
110111111111111110101011110101101110a0110101111111110111111011111111101110100110010011111001111111001111111011b01212b10a1210022121012011011011111011111111111111
111111111111101110011111111111100011a1101110111111011110111111011101101101111111110101101111111111111012020111a02221a21b2210222212101011111101110111111111111111
111111111001101111100111111011111111a1011111101111111100110111111011101011111111100111111111111101011112102112a22100a21a1122222111102111111001101110110111101101
111110111001110111111110011111110101a1111111111111111111101112211201122222200022012211010112011111010111222221b01212b22a0120022211010110111001011101111111011101
110111101111111101011111101111111011a1110111111111010111101101211112010122112112000101121221110101111112011022a22221a12b1222222221210010111111110110001111110111
111101110111011101111101111111011101a1011111111011111111111112212102121012012212211212011211110111111111121010a11211a11b0210010211121101001110101011011111110011
011111111101111011011111111101111101a1101101110111111111110110210110121221211201011121120111111010111101210021b21111a11b1022012021222200111111111111111110111111
111101011111110101111111101010101110a0011110111111111111101101121122120111212222112212112210110011101112212112a11120a22a2221011121012211111111011111101100111111
111011111110111111111111111011111111a1011101101111101110111112222112211001002220011221122112101111110112121102b12000a11a2210121011201101111101111000110111111011
111111111011111110111000101111111011a1111011111101111111011101201021020212122202011020122201001011011110111222a12112b12a2211111210110011111111111111011011111111
111111110110111011101111000111011001a1111111111111111111101111101120201002021120112101112212101110111111101111a00011a11a1111110101110111111111110111111011111111
101111111111110111111101111011011110a1110111110111111111000110112111111202111022011220211012111011111111001110a01111a10a1111111110010111111111111111110111011111
111111111101001111111111111110110011a111111011110001111011111111111111aabaaaaaaaabaabababbaaaaaaaaaaaaaaaaaaaaa11100a10a1110101110011111101111111111111111110110
111111111011111110111110111101100111a101111011110101010001111202021112a202022211102120221222111111100111111110111111a01a1101111111111111111011010110111110011111
111101101011011111111101111110111111a111110101100101111011011201211211a212002121212020012021101111110011110011101110a11a0111111110110111111111111111100111101111
111110111111101001011011111011110110a111111011111001011001010022010111b221110102011110012111111110101111101101011111a11a0011111011111101111111101100111101110111
111011111111111111101111111111110010a100110111111111111110111122221010a201111222212100112021111001111101110111111111a11a1111111011011101101111111011111111111101
111111101111100101111111101111101111a110111111111011001101111220212011a112211222121212212222111111111110111110111101a01a1101110101110111111101111111111101101011
001111110011011011111111111011111111a111111011110111111111101211221212b200222121202220021221111101011111011110111011a11a0011110110011111110111110110110111111011
111111011111110011111110101110110111a111111110111001111010111101121212a201021222220212111221110111110111111111111101a10a1110111110111111101111111111011110111111
111110100101011111111111111001111101a111110110111101111111101022001121b121111121212021111000110110111111111100111001a10a1101110111101111011111110111111110111011
111101111111111100111110111111101111a110001111110011101111111122210121a211011121111202222122111111111011111111111111a11a1111111011111010111001111110111010111111
111101101111101111111110101111101011a111100111101111110101011100120022a222210011211111111122111010101111111101111101a11a1111000111101101111111111101111111101001
100111111101111111110111111111110011a101001111111011111001111111211120b220112212002222121112111111100111111111111110a11a1111011010011111111111011100011011100111
011110111110111111011011111111111111a101111011111111111111111111021221a110012201202222021211110101001011111111111111a11a1111110111111111011111001111110101101011
111011111111110011100111101110111111a111111101101111101111111221111220a211011202221101222212110111111110111110111111a01a1111111111111110111111101111111011111000
001111111111111101101111001111111110a011111110100111111011111102122101a222020020202122020111111001111111111011111111a01a1111011111111111111111111111111111101001
001110111111011111110111111101101111a111111111111111110110111111122101b022011111111022121101110111111111111011101111a11a1111101111111010111111101110111111111111
101011111011011101111110111010011011a111111101111111111111111112221222a202201220102211012222011110110111110111011111a01a1111101111110111111010110011111111111111
001111111110111111111110110100111101a101111011111011110010111011111120a112021121000122020210111001111111101101101011a11a1111110111111011111011111111110111101101
101001111101111111111111111011001101a111111111111111111011111112000122a022200122211220212010111010111111111111111111a11a1111100001101111110111011100111010111110
111111111111111111111111001111110111a110111111111110111011111122212101b110111022222011100222011111111111111111101111a10a1111110110011101111111000010111111111101
111101101111111110101011111111101111a111101111011101111110111120101012b111212122220120111101111111101110110111101111a10aaaaaaaaaaaaaaaaaaaaaaaaaaaaaaaaaaaaaaaaa
011111011010111101111111110111111101a011111111011100111111101001002022b112220121100222110122011101111111111101111101a1110110111110111011111111111111111110111111
111111111111100011101100111110111111a011011011111101111111111111101000a100111011112102012211120212212121212201121111a1111110111010100011110111111111111101111111
111111111011111111011111101111101011a011101101101011011111111111101110a111011110112221211022011120112002122122121111a1101011111001101101111101111100111100110111
011111011010111111011001111111111011a111111111111001010011111111101011a111111111002021221220201111101121200111120110a0111011111110111111100111111110111101111111
110110111111111011111111011101111111a110101111111001111001111111111011a100101110112212222221200112202001220212112011a0001111111011110101111111111100101110101111
101111111111101111101110111111110111a111111101111010110110111111100110a110101111010120211111102121120200011112020110a1101111111111011111111011101111111111110111
111111110001111110111110111111111010a110101111100111111111111100111111a111111001111122121122001221022102211112012111a1111011111111101111011110110111111111111001
111111101101011111101111111111110111a111100011111111111011111111111111a111111111112220202221222220121221021111221110a1001110111011101111110111011111101101111011
111011111111110111111101010101110111a111111111111111111101101111100011a110111111102121221222121212120110222122210101a1111011111111111111111111101111101111111011
100101111110111111110111101000111111a001111011001101110111110111110111a111111101112111112011111211120212201222122111a1111110111110111111111101111111010101111111
110011110111111111111111111010111011a101111110111010111111011111111111a101111101110102021211020121211212112111011110a0101011111111110111111111110111111111111101
110111111111111111111111111101101111a110101111111111110111011011101110a111111111110010212122210001211122221210022101a0101111111110111111111111111111101011110111
111111101111111011111100111110111111a011111100011111111101111111111111a111110111101101202111121121101200211212110001a0111011111101101111110111111111111110110111
010111111101010111101111011111111111a011011111111101111111011111011101a111111110010121112111220212221101020101001100a1111111011111111011111111111111111101110111
111111101111111111111111111111111111a111111111111011111111111011111111a111111101110122111120201122112222200221210111a1111111111100100111111111111111111111111111
111111100111111110110101111111111111a001100111100111111111010011111111a111111110111202212120111222221102222222102111a0110111011111111111111111100011000111010011
101110111111111101011111011111111011a111111110111010111111110111110110a110111111101120120022120112221210011121101111a1011111101111111111111111111111111110111011
111111111111111111111111011111011111a111011010110110111111000100101111a111011111102122002212112001111211221021221111a0111001111111100111011111110111111111101101
111111111110111110011001011111111101a111111111111011111111111011111110a1110111111102122221111212aababaaabbbbbbbabaaaa1010011111101011110111100110001111111111111
110011111111110011111101111110111111a001111101111011111110011100100101a0100111111122212110211201a122121101022222011001111011110111110111111111111111110111111111
111111111111111011111100101111111110a111101111110111111111111001011110a1101111111122020120222202b112201222111022110011111011011111111011111111111101111101011111
010101111011111110111011101101110111a111111101101111001111111100111110a1111110110121122121012212a022211222121022011111101111011011100110011100111110111111111111
110111110111111111011011110111111111a011111111011001110001110111111111a1111111111102222010122102b021010211122220211110111111111111111111111011111110100010111111
111111000101110101111011011001111111a111101111101111111111111011111111a1000011011101122222012002a222221122110120011011011111111111111011111110111111011011100111
111110111111111111010011011111111111a011111111111111110010111101111110a1001111111111021220102111b102201212221020211110110110111111111111110111111111111001101110
111011011011111011111011111111101111a101111111110111011111011111111101a1011101111121202012212210b222112112012220111011111110111111111111111111111111111110111110
011011011111111111111011110111101111a111011101111111111110111011011111a1111111111012101011122110b111011122210111201111111101011111110111111100001011111111111011
111101111101011101111011101011011111a111011011011111111111011111011111a1001111011122121211010121b210120211101102111111111011100111011111111110111011111110111111
111101000101110111111111111011001111a011111011111110100111011011111111a1110101111122122101112212b211002022122222211010111101111110011111111000000111111111110111
011110111111110111111111110011111111a110110110111111011110111111101111a1111011110121111122010222a201221011022110111101011000111101010001111010101011101110100011
111111111111111011111111111111111011a011111111011110011101111111111111a1111111111121012021011100a210222102121200211111111110111011110111110111111111111111101111
111111111111111111111110111011111101a111111001111001011101000110011111a1101110111121202212012022a122021121212121211111001111101111111111100111111111110111111100
111111011101111111111111101101110111a111111010111111111111101011111110a1011111111100111111111111a101011111011101011111010111111111001010101110001101111101101111
101111111011111111100111111111111011a100101111111111111111110111111001a0111111111111111111011101a111101111010110101110111111110011111001101011101111111011101110
110100101111111111101110110111110110a010011011111111111110111111111001a1010111111111011011101101a111111011110001101011101111111111111111111111111110111111111111
111111111111111111101101111101111111a111110101101111010111110001101011a1111111111101110111111111a110111101100110100101110011101111111111101111111111101111111011
011111111111111100111011111001011111a101111110110111111101101110011010a1111111011011111011101111a110110101111111111111110111111111111011111111111011110011011111
011011101111101100000101111111110101a111111111111111110110111111111001a1111111011111011101101010a011111010111111101101001011110011110011001011110110111111111111
010111110111110111111101111011111011a111011001111111110111011111111111a1101111111010111111110111a111111001101111111111110111011100111011111110110111011111111111
