71 10
8 119
118 42
15 7
76 66
86 2
64 26
50 31
133 26
97 97

1201220111210122222122111002112111100111a01111111111110a11111011111111121020221212211221112201122202210111101011111a11111010101110111011111110111111011010101111
2210211012201100011010121112122111110111a11011101111101a11111111101101100111221122221112111012022112110111111110101a11111110011111111111111110111111011011111111
2221121201222200112211011100110011011111a11110110111101a11111011001111122121222212110111101121020112111111111101111a11111100111001111111111110010111111100111111
2012122110112211022212221121221111111111a00111111110111a10111110110110112111111221202021222021200122211111111111101a11110111101010111111111101111011111011111111
1221222122201012212112101101222001110101a11011110111111a11111111111011101211112221122121102222112121221111111110111a11111011111111111111111101111111111111101111
1102221011121210111121112102211111111111a10111111001011a01111111101011112220102110220221022222122210021111110111111a01011011111101110110011110111111011110111111
2021222000221222211112001122112111111111a11111101100101a11111111111111101101220200012112211220012221121011111011111a11011110011010111010011011110111011111111110
1200122112220122012012211111211111111001a11111111010011a10110101101110121122000121222111121221202111121111111101111a111aaaaaaaaaaaaaaaaaaaaaaaaaaaaaaaaaaaaaaaaa
2121122212122112201212102211202111111111a01011011011011a11111011111110122211021010121211102102111010111111111111111a111a1011111100111111111101111111111110111111
2121101110102212111111001221122001110111a01111110101111a11111111111101102012011220211110000020201200120011111011111a111a1111010111111111110111110110101011010101
2212010122212022110211001220121101011101a11111111111111a11011011111001101211102121121211120221120120121111011101111a111a1011111111101110110100111111110111011101
2111101212211202021212020122222111111100a01101110020212a12212202211222002220122221122120120211121111220111111111101a111b2111012111202110022002012100201011111011
2202111121222121102022000002221001011111a11001001202121b00212210202111120021222212112012221202221001021111110111111a111b1220201111222201212102122112111110011111
1212121210220212122201222222221111111011a10101111102210b12121221111002202202201222212120211210202100001111111011111a110a2221112121221222201112122202101111100111
2110120112111120122222112121111111101011a11011111022122b21110001012110021022222221200022221111001120111011111011111a110b2022202010122211111212120020211111011111
0122112221111202210221112120201111110011a11011111202120a22221112112121221222222211222022222122212222111111100011110a110a2112201212201010211101110212210111011111
2122110201122012200121110002221010121122a12212210222122b21222020012101110012222221021002111102112211111111111110011a110b2022111200021101102101012010201111111011
1112120120220001110122112222110111121211b21220121120222a20212112021121220202211222210100211020111211211111110110001a111a0102110111100222012222212120211101111111
1112221211102111022210112010112111111122b20212022022222b22102112201212222202221111222112022011221222111111011101010a112a0220100122210112221222211122201111110111
2122111122222112101112221122211111122010b01211211022222b22221220002012202022120210101022120122222221021111111111111a110b1022111120121011101221201111011111110111
1221221121012111110022211102211100021112a22211022221012b21111222022111211022220010110101210202110112220001101110111a110a1110112021102210201012022212001101011110
2222101121102210111211112121222011112212b11120111202222b11202221001101122022220002021122210101212101221111111111110a110b1221120221111101122212122010111110111111
1022212121212211211111101220202101121220b10212110222222b02220012202221202002212201110011220201112211120111011110001a101b1111212212102102211100021122011011111111
2022111122210122121122202112111011112211b22222100212221b02222222222202120222220221212221111112212010210101100111110a112a1211111121112122002222122102011110111111
2121211222011111121202102101001101022001b21211102210202b21002022122122222220012222122122011200111212121111011111101a111a2122100120121222222122211202211111111101
2111222111121021121111212120212110121020a11222111020202b22221212222122101201120012112112021221122211211111111110111a110b1120020221221221012222111100211111111111
1112200122000122110201211201222011112111b21112220112102b21122022220201122212212021002102220211112120210111111011111a110b1201112120212222120111211111001011111101
2102012010211201021121111122112111021211a00010010212222b21221221222120020002222212112112001220222112211222200112211b222bbabaabbbabbbbbabbaab22202212210111111101
2112020122110022011022101212212111102212b02201111002020b01211222211212222221222010222002121221121022221212220111022a01221212021112222112122a10211222011101011111
2200122221211201122122112210122011111201b22222111021022b21122221221122201210222012201220022202001201121222211211011a01211202212011220011022a22122202211111001111
2122022212112222111021010000122011102110a02212122102121b22002020022122210222222021111202222200022111120121020211010a12022022000212212200011b10122200211101111101
0111101111111101111111111111011111012211b01221112220220b11202222122202202122210110111111110111101101111212202212022b02020220201020221211202b20222122100111101111
1001111011111111101110011111111111120000a12111111110022b22102222222022111121211111101011111011111110111111112212120b11201021101221002022220a01002002111111111110
1110011101100001111110101111111111111220b01121201222202b22221212201220121102121101011111111111111110111111102222111b02202122202122122221102b11221222011101100111
1111111011111111111011101011001111121221a12120102002222b22221211220122120222211111101100111011011101111022121211001b02221120212212222201121a02121121011110111111
1100111111111011110011011111111101111110b20002121222211b20201200122220212220112001111011011111111011111010101021121b00022212222122021212101b12022101110101110110
1110101011110110111101011101101111111221b21112202222211b22022022000022211102021011111011111011111111111211112021211b01102020222220222210120a21100121111111111111
1101011110111001111011001111010111101220a22120121222210a22220222221220002202111011110111111111111111111021110112202b12210212222022202222211a22211100110010111111
1110111011101101110111111001101101121022a02111011211122b22212022202111221111201211011111110111101100111222212211112b10022222222222022211112a01211011211001111111
1101111010111111110101111111101111102211a10211112211210b11212222202112222210210101111101111111111101110212102211011b22222020221020122202121a21020112211111111111
0011101111011111011111111111111111120200b01120011222122b22122022221212220100101211101110110101011111111111220122010bbabbbbabbbbaabbbbbaa202a12111101111111111110
1111001111011111100111111110111111111201a12022120212202a2212212202212122002021221101101110011010111011100210202212022122022212222210121b222b02110120111100111101
1111111111111111010111110111111110110102a21220201122002a0202201012101111110110111011101111011001111011111222120221011111102011121221201a111a11101110111011111111
1111111011011111111111001110011111111111b12021211012221a2201010221111111011111100011111101111011011111101121120210121221211012011210201a011a11111111111011110111
1111111110111111111111011111101111102201b12121111210111a1122011111110111111111110111111111111111011111011222021121111002110211221111221a111a11111111101110111111
1110111011101101101011111111111101111120b12021011212121b1200201211111111111110011111011110110111111111120020211011122110122111210111110a111a11101111110101111001
1111111100100011111111101110101100122210b11212001220201a0112222011111101011111111111101100111100011111102211112101221112120201022012221a110a11111111001111001111
1111111101111111111111110111111011101011a11111110111110a1111111101111010101111111011010111111101111011122122212121102221011122211012011a111aaaaaaaaaaaaaaaaaaaaa
0111111110101111011111111011111111111110a11110111011000a1111111111111111110111111110111111101111011101122212010121211210100222222211010a101111111111110111110011
1111001111111111111110010111111111101001a10110101111011a1011111111111111111111111011101111110001111111122222112011001201202201202121021a111111111100101111111111
0011010111001010111111111011111111111001a01110111111111a1010111111101111111111101011011011011111111111112221122102222200122221112202121a111111111111010111001110
1111011111111111101110010011100011111011a11011111111001a1001021200010121221001122021201101121111111111111112211212121121010122101202221a011011110010011111011111
1111111001011110111110101110101110111111a11110111110111a1011121122121202102020112222021111021111111111111221111102112012211201021211111a110011101110111011011111
1111110111111010011111111110111111111111a11111111101111a0001122210111222120221221112211010221111011111012201121222201022212011211012121a110111111110111101111110
0111110000011111110111101011110111111110a01111111101100a0110102201101121022222212222112202111111010001122102122110212122220122221010221a011111111111111011111011
1110111111110111101011111011110110111101a01111011111110a1111111121220112210221222022201110221111111011121102121222222212022122202111211a110101101111111110101111
1011111010101110011111111111101111111110a01111111111111a0111122110212102221200222110022221211111111001121211112222121112112220201221021a001011110111011111101011
1111111111100111111111111111011110111111a01101111110111a1111011222220122102212220120102121011111011111122111122120122222121222122222221a111111110111011101111101
1100111011110111111111100111111111111010a01001111011011a1111100002110101111011211121102222121011111110111111111101111111100111101111111a110001111111111100111110
1000111111110101111111111101011011111101a11111111111111a1111101221201212101121101202101110211010001111111110111111111111111111111010101a111111011111111101110111
1111001111011101100111101111111011111101a11111111011001aaaaaaabbabaabbbaaabaabaaabbbaabababbaaaaaaaaaaaaaaaaaaaaaaaaaaaaaaaaaaaaaaaaaaaa111011111111101111001111
0111111111111111111111111111110011111110a11011111111100111110112011111012121022211112120122111101111011111111101110110110100100011111111110111111110011111111111
1111111011101110111011111111111110011111a11100011111101111111112012122012021021222211022211111111011011100011011011001111111011111011111011111011111101111001111
0111110100111111101101111111110111111110a01011111110111011111021220020111222221211202012121111111101010111011111011011111101011101111011101111110111100111111111
1011110111111010111110111011011111111011a01100110011101010111220112002001112222221122022022010001111111010100111110011111111111111111011111111101111111111001110
1010111011111111011011011111011111101111a01101111111111111101111022112002220212211102122020211111111111011101111011001101111110011111111111111011111111111111101
1101111110000111111011111111101111111101a11110111111111011111210221110112220121112122221111111111011111111111111111111111110001111111111111110111111111111011110
1100011111011111101111111101111101111111a11111111111101011111212121211121202121212120101201210111011101110101111011111111111111011100001111011111111111111100110
0101110111111111111110111101111111110101a00111111011101111111100012022210211012110110222211111111110100110110101111111111101110110101011111011111111010111111111
1001110111011111101110111110110111111101a11011111011111110010122222222211111112001022111112211011101101110101100111111101011101111010111110100111111101110111011
1010011011011011101111011111111111111010a11001111111101111011110110211212022011121120110201211111110101111111011111011111010111111011111111111010110001111111111
0111111111111101111111111101111101011011a11101111111111111101002211012222101211201211201022211001111001000011111011110110111011111111011111111111111001111111111
aaaaaaaaaaaaaaaaaaaaaaaaaaaaaaaaaaaaaaaaa10101101011111110111201121120110122222211122212121211100111011001110111111111110111111101111011011001111111101100111111
0011011111111010111100110111111110011111001101111111111101111121122221202120122222002021220010101111011110100111111111101101111111111111101011011111101111111011
1110111111111111101111111111011011100011001111111011111111111201002111201212122210012122122011110110111011110110111111111111110011011111101011011101111110101001
1011110111101110111100101001111111011011011111110011001111110012210222221122112122001222222011101101110110111111111011111111001111111110111011111111111110111111
1111111101111111111101111001111111111101110111110111101100110122212201112210202220122022222201111011011110101111111101111011111111011111111111111110001111111111
1111111111111111111011011011111111111100111111101111111101111011210211202201011211221022221011011011111101111111101111111111011011110111111111111110011111111111
0101111101011111111111101100111101011111101111011101111011111212112222220202222112121222212210111111111111110111111111011010101011101111111101111100101101011011
1111111111011101110111111111110110110111101111111010010110110221121220012220122122010022101110111111011111011111111111101011001111110111111100111111111111111111
1111001101010011111111001110101111011100011111111010100111011200221211221002111101112110122211101111011110101011111101111111110111111111101111111111111100111111
1111111111011111111110110111111110111011111011011011111111011021011022221120111112211120202011111111111011110001110111101111011111111101111001010001000100011110
1111101011101101111101010000101111111101110111011110101111101101111111111110010101221221101112101111022121022021201111010111100101111100111110101111011011110011
1011011101111110010111100101111111011111101111011111110011110111101011111010110101112011110110222220210120210210211111111011101111011100011011100010001011001111
1110011111011011110111101000111111111011101001101011111011101011011111111111011111212111212112221101110212201120000111011111110101010111011111111011101101111111
1110111111101100111111001110111110110111111011101111111011011111110111000011101111022001211220111122111121212122111100111111111101011110111110111111110011101011
1001101111111110111111011111111011111111111111111111111111111101111111100010111111102022222220210022112221200211111111100111101110111111111111011111111111111011
1011111111111111111111111011110011101111110010111101111111101111111011111011111111112011011112121122020111222111011111111111110110111110111111111111111111011111
1111011101011011111111011111101111111001111111101111101111111110100011010110001111212121022122111212102100120020211111101111111111100011110111110000101111101101
1110111111111111111101111101111101111101111111111011111111111011111111111001111111220102111222021121221112211121011010111111011011011010110111101101111110011111
1110000111111010110110011111111011111110110111110111111111111001110000101111111111121220021220212212120122021220111111111111110111011111111111011111101111111111
1001111110111111111111101111111110111101110111110101110111111101110000111111001111122022222210211222112102122012101111011111100111111110010111111111110101101111
1111111111111111111111011111101100011101110111110111101011111111110111011111111111120200102220210112211011201011110111011111001111110111111111111111111011111110
1111111011111011111111111101111111111111111111111110111101011001111111111111011111111210222221021201110101101121111110111101110101111110011101111110111011111111
0011111111011101111111011110111111011110111111011111111111100011111111111111111011212202012012122222120102120211101011100111111111001101011111011111010111101001
1111011101101011111110110111011111111011111111011010111011111111111001111101111011220111111201112121211110121222010111101110111110111100101111010110110111011111
1111111111101111111111101001111111111101011101111111111111101101101111111111011000211211110201211200200222202220211101111111110111000111101011110111011001011111
1111111111111101111100111101011111101111111110111111110011110111111100111111111011221121120222210222110122212112211111110110111101101111111111101111101011111011
0111111111111111101011111110101101001111111010111111111101001111011111111110101111111111220201121112220221211212111110110001111101111011100101111111001110110101
1111011111101110111111111101111011011101111110111111111011100100111111110111111111012211012222212011012110021221101110010111011111011011111111101111111111111011
110011111111010111111101111011111111111aaaaaaaaaaaaaaaaaaaaaaaaaaaaaaaaaaaaaaaaaaababbbabbabbbaaaaababbaaaaabababaaaaaaaaaaaaaaaaaaaaaaaaaaaaaaaaaaaaaaaaaaaaaaa
111110111101100111111111111110011101111a011111111111111111111101110111011010101111221200121110101111021121112112210010111101111111111011111111111110001111111111
111111110111011111111011111110111111110a101111111101111110111111111101111111111110121202220111111212221212122002110011111111111101111111111001001111111111111111
101111110111111101111111111111111111111a111111110011110011110100111111011111111110112221122121221021111222111120111111111111111011111110111011111011011011111110
111111111110111110111111101111011110111a111110110111111111111111111111111111110100220102000001221022212110211201101011111111110111111111101111111011011111111111
101011111111111101111111101101111111101a100011111111111101110101011111110011101011212211121221011012122111012111111111101111011110011111111111010111111111011111
111111111110111111111111111111010110111a110111011111111111111011101111111100110110221101002220212212122221210011111100111101111011111111111111110111111110000001
111111111011101111111011101111101101111a011111111111111111111111111111001111110111121012112200010121010002211212111101111111011111011111111101111111110110110111
011101110110111101110110111111110110110a111111110111111111111110000011011100111110122021011212000221222101111200010011110111110110000111011100110111111101111110
111110011111100111000111111111111111111a011111011111011111011111110111111011110111111121212211110012211210121221211111111111111111000111011111101111100101110001
111111111111101111111101111111111101110a101101111011111101111111111110011111101111021021012210221112220211020112211111010111111111111110101110011111111111110111
111011111011101111111111111111111111111a111110111111111011111001111011111111111111201121211212222220212022112212211011111111101111111101010111101101111110011111
011011111110111101110110111111101111111a101111001111111111101011011111001111111111101122211120220221201212121111110010101111111001110011111111011111101110110110
101101111101010101111111111111000111111a101101111011110111011001111111111111111111101111111011111011111110011111101101100100111100111111111111111011110111111111
110110101101111010101111111110111111111a111111111010110111110111111111111111111111111011111111110110111111111111010111111111111111111111111011111101111011111011
100101101011111110011111111111111111101a001111111110011101111110110110101010111110111101110000111111110101111010001111111111110100111111111111011101111110111101
011111111110111011101111111110110111011a111101111111011110101110110011111111111011101111110111111111011111010111111111010111111011111011111111111111111011011111
100001111111111101111111111111011111100a011111111111111001101111111111111111111111001111111111101001111111111111111111111111111111111110111111011110110111111011
110001111110111100010010110111111111111a111111111111111011110110011111111111101100111111111111111111111111110111111011101111111110111111111011101111101111111011
111110111111111011010111010101110111110a110010111101011101101111111111101101111110111110001111110111111111111111110111101110110101011111101111101111110111111110
