71 10
8 119
118 42
15 7
76 66
86 2
64 26
50 31
133 26
97 97

2100001221020221211220222222102111110111111a1111111011011111101111011111121200111b2220211222222102101211111101111111111a1110111111110111000011110111111111110111
2120101222221202202121121202121011110111101a0111010101011110100111111001112111211b1112201112211111211111111111111110111a1101101111111111111111110110111011111111
2012100212210211202022211222012111101110111a1111111111111111110111011100112122002b2221210212212220211111101110111011101a1111101111111111011111111111001101111001
1221021222211122012212021011121011011111101a1101111111010111111110100112121120221a1011102112111112220111111111111111101a1101110011110111110011111001110101011010
1111101222202120110220111222221110111110111a1011111111111111111111111112022022221b2122012022021210211111101111111111010a1110110111111111110110110100111011111111
1021011111212220111020100020211111110011011a1101101011011101111110111110221112222b2201221221122110011111101111111101111a1111101111111111101010101111111011101111
2222022210212111212110020221212010111010111a1010111111101101110111101011111012001a2011122012211112222111111110011111111a1111111110101010001000011111111111011110
2002221011122122220222111121112111001101101a1111111100101111111001111111221102212a2110111212121002212210101111101101010a1111111111101111001111011111111011101100
2222202100111111111120110122111110011111011a1111110111111111111111110112110201200b1011212220002210222201101011011111011a1101111111011011011010100101111111110111
1122101221211111200222000222210011111011111a0110111010110111011101111112021102122a1201211111101021101211111111110111111a1111111111111101010111101111011011101101
1212001102111112001112111020121101110111110a111111010101101111010111110P022222200a2100221212211221112001111111011111111a1111111101111110111111011111110111111111
2101211222212211112101122122202111111101111a1111122220220112201111112011P20022122b2121020101112111122201110011001110110a1222202020122202121111121002210101101111
2111120122122011112121212221102011001011110a11111221120100222221110222102PP221020b1202222112012121022011111111111011112a1211111011210111210122121112101110111111
2020112012112022212012120222112110111110111a1111111102111220122211211212222P22121a0212221101221012112010110011010111112a1221111211001122211102120000111001101111
2120220112121102121110200101002110111111110a11101110212102122020021021221222PP220b1222102110112222121211011111101111111b2220122222222221101122211102111111101111
1102222221120222122011222211000100111101001a1110102221121211121111122212221022P21a1121010212121212021011101101111110112a0212221211211022111110111122111111111111
1122121011222210122121220111212111112111011a12110220222221112222200120202122211PPa2222122202121221221111100111101111110b1111202012221201121122200220111111101110
1011222211222222112000102112222111021112221b1221222222210022221220112021220220212P1102211201112000201111101111111111111a1222220011012211112222001121211110011111
1211202001112222111122122222011111021201121a1212022022011022222122211122012112220P1212100201011222112111101111110001111b2110211222111110221100102102101011111001
2122221022121122012211111222221110101111101b0212112222201220222112222110112212012P2212210221121111221111111101111101112b1002001211120122221112102112211111111111
abaa110112101100021212211211211111010121211a2201002202212021221222122111120202222P1112221121112011110011111111111110112a1111110210102012101201222210201110111111
212b011002210122222120111011012100101221112b0011020112000021122221112202222222202P1222122201202112210111111111101101112a1222102111121021122222200010110111111101
121a212121220221012100110122210010111221212b2221120220222220221122002212212222210P1212211102202012011201001111110111112a0221221112012121202122001220110111011001
011a220121102211211211121101012111121201211a1212212120221202022221112112122011021P0222011120011112022011111101111111012b1102222102200012102201221212201101000111
212a221001202211120002211021212111122110212b2121122222210221012022222122122122210P0021121121211100122011111011111111102b2112021201121121001220111022010111111111
222b121122222111112111220211122111122101220b2220112222022012020221002212222020122P2122212121121120221011111111110011110b2001122221210012102221002101111110000110
112b111022120121222102111112212111112202221b1100122022222102222212212122201010021P2122111211111222222110010110111011111b1111122200221202021212100222001101011111
212a011110022201222121022002221111102202222a1122212222112200220222112210220221102P2221200112122111121210212012121112221b2122122022022221201122201111211001011111
221a202220021202012221111211121111101120121b2210122102222121202222220012212012211P0220120212101111010112110221112020002b2222222102222212011121222201211111111111
002b022212112110121211211211222011012122120b2221212222221202222221112101122002210P2211221221212212120211202122102211012b2100221212211112111aabaabbaaaaaaaaaaaaaa
101b202001011222121212222222121010121211212a1211202211222200212202201002100201021P1112112221100220112212110221222202212a1122202210020112101a01012102111111111011
110a011111101111011111111110111101121112100b1200222222222222121210112212122212011P1111111110101111101112022012110002122a0200202022212202210a02120020101111111111
111a110111111111010100111111110011111100212a2121102110112220212022220112222112121P1110111111110111011112222122122112221b1102222212202222021a21112012211101111101
111a111111011111001011111111111111112001101a0211112211221122222222010211000220101P1111111111101110101112011112111002110b2100222200100220101b12220002011001111111
100a111011110110110110111101111111112000011a2112220022111112201212222222022212010P1111111111111100011111120202011202022a2222021212222121111b02211211210111110101
111a111011101111111111110111011111011120122a2222220222222210212022020222112202101P1110110110111111111101211111101021101b1110222221221212222b01211212211101001101
011a011011111111100111101111101111122021212b1021122011201202002122122202211112201P0111110111111011111112011101112211200b1222201200012222010b11212101110111011110
110a111111111111000101101111111110022221112a2111122102202121221221112212210212001P1111111111111001101112211110122211100b0122112221210220111a20111121111101111011
011a111111010110101011111110101011112121221a1122002222221221020221020001110220011P1111111101001110111111122012122111112b1120112122222121010a02121221110111111111
011a111000100001111011011111111111121121020b1120222222222121121210120212111201110P1100111111111111111102211211112211221a2202111222022012202b02210112211011011011
011aaaaaaaaaaaaaaaaaaaaaaaaaaaaaaaaaabbabaaa2111022222012122012020222112221111010P1111010011011111110100112110010121212b2012212022222011011b00222022110111111101
111111011101101111111111111110111111122111210010010112220022022212211112211012021P1111111111111101010011122110122112122a2100222222212102211a11102210211100110111
011111111101111011111111111111101112021112220021011120022101212100111101010111110P1110111101111011111112211021120222111a0111111121012001111a11111101111011111111
010111001101101111101111011111111112212211011211012120112002201202111011111111111P1110111111100111101012212111102221211b0221121212211111110a01111111101011011111
111001101111101111111110010101000102021121212010120212211122112012111111111101011P1111111001011111001112112101222100200b0101120212102210111a11110011010111100111
111110110111111111111111011011111102211211021110011120211221211010111010101111111P0111001111111111111112011220202102212b1020211111010210111a10111110111111011111
001110111111011111111001111111111102101222121122212111110010022212010111100111101P1111111101111011111112122101220022221a1020011021102211111a11111001101111111111
101111111111110111110111111101011011111011111010001111111011111110101111111111101P1111111011110111110111122122110022221b2122212121221011101a11111111110111111111
101111111111001111101111001011011111110111111111011110111111111110101101110111111P1011011111111111011112101222101200221a1121220122210111010a11110101111001111111
111111111111010111111111110101111111011111111011111111111100101100111001100111110P1111111111111111111112110121110210222ababbaaabbabbabaaaaaa11111101101011101101
111111011010111111011111111111111011111101101101111111111111111101111111110111101P101111010111101111100112111210201122101111212011201211110111111101110111011011
111111110111111111111111010111100111111110011110110011111111112112112112121221212P112211221111111111101100020211101220211201212102102211001101111111011110110101
111110111111011111111110111101111111111111101111101100111110111201121110102122101P012222212201110111001011202022221111011101201111201201111110011111111011101111
111001111111101111111010111111010111111111101111111101101110101112122001122221021P222121222111101111011202222212222122221100111110110211111111100111111011111111
101111011111111111011111110111111101011101111111011100111111111111110012211120112P200002002111111111111112120220112210202012222212202011111110111111111110111111
011111110111111111011011001111110011111111011010011111111011120212010110120222022P101212110011110111111102012001101200212122221022200111011111111111111110101110
000111111000011111111001111111011110010101001111111100011111021020022211221112011P112021120211111111001201112012121121112202112111221010111111100111111111111111
100101110111111100111110111111001111111001111111100111100111112121122110100212021P212221120211110101101121112222200210100222012112222211111111001001111111110011
110100111111011011111101111101111110110111110111111111111011122011210122220222210P012112001111011000110111111101111110011111111011111101110111110111010001111111
11001110011100001111110110111100010111101aPPPPPPPPPPPPPPPPPPPPPPPPPPPPPPPPPPPPPPPb110122212110111111010111111101111111010101110110111111110111111011110011110101
11110011110111111111101111001011111111111P0111111111111110111212200112011011112002221011220101110111110111111111101110111111111111111111101110010010111111111111
10111111001001111111101111011110111100011P1111110011101111110002211200102220021112121110212001111001111111110101111110111101110111111100111111111111111110111011
11111101101111111111101011111111100111111P1110111001111110111121012111001001221101122211112011010111111111111011111111111111101111111001111111111110111111111111
11111011011111011111111111100111111111111P1111111110111101111121221111212121020120122112212111111011101010001111101111011111111110111111111011110111110011111011
11111011011111111111111111101111111111111P1111011100001100111221212121021021122002220021011111110111111111111111011101110010110111111111101111111111001110101011
11111111001111111110111101111110111111110P0011111110011011111122011111111020002102201202121111111101110001111011101111011111111101110111111111011111100110011111
11110001101111111111111101111110101110111P1110111111111111101122001101110111100221102112201010110111001111011111111110011111111101011111111111111111011110111111
11111111111111011011111111110111101111100P1110111110111101111101211012112112200210112122200110111111010111111111111100111110011111100110111111111111101010011111
11101011111011011111101111011111111011011P1111011000011111111001021022110112200011010101122110100111111111011101111001111111111111011011111101111010111101011101
11110011001111111111111011110111011111110P1111111101011101101000022211122211122212112121222201110111111100111001111111000111111001110101011111111011111110101101
10011111101110101110111111101101011111111P0111111111110111101111222112210221010221211201222201111110111111011111110111111100111001110111111101101110101110111110
00101111111101111011111010111111101101101P1110011100110111111122001222111021101211111201011210101100111011111111101110111111111111110111110110111111111111111111
00101001111101011101111101110111101111111P1101111110100011111211121212222111101200211211012010111111111111011100010111111111110101111111011001101111000110111011
01111010111111111111011010001111011111011P1111101100101111011200202212111122121122111121202211111111100111111111111011111110011011100101111111111111110110111111
11011101111110111111111111011111111101101P1111111101001111111121221011212011111220210010121211111111111101110111111111111111111101110111101001111011111111111111
11110111111011111111110110011010111111111P1110101101110101111001221022022001112211020120221011110101111101111101111101111111010111111111111011111110000111011101
00110111101111011100101101001111011111111P1011101111111111111211121110110111222212222212221111101111101111011111110011111111111111101011100011101011111111111001
11111111001110111111011111111111101111111P0111111111111011101020022011212221111101121201102210011011110101111111101001111111111111111111111101011111111111111111
11111111111110010011011111111100111111111P1111101111100101111022120201101021122201211022211101111111110011110111011111011001100111111011111110111111110111011101
011111110111111110111aPPPPPPPPPPPPPPPPPPPa1110110110111111111212012211012111221011122112012111101001111111111011111111111111111010111101111111111110001111111100
111111100011010110110P110011011011111111110100111111110110111021121102112121201221012220121111101111110101111111111111111111001111100110111101110101110101111111
111101011011111110011P110111111111110001111111101011011111111201110212211122201021221120112211111101011101111111111101111111111011111010111001111011101111111111
010111111111111101111P111011111111010101111110111111101101111111111101111111100111111012111101122212112012222211211101111011111111111011011110111100111011111111
110111111011101111011P110111111111111011011111111011111111011111111111111100101011220202012021211012111111020122111111100010111111111101101111000111011100001111
111111111100110110011P101011011111111111111111110100011101111111000111111100111111022110112112122221112212101021201111111111111111111111110101111101001111111101
111101101011111111111P110011111111111111111101110111111111111111101111111111101110101120221212110122112121220022101111001111110101111111111111100011111111111111
111111010101111101111P111111111110111111111110110011111011111111111111101100101111212220211022122122121122222212010111101001111111111101011111111110111011111110
111010101111111111101P111101011111111111011111111011011010011111101101110101111011121111122110222102100210222112200111110111111111010111101111111100111010101111
110101011011001011111P111111101111111111111110101111111101011110011111101101111111110221121000211021121111221221111011111111001011111111100111111111111111111110
111111110111010111101P111100111101101101111010110110111111110010101111111011111111010011022022211110211021122110211101111010111111111111111111111100111110111110
011110111111111101111P110111111110011011111011011111101111111111111111111010101111112201211121100122021222112112101111111111111011110011111111011111111011111111
111101111111110111010P101011111101111111101111100111100011101110010100111001100100210121200200011112101122120221201111111001111111010110011011111101101010110111
010011110111110111111P011111111111111111111101111101011111101111111010101111011001120020102112211221022121101200111110011101111111011111111111011111111111110111
111111011111111101111P111111111001111111111111111111111011111111111001110110111111222201112221022210111011011120011100010111110101111111011110101111101111111101
101101111111111110111P111111110110111110111111110111011111111111111011111111111111112100120202122212211102011110101011010111110111111111111111011111111111111110
110111111111111101100P100110001111111111010111111110110011011111011110111111111110110211212112110222221020210111111111111111011111101111111011111111001110111111
111111111101110101111P111111101111101011110110110110111101111111111111111111001111000122200212202121211211212122201110101111111110011101011111100011100111111011
101111111011111011111P110111111111111111111101101001111110111111111111111110111111022121011112000211202020111012011111011111111111011001111101111111101111111111
110111111001111111111P101111110111111111101111101111011111111101111011111111111110222200022122111111211221102202211101110111111111111001111110100111111110111111
111111110111110101110P01110111111111011111011101101011101101111111aaaaaaaaaaaaaaaababaaaabbaababbabbbabbbaaaaaabaaaaaaaaaaaaaaaaaaaaaaaaaaaaaaaaaaaaaaaaaaaaaaaa
011111111111111111101P11111111111111111100011111111111101100011101a111111110110111220202212112211201102111201210211111101111010110110101111011110111110101111110
110111111101000111011P11111111111111111111111111111111111111101111a011010111110111022212222011221222222111202220211110100111011111101100111111101011111001110111
111110111111101111111P10111101111111111111011111110111110111111111a110111111101111112210112212011122220111210220011011011111101011111011111111111111111111110111
101111011111001111001P11111001111111111111111111110011011111110111a111111011001111210121102111201111122220212211210111111101111110011111111111111111101111111110
001111110111111111111P01101011111010101111111111101101111111000000a100111110111101202002222202120121212011110210011111111110111111101111101111111011110001011110
111111101111111011011P11101111110111111111111011101011111110111111a111111111101111020102120212022222211122202111111111110111111111110111111111101011111111101011
011110011110101111001P10111011110111111111111111111011111111110111a101110111111110112022010022012110001112212202201111111111101111111111111111101111000111111111
101001111111111101111P11110101111111011111101111011111111111111101a101101110111111102221011222110222212121101211101001111111111110111111011111111111111000100111
111111101111111110111P11111011101111111111100011111111011111110011a111111111101011002021221211012210110210222022210111111001111111011011101111110111011110011111
111110110100110101011P10111010010101111111111111111111110111111111a111111101110110222102112100101012202111112201211011111111101110111111111111101111111101010111
010111011110111011111P11111101111011111111110111111111111111111011a110110101100110222221211021221220222021022221210011011111111111111111110111111101010111111111
101111101111111111110P11111011011111111111000111111101111010101010a111111110101011121221011202220210110201212211201111111011111011110011111011111011010111111111
111011111111111101111P01001111111111111111101110001111111111111111a110111101111011102220212212002221210102110121211111110111110111111111110000111110011111111110
111100111111111011101P11111111111111011011111111101111111011110110a111111011111111111111111101011111111111111111111101010101111111101111111111110011111110111111
011011111110111111111P11110111110011011010100111101111111111110111a111111111111111011110010110111011101001110111111111110011111111111111111101101011011101111111
11111111111111110PPPPa11101101111011001101011110100111111101110111a111110111110111101110101111011100111111111110011111110111110111111111111011110110111001110111
11111110010100PPP1110a11011111111111100111111111111111111111101110a101011111111111011110111010010111101010111111111111111111111111111111111111111001111111101101
11111111111PPP1111011a11101101111111111011011100011111111111010011a111111110110111011101111011111011111111111111111110111011001111101111110100111011011111111111
1110011110P1000011101a11111101111111111110110111111111101101110110a111111110110101111111011110001001111111111111111100111101111101111111001111111111111110101111
11111110PP10111111011a10111110111100111100101111111111101111111111a111101111111010111111110111101011110111101111011011010111111011101111011110110111111111110111
