11 33
155 80
118 42
15 7
76 66
86 2
64 26
50 31
133 26
97 97

110212211200202121122110210102111a11111a01111111011111101110111111111111112122201011222221a1101101222111101111a1111101100110111111110110101111111011011111110110
012112000221220122110112221112211a11111a11110011111111111111111010011110102112222021200201b1021210021111101101a0111110001111111110110111011101101101111111011111
211212012200211222020001021100101a11111a11011011101111111011111111110110111211121220012112a1201002101111111000a1011111111111010110111111111111111111111111010110
101112201202122012200101011121211a01011a11011111011111111101111111101112211202212102110111b2110221022201011110a1111111110111101101111011101110111110011111101101
210211220100210022121121212111111a10101a11111010111111111011101111111110221112121210112220a1212211111111011111a1111011110111110010111111110111101100111011101111
222121112112221011211111201211211a10111a11011101111100110110111000111112210122000021222011a1111200011111111111a1111111101111110110111111111111111000110111111111
110220211102211222221111201122111a11010a11101111111111101111101101111110222222202211222101a1122012022111011111a1111111111111110111111111101101011111111111111100
021112211122012122220120112022210a11111a11111110111101111110111011100001222201222220012210b1100112200201110111a1111111111011111111111011111100111101101111111111
202212021102110222122220011011011a10110a10101101011111101111011110111111100211221022021021b2111101221011101011a1011111101111111111111101011110111100100001011111
122211110020211222122121211202111a11111a11111111111111011111111111001101122111111012222111b2100211211211110110a1111111111101111101111111111110101111111110110111
222022121202002211212111100121110a00001a11110011100010111111111110011111221102010012121211b1122222110211111111a0000110101111111101110011110011111111011110110111
022211012110201202110201212220111a11110a11110010122001122122122221120021122120122112022210a1112212022210111111a1111110122210122112011022020221211101201110001111
222012011122122222212211202112011a11101a11111111011021100101111200111112222202201201121101a2112221212211011111a1011101121011022220022112221100201221111011010111
112111202121122102210211212222111a11101a11111011111122110011211122212122212001222210220112a1112021020211001011a0101111211112002221012101221121022010101111011001
021222102212111221010012021121211a11100a11100111121222021110121111002001211220220221001122a2221122212011111111a1110111102120221111212221121221201212111111111101
121112021210021121112210122121211a01110a11111111121221222110121021210212102222202212112110b1111101121110001000a0111111120001110112111012112110010112210101111101
111101012110222111101120120212211a12101a11021112222220222212122122212211122222121022221210b2101111210010111111a1110110221120120122121111122102211022210111111111
112221122101011000221002121212111a00222a12220022102221212022022022102112022220210002022201b0102021022110111111a0111111121222222100111121012212020121101111111111
110122212011121112211121221122211a11201a12110221022221021222202221211010222001221222101222b1102111111211111111a1111100211012212222212221111011021000101010010101
010121212202222121211022012112100a12201a21022222121122212122202212222121222100202110121111a1112201101211010110a1111111022112212121101200021020011212211111111101
222000112010211000122220111011110a02221a02211212202002220000202022122222212222220220200211a1212120200211111101a1111011101010222211101102022202021210111111111111
111211101211111212102020112211211a10111a01112111002120022220022222201220122211221112200211b2011112211101110111a0010110122212012222121111222200112021211101011011
021112221121101122222210001121111a12012b12211212122221210122122222201221121221201111102122b2100212022111111111a1101111222220212121212121221002210112101110111111
021211111220221221021200111112211a11110a00122020200222102202221221112020010222222120221222b0111211102210111101a1110101222222102120212210211212111111111111011111
222220101111122201212112111200110a12121b11121122220222020002101201221012222200221100102112a1122111221111111111a1111111200102122211221000120111111211110111111101
211111202011022222212221121220211a12022a20200100112001200220020112211112210220201121202211b2102200100011111011a1011100222212021222120022010012201201211101111101
011101201221122112110021112110110a11202b11111201122222202112201222121222022222020201111212b0110122021201111110a1101110021201012202202111211212111112211111101011
221120222212210211122021120212111a12022b22012111222022211212111222221012210221201221210022a0112122212212211212b1212222220222211012120122221022211221111011101011
221021120012120211202211112111011a11211b11220220112122220202112200121122121222222012110121b0222211112212012122b2201111022101102010222221222211100212111111110011
210211211101210002110221120002210a11220a21220212212222220220200220222201021222222222122102a1122022221011111211a1222001222222111222221200220101211211011101111011
111111022222211102111202201100101a12122b21212122220222221201210222111221210222221100220102a2111221211212112120a0120110011212222220222210111121000222010110110111
111111110110111111110111011111111a12110a10112221102202121220120212212021111012211111011111a1111011111011021012a1111122202120122222122111121122021012201110111011
111110111111111111101111111111010a11010b10020200112211220122221122112222012221111111101110a1011111010110121011b2012121111220122111212222021022202211110111111111
111110011011111101111011101011011a12012a11212222120222200022222122212102021101211111111111a1101111111010122111b0112012022112210102221220112100201221111101111101
101011101111111111100111111111110a12110a21202021222222021002222222101112012101201111111110a1111111010111221122b1222111112222221121220201022121221221111011111111
111101100111111011111111111111001a02120b00100112221211211222220222022121211112121111010111a0110111011111021120b0111222202222222202222001220101222121011111111100
111110110011111011011111111011011a11010a12001102111201222222222200111022112112211111111011a1111011010112021001a2012012222122220122022112212211022101011111111111
111101011111011111111111110111111a11212a12221021102221101202220222202022002212201111111111a1111111111112111211a1210121202212222122020211221222101122010111111101
011001001101011111111101110101111a00112b12222111121122202212222200221201222000211111111111a1111111101111021220a1121101211222012212222021112110202110101111111010
111110110111101010111110110111111a10011b12121022221200220202222202222221222201121111011001a1111101110111122221b2122222121110212222222122012021221111111010011110
111101101111011110011111110111111a10111a12012211121222222120222221110101011110120000010111a1111100111100012222a1211110222112112221222211112122120202101111001111
100111111011101011111111110011011a11101b22021222122200202202102222200111021012101111111111a1111110110011112221a11012022baabbbbabbbbbbabbaabbaaaababbbaaaaaaaaaaa
111111111101110111001011111011111a01021a02202121021112222220001102111111011000011110110011a0001010111112121011b00122212a2122111111101111111110110001110111110111
111101000111111111111011101110100a12201b22221201110220112212210102110111111110011001111011a1101111111111122212a11012122b1212121022222211111111111110101011110111
111011111111111011111011011111111a11111a22222120201111102111222221110101111110111111111010a1111011111110101211a21212122b1101001210212210001111111110111110101111
111111011011101111111110111111011a11212a22211211220211101221211110111111111011011111101111a0111011111112021122a01112122b0111221111121101111001111111111110101111
100111111111101111110111110111111a11121b12102122210112101121111102011111111111101101111111a1111101111012220101b02222111a2221212211200111011111111011101010011111
111110111111111111011111110110111a00111a00111111111101111111111101111000011111111001111011a1110111111112202221a01110121b2101121120202211111011011011110110110111
101110111111111111111111111101001a11111a11110110111111110111101111111011111110111111111111a1011111111111110121b21212122b1222012122201001011110011101100011111111
110011101011010011111110111100011a11011a10101111101100101101111111111011110110111111111111a1101111111102102111b22122102a2221122201101211111101111111111011011010
111111111011111111111011111101111a10000a11111101111111111110110111111111101110111101111110a1110110001112222211b21221220a1022212011211110111110111111011111111111
101011111011000111111110110111011a11011a11111111011110111111102200222210211021212112101122a1101111111102210011b12011221b0221022110220211111110111111110111110111
101101111111101001110011110100101a11111a11101111101111100111110221120210012211122020022222a2101001111111222210a21202012b2222222121120100111011101001111111111111
110111101101111111010111111111011a11110a11111111111110111111112211202221221102222211111112a2111111111110201121b20112212b1011221211012111111111111110111111110110
111111001010111101001101111001011a10111a11011111111111111101012212212110221112200220112122b1011101101112021111a01011111a1202021201022110100111111110101101101101
111111101011111011111111010111111a11011a11111110101111111011012221022011021202100212002201a1111111010111021022b11222122b2212022121121211110111110101111111111111
111111100111111110111111111111101a10111a11111111111011111011101001221110021112111122022222b2011101111111212201b12211102a2112222121121011111110111011111111111101
101111101100010111111101101111111a10111a10101110011000111111110011120111102201121221111201b1100011111011111112a22221122b1110021222120211101111111111011111100001
111011001111111110011111111111111a01111a11111101101101111110101212221222122110200212111202b1111111111101011110a11111101a0111111101101101101111111111111111111101
111000011111110111100111111111111a11101a11010111111111111111101102022112021111222102111210a1111111111111110101a10111110a1011111111111111110111110111110001101111
111110111111001111111111110011101a11101a11111111111011011111111121221122212222112212210221baaaaaaaaaaaaaaaaaaaa11000111a0101110111000111111111011101111111110111
110111011011111111011111101111011a11111a1101101011111111111001210120202022112112122221021211101110110011011111111101110a1111111111111111111110111101111111111111
111111101101011111011111111111111a11101a1111110101111110101111122021210112200122201222112012011111011111111110101101101a0000111111111010110101111111111111111111
110011011111111110111111101110111a10111a1110111111111111101110122000111022210211001210211201111111111101011111101101111a0111111111011111111111111101011110111111
011011111011111010111111011111111a11111a1110100011111111101011211220111010011122012022111122111111111011110111111010111a1100010010111111111110111111111011110110
001111011101111111111101111111111a11111a1111101111011111110102102111022020221122022110122211101101111111111111111011110a1001111111101101111011101111011111011101
111100111011100111111101111111001a11011a1110101101001110011101202222111101021021110211211221111011111110111111111111101a1111111101010111110111111011011001111001
111011110110110110110010011111100a11100a1111011011111011011111220011220111022111122201211121111111111101110111111111111a1110111111111111101011111110001101111111
101111111111111111011100111111100a11110a1110111110111001101112212221121200002220210121112220111111011111111110111101110a1111101011111111100001111111111011111110
111111111111110111111101011111111a11111a0111111111111111111011022012210222211201010212201120111111111111111011011110111a1111011001100111111111100111100001111111
110110111101111110101010111111111a11110a1110100101011101110102122212020211101012102222102100111111111011111111111111111a1001111111011111111110101111111111111001
101011111111111111011111110100111a11111a1111111001101111111111111201210201122112212201110120011111100111110111111110110a1111110111111110111110100011111110111011
111111111101110111110011111111001a01111a1101111101111111111011021221121112112022212201222112111111110111111111000111101a0111111111101111111111111111111101111111
110011111111011111110111011111111a11111a0011111111110111011000011001221121102112221121012111111011111111111111010111111a1111011111111111111111111111111111110111
011010011101111111110101111111101a10111a1111011111011011111110010121222101021101121111021220110100101101111111111111111a1111110110111110110111101110100111111100
111111111111111111110110110111011a10111a0111111111110111110011121122112212002210012210222212111110011011111111111111000a1111110011001011110110011111111011111111
110111111111111111111110111111001a01110a1111011011100111011111112220222021201211222212122112011101111011111111000111010a1111111011011111101111111111011111110101
111111110111111110111011111111111a11101a1011011111111011111112210211211022210210222022001222101111011111111100111111111a1111110111010011011111101110000111111011
111111110111111101111111111011111a01001a1111101111011100101111211022112112021112101012120221011111111111111111100011111a0111110111111011111001111111111010011111
111011111101111111011110101111010a11111a0011101101101010101111011221200211011101212111211122011011110111100111111111101a1110111110111111110110100111101111101111
111111011111111001111101101101111a01101a1011011011101111111102012221201020112221110122120101101111110111011111111111011a1111111100111111111101111011011110100111
110111011110111111101011111111110a11111a0111101111111111111111110010222222122121222220211220111011111100111111101100111aaaaaaaaaaaaaaaaaaaaaaaaaaaaaaaaaaaaaaaaa
111110011101111111100010111111110a10111a111110110111111111111101011101111111111011110222202221212221200020112212211111111010111111011111011111111111111111001111
010111101101001110111111111101110a11101a101110111111111011011111111011111110110111122012121111120112211112222001111111111011111101111101111111111010010101101111
110111011011111100111111110011111a11110a111011111111111111111101111111111011111100210122112012121201221121011210011100011000101101110101110111101111111110111111
111111011101101010101101110110110a10111a111111111110101110111111111011111010111101220112101120012122001102221110111111111110110111111011011101011101111111011111
110111111101111111111111111111011a11110a101111111111111111111111101101111011111011202120221110110021122201122012111111101111100111101111101101110110111111101111
011111011011011111110111111011110a11111a110111101111011111111111110111111111110101102110011212211011200010212222111011111111101101011111101111011111111011111111
101111111110111111111111111110111a01100a111101101110111011111101101010111111111011011011210122101011212021102212111111111100111111100011101111111000111111111111
010111110001101110111011111111101a11110a111111111100111011111111111111101111101111201221221212122222211110212101211111111111110010110110111110010111111111011111
101111110111111111011101110101101a10111a111111111110111010111011111111011111010111212220202112112120021221112211211100111111011110111011001111011111111011101111
111101011011111011011111010101111a00001a011101111111100101111111101101011110111101200222022122222100122211001210111111101111111110101111111100101010100111111111
001011111110000111101111011101110a11001a101111001110111101111010101111111111111010112122121111222222221211120221111110111101110001111001111111111111100101111101
101111110111111101111110111010111a11111a111011111001101001111111110111111111111011221220220222201202101020220212210111111111100111111110111101101101111111111110
101111111111111011111111111011001a10111a101111111111111101110111111101011101110111022001011012120222211122222010110111111111111111111111111111111011111111101111
001101110101010011110111111111111a11111a111110011111111111111111111100110111111111110011210222002020121211111111111111111111101111011111110111111111111111101011
010001111110111101101111111110101a10011aaaaaaaaaaaaaaaaaaaaaaaaaaaaaaaaaaaaaaaaaaabaaabaaabaaaabbabbaabbaabbbabbaaaaaaaaaaaaaaaaaaaaaaaaaaaaaaaaaaaaaaaaaaaaaaaa
111111111111111100111110111101110a011111111111111110001111111101101111111011111110021112002220202202122022122201011111111111100111001111101110110111011111111111
111111111111011010101111111001111a011111101111111011111111011111111100001110111111112102102122222102121112111002011111111110111101111101101111110111011111111111
011111011110110101111110111101111a111011111111111110111101111111111110010111111111211212222220111112112021221222011111111110111111111111111110100011011110111111
111101111111111111110101111101110a111111101101111111111111111111111011111100111011221021211212212201120110002201211110110111111011111111100010111011111011111111
011111011111111111011111011011011a110110110111110111011111110111111110011010110111202120112212021212221120000221111101111111110111111111111110110101101111111111
110011111111110111010100111101011a101101111110111111010011111111010011110110101011111221102221212122021212222120210110111011010101111111010111110111111111011010
111100111011000111010101100111111a111110111100111111101110111111111111011011111011011020102012212022100011211121101111110101111111111111111011111111101111111111
111111011010111111101011001100111a111111111111110111011111111101101100101011110011100221202120221222011110202121111110111110111110111110011110111111111110110011
111111110111111011111111110101111a110111101111111111111111111111111110101111111111222122220201122111211001100110211110111111110111111111101011100101001110011111
101111110010111111011111111111111a111111111100100111111110111111110111111111101011212212211022012111210222201221211110101101111010110110111011001101111011001011
111111101011111111111110011111111a111111011111101111111011110111111011111111011011222121200102022211120012211012210111011100111101111101101011110110111100111111
011110111011011100111111111111111a100101111101111101110111001111011111111111111011221111112200211221121101121102110110111101111101101111101101101011111011111111
111101111111101101111101110111101a111101101011111111101111111101111111111111111111012102100121221122221122101120011000011001111111111111101110111111111011101111
111111011110111101011101101011111a101101110100010111101111111110111111110111111100101222221212221121021112022112001011011111101111111111111111101101101111111011
101011111111111011101111111111101a111110101100111011111101111111111111101111111000212011021222112212010122222112110011111111011111101111111111111111111101011011
011111111111111011111111111101110a100111011111111111110111111110111111111101111011212101111202012011110222110012111111111111011101110110101111110111111111011111
011110111111111111111111111111011a101101111111010110111111101101111101011111111110100101110110111111101011111100101110011111011111111110011101101111111110111111
111111111011000110110111101111111a101010001101101111110111101001111100110101111001111110111111000111011111011111111001111101110111111111101011101111011111111111
101011111111111101010100011111110a111110011011010111111111101111110111111110110111110111111011111111111001011011110111101111110011111111001111110111110100111111
101111110111111101111111111111111a111111010111110111011111011111111110110001111101110101111111111111100011111111100111110111111111111111111011011111111111111111
111111110101111110110111111011111a101111110011101110111110111110101111101111111111111010111111111111111010011110111111110110101111111101111111011110111011110101
111111111111111001101111111111101a100011000100111111011101111110111111111101100101111111111111111111011111001101110101010011110111101010111110111011011101111111
111101110101111111101111111010111a111111110111111101001011111111110111111011111111111111111111111110101101111110101111101111011111101110101111011110011111111110
