22 2
103 11
118 42
15 7
76 66
86 2
64 26
50 31
133 26
97 97

22222a010a1122022021a121122011200101111111111110111110111111111011111110200201102121201122211002112b221111100011110111011101111001111111101011110111110111111111
01121a212b2110112212a111212221000101111110111110111011011101101110111101111021122111112021102122022b221110111111111111111111111110110010111111010111111110111111
11221b121a1200021112a100122001111110111011111110100111100111001001111011011111211000221202211101121b101110011011111110111111110110111101111101111011111111010111
11112b111a1201122112a212112122111111111111111111110011101111101111011110112201211222122212201220112b211101110101011101110011100111010111111111101111110110011101
21221b220a0011112221a220101212211100111110111111001111111111111111111101111202012121221112111112121b121111111111110111111111110011111110100111111101100011111011
21021a011b2221012211b211120122211111011011100110111111001111011111111102002102111211111120002111112aabaaaaaaaaaaaaaaaaaaaaaaaaaaaaaaaaaaaaaa10111111111101111111
21121b012b1212110210b2220112112111111111111111111101110101111111111111021010121111010212122102200202221100011111101110111011111101011010111a01110111111111110001
12010a211a1101211210a2212210120111110110111011111111111101111111001111112012212122121201110121201100111111110111111010111110111111010111111a10111011110101111110
21110b121a1102101012b0012112122010110001100111111010100111101111111111100110222112102110212122200022110111011111011111111011111111111111111a00111011100111101110
10212a201b0212112222b0211021012101101111100100101110111111111111111111012021122011010212120111220201221101011011111110111111100010110010111a01001001111011011011
02112b101a1221010112b2202121010111110101111111111101011100111111111110112112021112112222221022202221101011101111111111111111111011011011111a11110111111111111101
00222a122b1221220101b1201121122111111111111111111211112012121101222121222211212110021220112022120120111111111111111011212121221200212122110a01021212111001111111
21222b110a2012221010b1100121211111001111111111111212111021121022220122102202212200220212121002100211020110111111101110011102001221111001221b20212122201111011111
21202a110a1212221001b1210120211111101111111111111112012022211121211122120220202211202012022121212111111111110101110100202202201111122111212b12102212211110111010
22220a222b0111102121b1212022020111111110111110100221102111112121122100010222211212121221012002120221121111111011111111111221221211112012212a12111222111101111111
22211b221a2121121111b1100021211111111111111111111112122200111121220121221222210221122212211210212121110011111111110101222111220200112111002b00201111111011111111
11012b001b1112122112b2211221012101121210111222201211202220022220210112010222021222012012001020210121121101011110111111110102201202210022112b22022220211111001110
10220b202b1222111122b2112112002111110210210001101222222212222202022112121002222211211202221202211110121111111101011111112212111102210211222a02211021210110101110
20221b211a1121002120b1010202222111111111120111020022112122222022202102212220220112121120121212211121101011110101001011112212022012120121210a10121112111111111111
22222a112a1121201002abaabaabbabaaaaaabbaabababaaabbbbbbbabbbabbbbbabababbbbbbbbbbababbbaabababbaabbba01111111111101011120220200211121112211a12211111210010111111
21222a220b121101222221012020212111112120221220112222212220122220112210202212221201010100121202112212a21111101111110110111211121211022012020a11111122210100101111
12211a121a121200102121102112222111122201102102201202021120222212222111122020102102211111202112101111b11000110111110111122011122212201010112a20210120110111111111
22200a212b021111222020112121002111111011102221221222202221221000222201222221022111222111221011221211a21101110011111011200210010221112222222a11012220110101111111
12110a201a221211222112210010211110012020121122220220010122222122202211122222212212210211111111202221a11111011111111111121222202221020122222a01212012011111111111
10221a122a112211212200212210222111002221212022110222222212120022222212122202220001212121121111102121a11011110111011110210121021121221222212a11211222010110011010
12020a210a120120121122212120110110022212110022021202202202210212221212211122012221101122222111220021b01111001001011111220120111121201021021a22122100211011111110
01220a022b100010021212202021212110122011012202212202202222220200122122222201022021110211121212112211a21111111011111111212121021122112111111a22121000211111010111
21122a221b202121220212112212010111122112021222210211022020100002122222122222222110112120120112002112a00221121121012001220220211212122011121b11111221211001111111
01010b102b110112000110221210111010110222212022210221212201212210221222122010020222212120011221021002b21222201122012221211022022101222120221a21201201110101010111
20110b121a111221222120201222222111120022002210212202221212222022102111122012112111212111212112120111a00211110221112002222221002220122212112a12122210111010101111
21121b112b112212202021022201022110112110122020212022122021222112121212222221022220100221102112120221b21021021111020202212102202211222120210b20211222211111111011
01111a101a110111011011011110110101110201120100112202221202222200021122021112221201101110101111111010a11122021222120212112022222120020221012b10121121011100111011
11011a110a111111111011101111111011110022200022212122010210200222212122221111101111110111111110111111a01121201202122202012022221202201221111b01211110111110011111
10110a101a011111111111101111010111120202221121211220220121022000111110120221010210111110101011111101a01112201111111221222220220010022210112a21200211111101111011
11111a101a100000111111111101111111121012212111210221222222221222221221201110202111111101110111111111a11221211111112110222202212122200222111b12211112211111101111
11110a011a110111110110011111001111102212101112121212022122122221221111122221110111011010011101101111a10221222020011211022120222201122102121a21112212211111111011
00011a111a011111111101111110111111122112122121201222022202222222202011101112222211111111110111111111a11021111122222010222120222222202112012b11101112111011111011
11111a111a111011011111111111111111012111100012100222221202000002212112210100121201111111011011111111a10112220112011112221222020002022211220b12021212111100101011
01111a011a111101111111101011111111122221101200012111110220211020222111211110021211111101011111111101a11211111011111120202100221221102210120b02200111110111110111
01110a111a010110010111111100111100102121121221201221222222210022120021221121010101111111101011110111aaabbbabaaaabaabbbbbb122222102202101222b12221210111111011101
01111a111a01111111011111101111111111220022012102020222221022222221111222012121121100111110010111101011121220220022211221b020221220022212111a12221220111110111111
10001a111a11111111111111111111111112111212222112200121222221111222112212111111211111111111110111101111111122121122112122b121201200112222122b00211110101111101110
11100a101a01111011110101111111110110222111012212200212201201111112111011011101101111110001111001111111101111012111212222a212010222110211111a11111010011111111111
11111a111a01100111011111101111111011001121211122212012102201121111110101111111101111110111101110111111110012221112122110a212211211201211111a11111011011011011111
11111a011a11101111101111111110111010120212120122021121102222222112111101100011111010101011111100111111021022121201120101a111022012020111111a11111011110110101111
00111a011a11110111111101111111111110222021111121111022220212201211111111111111111001010111001111111111022111221111112002a001102200222010011a11111111101111111110
11011a111a01010111011101111111111110122012102111221222111221110121111111001111111111111011111111001111022210220021122211b021222210210111111a01101111100111111101
10101a111a11110111111111111111111111110011101111111111110111011111111110111110101110011110111111101011102111202222112122a122111121011011100a10110111111111111111
11111a011a11111110101010110100011110011101111111100101101111011101010100101111100110111111101111111011121110121211022022a110111120210210101a11111111111011111111
11101a111a01101111111111011101111101111111101111011101111111111101111010110101101110111111111111111110121122122222022222b011201220211111111a11111111111011111111
11111a111a11101111111011111110111111111101111111100111111111111111111111101111011101111011111110110100102022021112021111a220002222222211011a01111100111111101111
10111a111a11111111111100111111111111100010111101001111011011122221212121012020102210221211220101111111121121212011211111a122001111122201111a11110111111111110111
01110a110a01110110111111111011111101111011111111111111011111100210201212212212211222212121211101101101110120202220112212a011201211202011100a01111110010111111111
11011a111a01111111101101101101111011100011111011011100101111112022222201002021222220221222021111011011121212022122220122b201121101211210011a11111110110111010111
11111a111a10110111111101111110111011111010111111111111111111102211212201110212121222201002010111111111101111112221101112b012221211210011111a11111111100111110111
11111a100a00110111111111101111111111111111101111101111111101111102220111111120210110012112221111011101022221112122111221a111110111221211011a11111111111101110111
10111a111a11011111111111101101111011111110111111011011111101100112202010021112002101211121111011011111122112210210012112a112111210102111111a11011111011011110110
00111a011a11111111110110111101001101111110011111010101001111112111220210210220211101210112201110111111111121120112121122a222210121112001011a11101101111111110111
11101a111a01101111101011011011111011111111111111011111011100111122211222010101001112121202121111111011111101011111011111a111111111110101111a11110111111110011110
11101a111a00111111111111111110011001011111111111111110101101112012002122111122221221122010221111111111110111111111011111a101111111011011111a11111111111101111110
11111a011aaaaaaaaaaaaaaaaaaaaaaaaaaaaaaaaaaaaaaaaa0011111110102201111220121121002112212121220111111010101111111111110111a111111010111111101a01111110011111111111
01111a0111111111111101100111011011111100111101101a1111111011120010201121121111110012112122220101111111101111011110011111a000011001111111111a11111111111100111111
11011a0111111111101101011101011111101001111111111a1111111101101122222111122110021222211120121111011110111101011111010101a110111111101010000a11110111111111101111
11111a1111111111111110111111000111111001111111111a1101111011112201011212022001100102111121011110111111111111110011011011a111101101111111111a11111101110011111011
10110a1110100010111111101111111110111000101001111a1110110111112011210020210112112111221222001101111111101101001111110101a111111001111011111a01110111101111111111
01011a0111110111101111111111101111111111101110111a1111110111010211122200122100102100220212111111001001110111111111111011a111011111011100010a11101111111011111111
11110a1011111110101101111101101111111001001100111a1111001111122211212000111221221002021111120011110101001111111111111001a111110111110011111a11110010111101011011
10111a1110111100111111111000011110111111111111111a1110010111122120212021122201212110212121201011111011111111000100011101a011111111111011111a11111111011111111110
11111a1011110111110111111011111011111111010011111a1111101001020122201020222220201111112122201111100001111111111111110100a110110101011111011a11000110010111110111
11111a1101110111111111110100111001111101001111110a1001111101120222101122201021111121202212120011001001011111110101111111a111011011111101111a11011000011011100011
11111a1111111101111001101111111011111111111110111a1111111111112221121120122021212201122212201111111001111111110111110100a111111110111100111a11111111011010111111
11011a1111011101110110110110011111111100001111111a1111111111122020212001012010221112202102201111111011111110011011101110a111101111011111111a11110100101101001111
01110a1011110111111011011111111110111110111101111a1111110010021111120001122112222111221110121111101010100011111100111011a011111111101111111a10111101011111111111
11111a0111011111110111110111101111111111010111111a1110001111121001200210121012211102121122011111111111111110111111111001a101110111110111111a01111010111111111110
11110a1111111111101010011111111101101111111111111a0001111111121121000021101222010220111121210011111111111111011011101111a101110110011111111a11110110111011111101
11111a1111111110111111111100111111111101011100110a1101011011112120212222112021102121220212001111101010110111111001101011a111100111111111111a01111111101011111111
11111a1101111101111100101111111011111111111111101a1111111111121221122212222220021112210222011111111110111111110111111111a111111111111100110a00100111111110111111
01111a1011111100110011101111111111101010010111010a1110111011101012201122010212202112002211221111101101111011011011111110a000111111111111010a10101111111011011111
11111a1011101110110111110111110011111110111011111a1111111101112222022022210012111210212122211111111101111111111111101111a111000111111010111a11101111111100010111
11101a0010111111111001101101011111111111111011110a111111111011122212122212100112bbbbaaaaaaaaaaaaaaaaaaaaaaaaaaaaaaaaaaaaa111111111111111111a11111111011111111111
10111a1111111111111111011011110111101011011111011a111011111101112021111220110012a1002021202211111101111111001011011111001011011110111111010a11110101111011111111
10111a1111111110111111111011101111111111111111101a010101111112212022111111221201b1121012211111100010001000101101011111111101101111111111100a11000111010111111111
11111a1111101111110111111111111111011011011011101a111111011111111100111111011111a1122022211210112222022222200222010110111111111111101111111a11101111111011101111
01111a1100111110111101111011111011111101001111111a111111111110011010110010111111a1200112022211012220012201001112111110101101111010111111111a11011111110111001111
01111a1111111111111111110011011101011111110110111a111110010111111111110110111010a1212212111220221121200121010221111010110111001101111011111a10111111111111000111
11011a0111011111111100111111010101011111111110101a111111111111111101101110110100a0211112112022200021102102012211111110111111111111110001111aaaaaaaaaaaaaaaaaaaaa
11101a1111101111011110010101110011111111111101111a111110110011111111110111111111a1020111011112101102211210211001011110111110110111111110101101111111101101111111
01111a1100011111111111011111111011011111110111011a011110111111011111111111110111a1021121201021021122200000100112211011110111111111110010010111110110110011111101
11111a1011011111011000101111111111111111110110110a110111111111110100111101110010a1111111221222121101112221012021211101110101011111110010111111011101111111011100
11011a0110111111001111101111011111100101111101111a111111101110111111110110111110a0221122221221111011121221210221011111101111111111101111001111111111111111111111
10100a1111111111101111110011111110111101110111111a111111110110111001101011110110a1222200221212222200202111122212011111100011011111101100011101111101111110011101
10111a0111011011110111111011111111111111001010111a111111101111111111111111101111a1022201100210222221221212002112011011111100111111111111110111111111111111111011
10111a1111111010111010111111111101111111111100000a001011100111111011111101011110a1221122002122110022011022011220111011111111111111111111111110110111110011110000
11101a1111100111101111111111111111111111111010110a111111111111011100111111111111a1122221211211000221022122021221011111111111111111011111111111010011111101111111
11111a1111011011111110110111111111110111111111101a111101111101111111001111111010a1222222122211122122020120012211110111011111101111111011111111111011101111111001
10101a1011011111111101111111111011111111110011110a110111111101010111111010111111a1201122212112212220221120221222211111101111110110110111111011111111111110111111
11110a0101111111111111111110111110111110011001111a111101111110111111111110011101a1221212221110210222011221220102111111101111110111111111110110010111101111111111
11111a1101101101111101110111111111111111111111111a011011111011001111010110010111a1111111211011112111102010020101101111111111101100111111111111111111011110111111
11110a1011111101111111111111111101111111111111010a101111111111111111111101110111a1112102112022111211200222012122211101110110110111111011010100101111111101111001
11111a0111011110111110111111110111101110111011101a111110011111110111111111110101a1220212212112220022222022112111210111011010111111111111111111010111111111111111
11111aaaaaaaaaaaaaaaaaaaaa01111111010101111111100a101011111111011011111111001111a1012200210210111010012012100212011101111101111111011111111001100110111111111111
1011111110110100111111111a11111111101101111111100a111111111111101110011111111111a1112212020121111110211202020211111010111111011011111111111011111111111101111111
1111111111010111111111111a11000111111001110111011a011111110110111111111111111111a1112221122222222121222221122212211111110111100101111101110101111110111111111111
1111101011111111111111110a10111011111110111111111a111111011110111111111010111111a1222101211121211211020202102212111101111111111011110110111000011111111111111010
0110100111101011111110100a11111111111011111111001a111111111101011111111110111110a1201012222022122111221102121102211111110101111110011111011111111111111111011100
0111111011010010111111100a10111111011101110111001a111111111100111111111101110101a1222111010122210102202110112121110111111111011011111111111111111111111111111111
1011111011001110111111110a11111111111101110111101a111001111011011111101111100110a0111212022212102112121212202010201111101111111110111111111111111011111010111111
1011011011111101110111010a01100111111111111101111a111111110101111111111010110011a1202022221212010110211121122212111101111111111111110011111111111111101110110001
1111111101110101111110111a11101001101101101111101a110001101111011111111111011111a1011112202102022122011221022011211110111000111111011011101111111111111001110011
1101111111011111111111101a11101111011101111101110a111111111111001110111111111011a0020222111122020101221101001221011101101111011111101111101101110011001010110101
1101111110011111110001011a11111011111111111011111a111111111111110111111110111111a0111101110202212121211212211012211111011110111111111111011011011111111100111110
1111011111111111111111101a01111111111111110111011a111001111011101110101100111111a1022021222222122110112210112112110111111101101111111111110010111101111110110110
0011110011101111111111011a11101111111101111011111a110111111110110011001110111011a1110211211020211222212020012211100011100101111111101011111010111111111011110111
1001111101111111110111101a00011101100101111101111a110111110111111011111101010111a1101111010100111111011111111111011111011011111110111111111010110110111111101011
1111111111110111011010010a11110111101111111110011a111111111110110011111111111111a1110111111110111111111110111111110111110101110111011101010111111111111111111101
1011011110011111111111110a01111101101110011011111a110011111101111011111111111101a1110111011111011101111101011111101100110111011111111111001011111101110110111111
1101101111011111111101111a11111111111111111110111a111101011111111110011111111111a0111111110111001111110001110111110010101011111110101001111111111111111110110110
1111111111101111111111111a11111111111011011110111a111110111100110111010111000011a1111011110101111110110110110111110111011111111111111111111111011111110111111111
1101111101101011111111011a11111110111111111111111a110011111101110011110111110011a1011100110111110111111111111010111111111111110111110110111111011110011111111011
1111110110111110011111110a11111111111111111111011a111111110110011111111011111111a1111111101100111011101010110110111000111111111010111111111011011011111011101110
