66 100
26 8
118 42
15 7
76 66
86 2
64 26
50 31
133 26
97 97

11020b112222111022212211212a121001001111111110101111011101110111011101121221221221011212222100212221211111111111011110011111a11100011111111111111a11101001111111
22121a211111002122212102112a201111011001111111101110101101111111111111112120111112201112122112202222001111111111111111111011a11111101011111001100a11111111111111
11110a022222220112111221012b112100001111111100111111110111011011101111121010010022200011101111200202201111111111111010111111a11111001001100110111a01011100111110
12121b110121211222021001121a121111111111111111101101111101111101110111112211210121202102212111201010120001101111110100110111a11111111011111111111a11111011000110
12120b112222210221211212220b011101110011111110101101111111110111101111122022111111210112212101010112221111111111111111101110a11111011111010111111a11110111111111
11202a212111011210112121110b021011111111111110101110111110110011111011122111222122212011121202121012210111100111111111111011a11111110101110111101a10111011011111
12122b210022101221102111222a122010101111111111111011111111011111110111111112221121122101221010012121120110011111111011111111a10111111111111001111a11011110111111
11222b212112212112220122101b100111110111111111111111111111111111111111122112222110020001112122120220211111101100101111111101a01111101111111111110a01110101110111
10112b00111111122112212101PP001111111101111111111011111101111111001111002112110011222220221221221202021100011111111101101110a10111111101111111111a01111111011111
11211b110221211112111222010P022111111011011101111111111011111111010111121201121112000211212211121220100111101111111011111111a00111111101111011111a11111101101111
20211a121112022020012111020P210101100111111011111111111110111111111111112122100212221111102111212222121110011001111111111101a11110111111111011111a11111110111101
22212a121011101012100120011P021110111101111110111110212121120011122011122222022221112122222202011020211010111111111111220110a10221221002211211112b21110111111111
22101a210122102221221002101P020111010111111110111222222121122011221011121010222102121212212200210022211111010111100110110222a10211221112112201111a22211110111111
22111a202112001111012222021P020101101111110111110211111011121212212022111021212021221222121021112111220111111111110011011110a11021012121021121201b12211101111111
22010a220122011112001021210P211111111110100111111222212122222122121110102021122222102120122111022212011010111001111111110220a11002200210211021212b12011011111001
22212a222112211220111121101P210111111111111111111212222111001111122211112222222021220210112221201111021101110111111110011121a21201101212211211211b11111111110110
21112a022202110211002110212P002011120101121022111020201002201102221221122221002112011010202222122212121000101110111001121221a12222101022221021020a21210111100111
20222b112210122212221021012P110111112022111120112221022102222202222210222202022201022010112112210221111110111110111101122102b01211220120021221102b10111111110101
02222b011111211001212121112P002101012110102011111221002020222222122021000222110200021102101210212110221101111111111101121011a11201120110220110222a21111010111101
21021b001102110221102211220P111111121122111021102112222002222220221112121200010201211212021121020112210111111101111100221220a11110212222010121121a20211011110111
11120b011021121122112211112P201110120112211222201221112112212112220202220220022202222210122221121112001110001010111011122202b20120101122101112202a22111111111100
02120b021121021212221222110P120111021220120211222122222202122221021122010122222222111011222221011012211011111111110111110211b20002010100002111111a12110111011111
12001a022120220121101211011P022111112201212222100021202122002000221120122022222000112112222122111111201111011111111111110111b22101211201202220102a21200100111101
21102b110120211111102112211P011111110122211110022022222220002222222112122100122222021021221112201022121111111111011111222121a11022211102211211001a12211100110101
01001a011022221111111122221P221111121222011110012010022122000210221012121222201121121122012102021211221111001101111111201222b22210111210122210101a20211101111110
20121b112112212112222112220P111101110020011202121221202212222202021201121202210221012112210221012112220111111111110111110202b12100221001112221120b20111111011011
22121b122211000202212112202P111111111122111220112212222020112022200122102002022212201220222201212122111101111110101111221000b00021102221121202101a21101111111111
12212a211111212210222022222P202111122121111101201220001212212122211122222222201221121010121111212102221222202121211212211222b22101220220010211101b11111111111111
12212b200221211122012211221P201110001122010012101221021012001002001112211022222001012110011101020202211202120112221220002222b22210022201112211021b20111110111100
20120a202120111220220120001P120111101200211222122211222122022222020111020212221012212102112111212211100100201121011201212101b12220201202000221211a12211111011011
12021b021202112122122220122P011110110220010212202221010011122222022220122212212121210221012011011211001121011110201121210120b12222202200102101221a22210111100111
11110a110011101111111100111P110111120222220212011212202222122122222110220221021001100011111111011111111212221111202121021122b22222221012120111102a12111111111110
11111a100001110110011111011P111111121211211001211222212222202222020210011002200200101110111111111111000221012111210002221221b22122112212022111221a02011100110101
11111a111110110111111111111P011010120121111200222202210211202120021112022200212210111111111011111101111002221111202211112002b12202121212221120102a12211111111111
11111a110101111101101111101P111101111100021211210222222221221122021221212210211110011111111011111011010011212120011022122222b21222222202012112211b00011110011011
11101a111111111110101011100P111000122121210120102222122202221220111111100021112010111111011110010110111022012102222121222212b02022122002020122221b22011101111101
11111a110011100011110111101P111101122022202121121222221220212120221002022212021210101110111101110101111101222022111001211122b22122002101221121202a22010111111101
10111a111111111111011110111P111011011121222202221212220022121222210120110000222010101110001101100111011112222211001202220220b01212010212201212100b12210101111001
11100a111101011011011111111P111111121102010002111021022222222202121112202210111210111111011111110101011221121111211212202001b20200220220212210221a12110111110110
01100a111111110111110101111P01111112111211221012002012222202200222101120121101110111aaaaaaaaaaaaaaaaaaabbbababbbbabaaabbbbbab22221202221102201202a12211111101111
11100a111011111111101110110P01111110110101101221122021222222212220001022010102210101a110111111111011011012220220021021220211222022121022221112020b21211111111111
11100a111110111111111101111P11010110120012102222220021122022022101211012102112211111a101101011111111110121101001112122202222222212022212001112212a22111101111111
01111a110111100011101110110P11111111222120111221211102210212221222111111111111111011a110111111110111110212210122022222102021200002222200111111111a11111111011101
11111a111111111110111111001P11100111202011121212022222120222011211111101111111101101a110101111011111111122211112211112121221021222220201111111111a11100111111111
11101a011111111111101111011P01011111021122222222110121222111202101111110100011011110a101111011101111111222121100112101211222012210122101110111011a11111111111011
11111a111111011110111111110P11101101122200112201221221001210121002111111111111101111a100000011111111010101212220101122120202111110211111111111111a10111111111111
10011a110101111101111111111P11111102001122111002122012220201210222110011111101110111a111111111110111111122122102122101111111011111212211111101110a00111101111111
01111a101110011111110111101P11111011101111101111010111111101111111011011101111011110a111111110011110111121102221112100200122002222222201011011110a11001011111111
00101a111111111111111011101P11111001110101110111111101111001101111111011111011111111a101011111111111111011221211211111111200201201202211111011110a11111111010011
01111a111101111111111111111P11100111101001111111111010111111110011111111111111111111a100111110110101101110211121022211102011120122201111110110101a10110111011111
11110a101111111011111111011P11111101011111011111111011111111011110001111011011011111a111011101011101110202122210112212121201112221222211111011111a11111111111111
11111a100111111111101111110P11011111111111111111100111011111101022220221101120021211a212022111111111101201111210021212112221021111211111111111011a10100110101111
11110a101101100111110111110P11111011111011101111001110011110101110221222220001102002b010212111100111111110112011222111212221020112120110111111101a01100111001111
11101a101111111111111111111P11111000101111111111010011100111102122101211101020222120a211212201011111111111110112111210222120102002111211110111111a11111111111111
11111a101110101101101111111P11101011011101111111111101111011112222121121221012011211a222121101111111111212101211011121020221121010011111110111110a11011111111111
11111a111111101111010111111P10110011111111111101111111101010101212211011121111112222a211110111110111111211112111011122021212222202021111111001101a01001011111101
01111a111110010111111101010P11110111110110011110111011111110111122221112111011020112a122111011111111111220122222122210202100212212110111111111001a01101111110111
11101a010011011111101110111P11011111111111101011010100111111110222011112102211212101a002112110011111111020211210210221102222010201020211111111101a11111010111110
11011a110111111101011101111P10110110111110111100111111100111112212202212211122021021b202202111111111111110011011111111111111111011111111111010111a11110101101101
11111a111011111010100111110P01010111111101111111110111111101112111222121121121212200baaababbaaaaaaaaaaaaaaaaaaaaaaaaaaaaaaaaa11111011110111111011a11101010111101
11011a101111011001000011011P111011111101110011111101011111111202211112112202210111211221021111111111111111111110100111110101a11111111011101111111a11111111100101
11111a111111011110011111111P011111111111111101001111011111111212111020201102221221110020101111111111111110111101001111111101a10111111101111111011a11111111111111
11111a111011111111111011111P010111111000111101010011100101111220121122212222111201112212121211111111011111110011111011111101a11111101111111011010a11101110110110
11111a111111111111111110110P111111111111010011111111111111111221012221222002122111221101210201111111011111111111110111110011a10111101111011111111a11101111111101
01111a101110101111001111110P111111011111101011111101001111011102112110021112111221012112122111111110110101111111011101101111a11111111111100101111a11110101111111
10101a111100111011101111111P111001101111111101110110110101111202212122201211211200121212101111110011110111100100101101011111a11111111111111011111a11111111111011
11011a101110011111011111101P111111111011110111100111101111111222222122212222211210211212022211101111101111111111111111111100a01110011011011101110a11011111011101
11011a111111011111111111111P011111111111111101111111111111110000211211111221120111202111102011111111101110010111111111111101a10111011011100111111a11111110111011
10111a001110111010110111111P111101110111101000111111111101111202121121122112111120222001122011111111001110000111111011011111a11011111111111011111a11111111110110
10111a110111111111101011101P011010011111111111111110110111101022210210202211120222012102212111111110001111111111101100111111a11111101111011111011a11111110100111
11110a011111111111111101010P111101111110010111111111111101011111122222012210122211200212210101111111111011110111100111110100a11111111110100011111a00110101101111
10111a111011111110101111111P111001111111110101111111101011111221222010221221220020221002110211101111111101111101111101111111a11111010011111101001a11101110010100
11110a110111011010111111111P111111001101111101111110111111011121121121222200112000010221102111111011110100111011111011111110a11110101111111011111a10111111111111
11111a110110111111110111101P111111101101110111111111011111111122202101222111000222121002221000111110101110011110101111111001a11101101111111111111a10001011101011
11111a011111011010101111101P111101111111111011111011111111111221221211122121002212211111222211011011111101011111011111011011a11110111111100111111a11111111111101
11101a010111111011111110101P111111111011100111110111111111111211111222112212121211220121010211011111111010101111101011111101a00111111110111100110a01111111001101
11111a011111101101111111111P111110111111101010111111011100111102201120210220011222210122211111101111111111101101111111100111a11110111101111110111a11111110111111
01111a111110111011111111110P011111011111111011101111010101111122210020221211112121121202221210111110111111011111111101111111a01111111001111110111a10111111011110
11110a101111110111101111111P010111111110111111011101101111011111222020102121121212101221211211011110111110110111111111111101a11101111111110101111a11110111111111
00111a111111111011111100011P1111111111101111111110011011111112011011220012020210001122021100111111111101aaaaaaaaaaaaaaaaaaaaa11111111111111101110a11111111111111
00111a111111111111111111111P1111100111010111111011111111111112221022011122102011202221111221101111011111a1111111011110110111111010001110110111111a11001110011101
11111a111111111111101011111P1010001111110111111111100111110012212212021212021121111102110100111101111001a0111111111011111111100111111111101111110a11011111111111
11001a110101111010010111110P1111111111111011111100111111111110111100111111100111112121112121111112212122a0112222011110111100110100010111001011100a00111001110111
11111a111110111111111111111P1111110111111111011111111111111101110111111111111111112112021222022212211212a1211121011101111111011111111101111111111a11011110111001
11111a111111101111111110111P0101111110111110111011111111111011110111101110101111110222121102002012112022a1112210110011111101110111111111100100101a11011001111001
11011a111111110101111011111P1011111100111101111111011111111111111111111111101111111022011112221012221112a2221121011101011111101011111111111111111a11101111011111
11110a110111111110101111111P1111111111111111110101111011111101010111110111111111012220110222022200111211b0222111001111111111111101111111011111111a10110110111111
11111a111011110111111111111P1111101111111110111111111111101111001111111111110110112220120211102210021200b1220121201111011001110010011111111111010a11111111110110
11110a111110011111110111111P0111111111111111011111111011111010101011111111111111010121120221111121121212a1210112211101111111111110111101111111001a10010111111011
10110a111111111101101111101P1011111101111111111111011111111111111011001011101101102221211212200111112002a2101220111110110111111101110111110110101a10110110000011
01100a111001111111111110011P1110100111111111110111111101111110111111111110111111111220222121200112212221a1102122011110101101011011110101111111001a11111010110110
01111a110010111111111111101P0011111011110101101111110110101111101110111011111111110212211100221110211210b2122202110111011111111111111101011011111a11111111111111
11110a111011111001000011110P1111110110111101111111111111001111111110111110111111111122211102122222111111a2021210211111111111111111110011111110111a11111100111111
11111a111111111111010111101P0111111100111111111101111110111110010111111110111111111121221000020210112221a2211112210110111011100111111101111110111a11111011101111
11011a111111111111101111111P1111111011110101111110101010111101111110111111111111102210112012102110201221b2002222211111011111001101111110111011111a01101111111111
11011a010010111111110111111P1001111101111100011001100111001111001101110111111110112121110212122212221122b2012110201111111111111101110111101101011a11111111111111
11011a111101111110111111111aPPPPPP1111011111101011101111111111110001011111110011111220001222221102212121b1222201101011100111111101111111111111111a00110011111100
01111a100111111011111011111a100110PPPPPPP110111111111111111111111010111111110111112022202120120111112120b1012121111101111011111111100111111101111a11111111111111
11111a011110111111111111111a1111111011110PPPPPPPPPP01111101111111100111011110110111101001010202220211221a1202022101101011010111011111111011110111a11111101101101
11101a101000111111110001000a11111111111101111111110PPPPP111111101011111111111010111221122211012122012021b1201022111101111101111011110110111111111a11111011111100
aaaaaa011001101101111111011a1000101011001011111111111010PPPPPPPPPPP0111111011111112011221121022120221020b1212112101110111111111011011011100011101aaaaaaaaaaaaaaa
111101010101111101111111111a1110111111110001110111111000001111011111111011111111111212021022200121221112a2212120211111110101011011011111111100111111011111111111
111011111111110101111101111a1111111011011110111110111011110101111010101110111111111212111211111111121211b2221122210100100111111011111011111111111011101111011101
011011011110111111101010011a1011100011011110111100111011111111111101111111110111011200122121011112211002a1210122001011101111111101111111011011111111111011101111
101111111110101111111011110a1111111101110001111010111110111111111111011110001111111021102222122021200122a2002011011110111111101111111111110111111011111111011111
011111110110111111011111111a1111101111111111111111111111101111011011111111101111012112000211211020012011a1022120011111010111110111011001111101110111011110111111
111011111111111011111011110a1101010111011101110110110101111100110110110101111101112122121121222002112220a2111101201111100110111101111101111010111110110111111101
011111111111100111011111111a0111000101111011101111111111111111100110111011111111112211002021120022122112b2022222011111111111111111111111011001101111111111111111
101111101111111111101111111a1111111100111111111011110111111010000101111011001111002200212122110212121221b1202221110001101011011101110111010111111011111111001111
111111111001011011111010110a1111111111001101111110111101111111010111011111111111102211101222121012211102b2202210111110111111001111111011100000111011001101111111
110110111011111101111011111a1111110111111111101011010111111011110111101011111011110212222220211012110122a2120111210011111111010011111111111011110111010011110110
111101001111111110111111111a0111111111101111111111011011001111011001111111101000111110222122011221121222b1222222211111111111111111101110111101100101111111110010
110011111111111011110111111a0111101101101011111111111110111111111111111101110111112121122220121212210222b1121210111111001101110111111110111111111100101111111111
111101111000111111111101011a1101111111111111111100111111111111111000000100111111101111110101111111111111a1111111111011011111111011111111111011100111111101011011
111111110111110111110101110a0111111110001111011011101010111111111011110111111011101111111111011111111110a1110111101111001111111111101110111110110111100111111111
100101111011111111111111111a1111110101111111111111111111111111111111111111111101111011011111111111111110a1101110111001111111111011101111011111111001001111111101
111101111101110111111111111a0100111111001101011111011111110110111111101101111111001101101111001101111110a1110000111111111111101110101000111110111111101111111111
101111111110110111111101111a1101111111101011110101100111111111111111101111110011101111111110101111010111a1110111111111101011111011110101101101111100011110101110
110111011101111111111111110a1111110111001111110011110111111001101010011111111111111101111111111101110111a1111101111101111111011111111111011111101111111010011101
111111010110111111110111110a1100110110111111111110111110111111111011101110001110111111111110100111111111a1111111101101011111101111110101111011111101011111110011
