71 10
8 119
118 42
15 7
76 66
86 2
64 26
50 31
133 26
97 97

102212220121021220122120121212211111111111111111111110110111a111111100121021220b11122101210211112101221101101111110011011010011111111111111111010011110111111111
212211201202220001022201002122210111111111111111111111111111a100101101021221100b10110112211122201021220111011111111100111111011111111010110001010100111111111011
000022221110112101022121112220110010110111010111110111111111a111111011122221201a12220021201110110022011100111110111011111110111111110111111101111011101111010011
220200111102111202211222212221101101011011110110111101010101a111111111122211211b11212210001102202102221111101111110101110111011111111111110111111111111110111111
110202110111111212112212222101201011111111101111111111111011a011111101101221111b11121221211211022112221100011111110111111011111111111111011111101101110101010110
211021200001110110221022112121111011101111110111111011101010a111011110120202002b01021111112012201111010110111110111111011110101011111111111101111111101100111111
120012222201122001210111001221211111111111011110111111111110a111111111012211100b11221210111012211221021110111101111011111110111011011011101111111111011111111111
022022202011212200121011011220101111111111110101111110111011a101110111121220112b22121220120221011222221011111011111111111011111110011110111110111111101111111101
111111120210211110212022221122011111111011111111111111111111aPPP111111102111001b10100211122210220112221111001011011111101110111111111111011101111111111001111111
210010102101102102120021102211010111011111011111111110111111P000P11011122111022b12210200211110122100111011110111011110110111111111111101110101100111110011011001
111220110211222111202121122112011110110111111111111101111111P1101PPPPPPP2121212a02112110222111022211011000110111111111111111111111111001010111111111111111111110
210102102221021222012211211222110101101111111101110211102200P102220221021222022a20122220022022121220121111111111111111022021111100122212222111122021110111011101
111112122011220020222111122012001111111111101001121221111210P010210102221201122b10122212100202212201111101100111111111202211222221212211220111122122001111111100
222112112222220110220210111111211001111011110111112212022121P022220211212121011b12211102112112100122101011011111111111201101102121120202210211201222211111110111
221112121122021011222211121122111011001110111111122211212111P102201111011222221a21202221220102221111111111111110110111121012021211020212200102121100011111111111
112212222212001211112112201002111110111111011101111210211012P011111101222211222b11000022201011111112110110111111011111112100122121201022202121222012011101101111
121010120202222111211100211212210000112210222120221201122122P211002012220222022b02022221111222110212110111111111111111122201121000122101221120221110211111110110
202112221222102000110020010012201112211010121012102220222202P020222212222022022b20121220211112021012210110111110111110212221121201012211111222211022211001110111
002012111011212110121122121210211102000112121221101202222220P002020121212212122b01211012001112102120211111101111110111020120001022112202200100121201211101011101
222112001112221211022121002021211112001220220122112222222212P212120120020222122b22212122211111201120211111001111011111120012202102201211111212212102001111101110
212021221222122121010100021011201101202121121011222222222122P202001211022222222b01002111112221000111201111010011101111111121120121200220020122212222101111111111
021210200121202211220112021112111110001102112221022221220101P022221111110012120a02122102212111221010201110101001011111212012212020221002220022020211111110111011
012222101120212022012220022201111111211221121120202222121101P200200111122010202b12212122100121220022021001101010110111012102022121211111212111220102011011111011
212201211110122011220122022012111101121222111121122022002222P212021122122221212b02202112120000211200121111111111011111011200200002120221112110202120111011111111
121221121202100022111111212011211101222112222212122222002220P120221122020112220b12111122221221212220211011011111110111102101112211220121200221010211111111111101
211121121122220021011011122121211111221222202121220122220202P211220211022122222b11012201022221200120201111111001111111112211121201121021112020001211011111110011
101222021121101101221022212212011112220221221200200222022222P022001111121222210b22202211221121222022201101110011111101121121222221102222022112100201111111111100
111222122201121211221220211011100112121021120022212100021222P202220100022202222a21101122011211122210021212111211011121222002212022222212200022201111111111111110
102101220111221111111212002012011111211112111202122200202220P001220012220022020a11001201202210212101111212121222211022021222201212222112220210102121011011011111
111112012122010111202112101200211101112212020221202222202022P202112212222220022b02021111002211202022021121122211212210212122002202221210001221112221211011111111
211121212222101221021110011211211110222022221212122210200221P121021121210212110b01100122022002101221120012102121002022202202222202010222211202122222111111111101
111100101101101110111010111101101112102001211022112200212022P012002201111220022b01101011111101011111111110110211111122200122022222122212222220211021211011001101
111110111111111100111110111111111112111202022021121220212221P222121011212112120a11101111111111111111111021121121122022222222212022211211221110211220211111001111
111111011111011101111100111101011012121102121022111022022212P220102202222212121b11011111101011111100010101101121201011212120211210222222111111100002111111111111
111110101111011010111011001111111001212221012211222212221021P222022122221011020b11101111111110100111111002112201212110200020022101220102120222111121111111111111
101011111111111111111111111111111112111122112212122220202211P221202222221212121aaaaaaaaaaaaaaaaaaaaaaaabaabaabbbaaabbbbbbbbaaabbbbbabbabbababbbaabbaaaaaaaaaaaaa
101111101111111111111111111101011102222111211120222202211221P220220102220222012211100111111010010100111202211122011120122120210210021111222101102221211100111111
101101110110111110101111101111111012122022211120121011200112P002121110022022111011110111111111111111111200111020211221220220210220022112120211201122110111010111
101111100001111111111111101111110112122110200021222202222222P002021012222221202101111011111111111111011221211121110212222110212002002212222212212122211010011111
011111011111111111101111001111111110200221021122222112122220P212221211121211102211011101111011101111111211121211022222222211000010222211020101102002201011111101
111111111111010111100110110111111110121012112201121222122022P122102220011000110111111110111011111010101122211102011111020211122112222212211201122201111010111011
011111000111110011111101111111111112111210201110100101212022P002101211222111212211001011001111111000110111112202211122020212220122220201221122022222110111110111
111001111111111011111111111101101110121212011221002222210212P212011111111100111110011111011100011111101222112221211202121210210110211111111111111111111110110111
101111111111010111011110111111111010010222122111200211122110P112210111101110111111111011110111111111111221101122202222211120212221001011110011101101101001011111
101111110111110101011111111111111012211022120111211020022020P222111111110111101111111111101001111110011101111212211121022112102222100210111011010111111111111011
111110101101111111111111101011101111211222022122210110002222P200220111111111111111011001111111111111110212100102102020201212122121212201111101110111110111110111
111111100111111110011111011111111111121212200211111201221222P101121011101111111001101111001110101110111220111021112220011021201110212000111111110110111111111111
110111101111011111111011111111111001111111010011110111101111P101111110111101001101111111111111011111111211112021212121201111000211021111110111111010111111111111
111111111111111111111100111110111011011111111111010111111111P111111111101111111111111111111001011111111221000211121221112212211111001111011011111111111101011111
110011111101010001111101111111011011111101111111011101111111P111001111111111111101101111111110110101111212220011012212200021111111121211111111011011110111101111
110010111101111011111110111111101111011101111111101010111111P101111111111111100000011111111010111111111221212111011211012212221010222011110101101111010110111111
110111100111111111111101111011111111111001110111111111111110P202222011122200122100110111011011111111110021022220102121221201221001121211110111111110101011111101
110111111111111111101011110100101001110010101111111111111011P112202121121221000012111102121011101110111211111202121220121210121120211111110011111111111101011011
101111110111111111101101101011111100111101111011101110110111P122102221221212212112011021002201111111111112012210211220122111202221212011011111111111111101111111
101111101111101111110011011111111111111111010111101111011001P112022122211221211120202101122211111111111121120112211222200021200212112111110011011101110111111111
011111111111111111101111111111111111111111111111111111111111P212212221102112202111112101020211111101111211200110221102000110122121011201110011100100011111011111
010001111111100111101100111110011110101111111111111110110111P022022111211210122110111221111211110111111220121201210122121122211221011111110111011101111111111101
101111111111111111011111110111111101111111111111101100111111P110122221211120212111021022201211111111011011122102122021221012211111222211110111111111110111111110
111101011111001111111111111001011111111111010111111111001101P102211212111211111201121121021111111111111111111110110111110101110111011001111111111111011111111111
111101111101111111011011111111000111111110111111111111011111P221122211102221220211012220222011100111111011110111111111100100110111111001111011111110101000110111
101111111111011110111111111100111101111111111100111110111111P201201202012111110221202120122211111111101101111110111111101111101111111111111111111110111101111101
011100111111110110110101111101111111111110111011111111111111P01011101112001112221112001220221111111aaaaaaaaaaaaaaaaaaaaaaaaaaaaaaaaaaaaaaaaaaaaaaaaaaaaaaaaaaaaa
111110111110111011111111111011111111010101111010111101111111P22120121221112112200122111101121011110a011111110110011111110101111011001111110111111111110111111111
001101111101111110111111110111110111101110110111111011101010P00001110012122222221211211022211111011a111111111111111110011111111011110011111101011010111111111101
111111101111111111111111101100011111111101111111111111011111P11221101212212001211122222221011110111a111101110111011011011110111110111111110010101010110101111011
110100111111111101010111010111110111011111110111011111111101P00212111102012221121022001211221101010a011111111111101111011111110111111110111111111101111101101111
101101111000011110111111111101011111101110111111111111101111P10012220000110110122121222122201110111a110111111111001111110111111111111111011111111011010111111111
110110110001111111111111011111111110111001111111100111111101P01222022020112210011201111021111111111a110111111110111001111111101111110110111111111111110111110011
100010111101110101111111111101101110111101101011111111111111P01122121221221202212002212221111101110a111111011111111101111111110111111111111110111111100111111111
111101110101101111101111111101111110001111111110111111011101P20112001121212001011112121201011011111a111111111111111111101001011101110111111111111111101111111110
101001111110111110111111110010111110001001111101101101111011P21000110222222200011221212212021111011a111111111100110001111111111111101110110011011111111101111110
111011111111111110111110111111111011011111101011011111101011P22201011212220112102210121122021111001a101101111110101111011111111101111101111110101001111011110111
101111110111110110111111111111100011101111011111111111111111P12101121101112122101122202211120110101a111101001101111110111011111111111111111101111011101010011110
111001111110111101100011111101101101011111111101110111111011P12110122211101120221202110212121111011a011101111101110110100011111110111101111111110111101111110101
111011111111101011011101111111110101111010111011111111111111P10101210111022122200211112212221101111a111111111100101111110011111111110111011111001110111111111001
111110100101111111101111111111101110101011011111111111110110P01222112121122121022212111121100110011a111111111111111111111111111101010111001111101111110111011110
aaaaaaaaaaaaaaPPPPPPPPPPPPPPPPPPPPPPPPPPPPPPPPPPPPPPPPPPPPPPa22221212122112221211202220101101101111a000111011101111011111111011111111111011011111111110111101111
1011101110010P1110110110011110111011111011111101101110110010122022112111122110222221211120211001111a111011110111111111111111111111001011011111111111111111100011
1111011111111P1111101111110111111100111001111111111101111011110022122211210212121121222201111110111a111111111111111011111111111111110111110110111111110111111110
1101010111111P1111111100111111111111011110110101011011111110021201211022112121221100221112221101111a111111111111011111111101111101111111110011001011011111011111
1111111101110P1111001111110010111101011111101101111100111111122221122011211201122001220120201111111a111100110011101010111111110111111110101111010111011111111100
1101111110011P1111111101111111011111110101010111111111111111111112211112002211121022101102211011111aaaaaaaaaaaaaaaaaaaaaaaaaaaaaaaaaaaaaaaaaaaaaaaaaaaaaaaaaaaaa
0111111111011P11110101111011111111101001111101111101101101110111101111111011111110112111111211110221222222211120101111110111111101111010111111111111111111111111
0110111111111P11111111111111101100111111111111110111111111111111111111111110111101122021102221220011110111111012011110111111100010100111110011110110111011111110
0111111111111P11011111011111101011100101111101111011111111111101001110110110100111222221010012212122221222210111210101101111111111101111111111011011110110111111
1111011111111P11111011011111111011011110001101111111111101111011111111011101111111110220120111222012212111202010001101101110111111110111111110111111111111111101
1011011111101P11110111111101110111111111011111011111011110011111101111111111111111220121211211212212212011122211211111011010110111110111111111110110011111111011
1101111110111P11111111011111111101101011111101111110101011101101010110011111110111110021020212011102112121211121211111111101111101111111111101111111100111010111
1111111111111P11101110111111111111101011111111111111111111111110011111011110101111120001111122202011220022110210011111111110111101111111101000111011101111111111
1111111111111P11100110111111011101111111111010111111110001101111100101011110101111101122222111210110020211020122210101110101011111111111111110111011111101011111
111111110111P011101111111111111111111101110111110111110111110111011111011100111111220121120120112112222111211001111011011011111110111111110111111011011110101111
010111111111P110111011111011101111111111011111111111011111111111111011011101011111222121222021220120222222110122101100011111110100111110010111110111111111101111
10111100011P0011110011010110011111111101110100111111111110111101111111111111111111122011121011211112010012211222111111111111110111111111111111011111001111111111
11111111111P1011011001111111110011111111101111010101111111111111101101111111111110001110011212211100120100220221211111111100101111001011111111111111101111111111
11110010111P1111101011101101111111111110111100111110111101111010111111101011111011221111211212210021112121011212211011111111111110100111010011011110111111111111
01111101101P1100111111011101100111111010101111011110011111111110111111101110111011022111202211111111211120122112010101111011111101111110101110111111011111101111
11111011110P1011110111111011111001010111011111111111111111111111101111111111111001121211212112121102121121220111111111011110111111111100111111111111111111101011
11110101111P1001111111111110111111111111101110101101111111111101111110111111111011201201110212122120210121121211111101111101010111110111111101111101101011111111
11001111111P1011011110100001101111011111100111011110111111101111011101111110110111212002222222101212112210201122111101110111111110011101011011101011110111101010
11111111111P01111110101111111101111111111111111aaaaaaaaaaaaaaaaaaaaaaaaaaaaaaaaaaaaabbaaaaaabbbabababbbaabbbabaaaaaaaaaaaaaaaaaaaaaaaaaaaaaaaaaaaaaa110111100101
01111111010P10101101101111011101010110110111111a111101111111100011011111110101111100101110110020012122020110200111110111111111111111110111101101111a100111011111
11111101111P10111111110011111111010111111011111a101110111111111011111111100010111120221112121112122222212122021111101101111110111110111111111110011a111111111111
11111111111P11001110111011111111111011010111110a101111110111111111111111011111011012212112120122212122102120221211111110101101111101111101111111110a111111010111
11110101111P01101110011111011101111101111100101a111110101101100001111110111101111110222021211112122112212112122211111111111101111111111111111101111a111111111110
11110101011P10110111110011110111111101111111111a011110111111101111111011111110111102102112102111111102202100111111111111110111111101101101111101111a111111010111
01111101101P11101110111111101110111110111111101a100111110101111111101111011100111101212212002011111012121012120220101111101110010111111101111111110a111101011111
0111111011P011111101101111111001110111110100111a111111111111010010011101111101111121122212102102012221221220012221111010110111101111111011101111111a111011111010
1111011111P110111011111110101111111111001111111a101111110111011111111111111001101022220202210111112221022220212101111011111111111111111111101111110a111111101110
0110101111P101011011011101010111101111111111111a111101110111111100011101101111101122121102012120121122221021001211111111111111011111110111101000110a111111111111
1111111111P101111101110110011011111111111111111a111111111011111111111111111111100010122211110112111021102210101211111111111111011011101110111101011a111101101111
1111111111P111111111111111110111111011111110111a111100111100111111110111111111111110212121110121021012222112221110111110111101101111101111101110111a111011110111
1101111111P111111100111110111110110111111111111a011110101111111111110110001111100112220220122222020122210112222221111111110001111001111111111101111a101111110111
1001100111P111100111111110111101111101011011011a111111011111111100111101111111111110102102211012011101110201210011100111110110110111110111111111111a110110110111
1001011111P111110111110111111101101111111011101a110111111101111111111111101110101011110011011111111101111111111011001001111111001111111110100111110a111111101011
1110000111P101111111111111111111111111111111001a011110111111111011101110111110011101001101101011111011111111111111111101110111111111011100001111111a011110010111
1111110011P011001110001110111101111110111101111a111101101101000100111111011111100111100100111111001111111011111011110111111000110100111111111111101a111111111110
1111011111P110111011111111011111101110101101011a111111110110111111111100110111011001111111101000000111001111101111111110110111001110110110110110101a111110011111
1111101101P100011110111011111101011101111111111a111111010011111101111111011011110111111111110111111001110111111011111101111111101110110110010101101a111111111111
111100111P0110110111110101111111111001100111000a111111101110010111110001101111011101111111011111111101111101011111100111011111101111011101101111111a101101011111
11111111P11011111111111011011010110111110100011a110111111111111011110001111111111100110111111011011010110101111111111101110101001111111101111111011a010111101101
