10 104
107 13
118 42
15 7
76 66
86 2
64 26
50 31
133 26
97 97

120022021112221112022111201a11211111100011111101111101111101111101111112221111121221211222211112122110111110a011111101111111111111111111101110011101010101011001
101020010122211021210222212a10210111111111100110111011111110011110111112120122111210121221111211002201101101a011110110010011111110111010110111111111011111111001
212222111211210212211202222b22211110110110111101111111100101111101011110220120121022122202111110121222110111a111101011111111111011101111111101001101110111011111
021022102210200022121121022a10011101111111111000111010011111111100101112112212221110100122122011111222111111a101111111111111110111110111011111111111011100111101
222212220221222122000202220a22211011111111011111111111111001110101111110012112211201012212222211121000111101a101110011011111110011111110011111101110101111111011
222022201121202111212112022a11211101111111111001101111110111011111110110020110212021111221000121220222111110a011111111111111111011111110010111110111101110100101
100110111111122101112121112a22101101110111110011111011111111011111111101122221211111101012122112012100111011a011111111111111010111111101111011111110001111111111
200201222222121221122220122b10011011111111111101111110111110111111011111122002100012211012222221221212111111a111110111101111101011001110001011111111111110101111
021110120122010021221112110a12011111101110000111111111110110111011111111212022111022221122211212211120111111a111111010111111111011110111111111010111100111111111
102211100220102212222102221a01011110111111011011111101101111111111111010012211221121120210122100212222111011a111111111111111111101111011111011101101101111011101
020212212122222221112112201b01111111111111101110111111111001110101001111112112212210012120122201120011011001a101111011011111111011101111111111111011001011010111
121110120212221200220012112a11211111001110111100122221222122022221221211022210221010010011110101100121101111a011111010112112012212122112002202001120210011111010
201102012210221010221111012b11211111111110111010021221112002212001120122222211002022211211022002112221110111a111111001010012221212222201111122121210111111111101
200020100200011222121121110a2110111101110111111110111012101101020221120221222202222121220121220111211110101Pa111111100021121111100121021201011222211101111111110
201221111110101012121222120b10211111011111111100100211020121221110111210221022202102110201110212211210011111P111111111122221212100111001222011212220201111111101
221201112002221200011121122b01010110111111001101121002221210202012022020211220201002121101112200120212111111P111111111111202111222112022021121222212011011111111
212201210100111221010011122a20011112210221021012122220100221122202121022221212122111210112210211022201111111P111111111222222211112212112011020201220211110101110
212120101121202212002120101b21211112211120101221212201212222122212221211222221121102211220211201210021011111P110110101011222210222202111111122022221111111111101
210212112222211012002020222a02101111121211221021122121021202120001222112211220002221212022121111221220011101P101111111112112111020012111101002222120211111110101
112222102221022212120221222aabaaaaaaabbaabbaabbbabbbabbabbbbbbabaaaaababbabbbabbabaaaaabbababaaabbababaaaaaPa101111110202121210222112220011122221221111aaaaaaaaa
20111111111012212221001110121121111121222111222011222211122112210220112222012200011202012101002200111211101Pa111111011021221111120211111000211022012011a10011111
10111122112211111111112101120211111102002122200222222122201122120221100202102012212120210200101211102211111Pa011111111212122120211121122010212121112011a01110111
10222101122112112111102111111221101201011021201102022022222222211222222122200200111211011110120222102211111Pa111010011112220000222212101120202222212211a10110111
12110101121122121020101120002021111202210000022100202202222222202222222210020202111221222222211220222101011Pa111111110211212222111221112111101210210211a11111110
21121122221111111121212112200110111221221200122002212121220222122221112202122221212012221102110221222111110Pa111101111022112222020220211122111212220011a11111101
21221212201101122110010122121221111211011201202112210112112220002011002202122222212111212111222222122111110Pa111111111221222121110010122101021110222211a01111111
01111112222110220220012211001011111122212201212022122122102212121221222211202120221222122221202221122211111Pa101110111200002212111210002011211211221010a11101111
01120112202222001211212211001021111221211000202212101222220222122212222201222222211210012221121222122112111Pb112010112222201002002022102221011111021211a11110110
22211212120122211211120121211201111202220101211222122120212222112111011222212212100021101211212111121011121Pa122112222222022022222102010111112210222111a11111101
20112212210112121220212212010111111122211111011012120222202222102211001220210222121112121211112211002002110Pb201201021202100022212220201111211122211211a11101111
12121112210120102021100122200001100002202011202101202021212222222212222201200222112121020212022010212112121Pb211112102022122021222111222221121221202110a11110111
11111111110111111101110001011001111212222121021102202220222222212221210021211012111111111010111011111102221Pb122012212220222220202012012022211112121211a11111111
11111111110111110100101101011110101022222110121012201122222222212202212210220102111101111101111111111100021Pb121200020002221020212220122211121210022101a11001111
10111101111011111110111001101111011200122110211020202222220122120021021121110222111101111111101111101112121Pb111200222022222021222222012202220112212211a11101111
10111111110110111111111111111111010202221222212212222012220201220220222212221212110001001111111111101111102Pa122120111021222222122201221010102211020101a01111111
11101010111111111111111101111011011220111111010112211101122122112211222200112210111010110100110111110101211Pb012201111212222002221122212121111202111110a11100111
11111111111010101111001011101111111212212011011202002211222120200110121112211020111011111111111101101011201Pb212211212222222122222221201121212212222000a11011001
10111101001111101101101111111001100121212101102122202021220011202121201112022212101011110111111111111112010Pb012110012202221222202222012212121100121211a00110111
11001111111111110111011111111101011121111002202011220212211202222111121121111221111111011110101110111112222Pb121110000222021222201222201221111002210111a01111111
11111011111111011101110111110101110221111211122022222220112120221122011112122212101101111101011111011111012Pb210221221202022002222212222120021200121110a11111010
10110011101111111101111111111111101011110112121220122221021222110202210220012212110111111111111111111002102Pa111122111202111122012222211111121201022211a10011111
11111111110111111011101111110110011120121121221211222212122222222221121222122121011111111101110111010112101Pb212202001222022120022122222210022212221111a11111111
11111111111110111111111111111111111222222121110222211121220112000111111101111111110111111010110111011111210Pa120222212022201222211211111111111011110111a11111111
10111111111011111111110111111011101211100121202012221111110200012201101011111111011111111011011011111111211Pb121222210122111022221201210110111111111011a11110101
11111011110011011111101110101110110222211012011221012000211100211111111111111111111111111111111011111112211Pa021221111222222012221102110010011111111111a11111010
11111111110101111001110111101111111122111110222112222220120011201211111111101111111110111001110111011102112Pb112121120101012211202220101111111001111101a11111100
11101011111111101011111111001110110201222000112211202211221211022111001101111111100111111111011111101012212Pb122211011212101112211122211101100111110111a11111110
11111111111111111111101101010101110111111010101101010111111011110111101111111101101111101101011111111101111Pa121102001221211102112121111111110111011111a11111111
11111111001110111111111111110111110111110101111111101111111011111111110111111111111111111111111011111112100Pb121222111222022221120101211111010010111010a11011111
11111001011111111110010101111011101111111111010111111111111111100111011110111111111010111111110110111110011Pa112020212110221120201221111111110110110110a01111101
11111111111111111111111111101110111011111011111110111110111111110111111111011111011110111111111101111111202Pa200200211111111010201212211110101111111101a01010111
11110110111111110101111111111101011111111101101111111111111112202112120211022220200112102212101111101112121Pa201120222021211200121022111111111011011111a10111110
11011111010111101110111101111100111110111100100011111111111102122120122211122211202110120221001101101110200Pa021112202010121222012122000100010111111110a11011111
11011101111011100011010111011111111111011111111111011110111111121101022201211211122020122122011110011002211Pb210121212110221121111110210101111111010011a11111011
01111101011011111011111101111111111111111111111101100101011111201111222020201120212112122112111011011110222Pb211112010121101220121212110111011111111010a11111111
10111111111011111111111111011101111111101111111111110111111112111212212211011120100201002201111111101112211Pa110122201102112211101111101111101111011110a11011101
11110101111111101110111111111111110011111110101011110111111111112022202222222201010102212201111111100110222Pb102201022222111222220100011111011101111111a11111111
00011011111111111111111110111101011111011110011110111101001112121011221201120012111112110022101111110110020Pa201101212210121111122220111111111100111111a11010101
11111111110111111011111111001111111111110111111111101110011112111212110110002112102121221111111010111111110Pa011111111111111101011110111010011001110111a11101010
110111111111111111111101101111011100111011001110101101111111111111112120111222111210211aPPPPPPPPPPPPPPPPPPPaa01aaaaaaaaaaaaaaaaaaaaaaaaaaaaaaaaaaaaaaaaa11011110
111111101111101110110111111111111011111110111111111011110101022220021121202210112222010P02121111111001011100a11a111111110101101101111101011111101111111111101101
110110111111101110111100100111111011111111111111011111110111122111121121121222201121212P01121111111111101101a11a100111111111111111110111111111101111110110011111
111111101111111111111111110111100111100110101111111101110011121211022111112221110211202P11121111110111101111a10a111011111111111110011010001111011010111111111111
110111111111110111100101111110111111111111111111101111111110101221212201120021122212212P11220111001111011110a11a011100101111011110100111101111011011111110111111
011010111110111111111010111111111111100111110010111110101010012100110102121211111221000P01001110111111011011a11a101111111111011111111001111111111011011111101111
101111110111111111111101100111111110101111100110111111110110010001111100212011121211022P11211110111111001110a11a011111111111011111011101101011101111110011111011
111011111111110100101011011110101011011101111111111111111111011111011210122020020111222P20211111111011101111a11a111111101110111111101001101111111111110111011111
101101111011111110101111011111101010111111111111111111111111122221111222111221002122002P01120111111111010110a11a111110101011111101111001111111111100111110011111
110010011010111111111111111101111110111100111111111111011001111020022221211221221212211P12221111111111011101a11a101111101111011011111110011011111101011111111001
011111111111111111111011111110110101101011101111011111111111122001021021220122220202102P22021111110111011111a01a011111011111111111101111111111101111101011111111
aaaaaaaaaaaaaaaaaaaaaaaaaaaaaaaaaaaaaaaaa1111011101111111110122112121121111122121110111P22120110111011111110a11a101111111110111110110111111111011100111111110111
0111110111111101011100111111111111111111a1110111111111111111021111002112121221212112212P10120111111110111100a10a110101111111110110010011111111110010111010101111
0111111101111111111111111111111111100111a1111011110100110111112211211110201201201101122P10211101101110101111a01a111111111111111111110111001110101111110111010011
1011011101111011111111111011110111100111a1111110111110101101110011102022202022001102201P02121111111111101110a11a011111111111101101111010111101000111111111101111
1111110111000111101111111011111111111101a1111111111011111111102111202212121110211012021P00211111100011111111a11a011011111110111111111111111111111111111111111101
1111101111001011110101111111111111111111a1110111111111100111120022111222122111222012121P02221111111011111111a10a110111111111111111001110111111111011101111111111
0111111111110111111111111100111101111010a1111111110111111111121110021012221210211022011P11110100110110110111a11a110111111111011110111111110001010111111111111101
1111010110011101011111101111011100111110a1111011011110011111121011212201212112121212210P22021110110111111101a11a011111111111111111101111111111001011101111110111
0110111111101011101110111110111100111111a0111101111001110100021121021211211022022111122P10001101111001100111a01a001111011011110111001111110011111111111111111101
1011101110101111011111111101111111111111a1111110111110110111102200221111110122111011021P20121110101111100111a11a110010111110111100111000111110011111011111111111
0111111111110101001111111111111001111011a1011111111111111111121202021221210222111222012P22201110111011111011a11a111111111101001110111111011101111101111111110111
0101110111111111111101111010110011111101a1010111111110111111121111112221111212121210121P01221011111111111111a01a111011101110100111111111110110110001111011111000
1111000111011111111100010010101111111001a0011001111111001111111100111111111010011101212P10010221222122211120b01b111111111010111001111111111110001111111111111111
1110011011111111111101111111111011101111a1111111111111111100111111111111111110111110000P21012222121200022211a11a111111110011110010111111011010011011011011111111
1111111100111111111111111111111011111111a0111110011111101011111111111111111100111102211P02221102102122220120a12b101111000111101111111111111001111111111011111111
1110111111111111011111111110111100111100a1111111101111110111111111001111111110101100212P01111121021021012222a12b011110111111111101111101111111001101101110111110
1110111110011100101100001011011111111001a10110110011111110111111111011111111111101120PPa02020002012012022002a22b111110011111111011011111110111111111001111010111
1110101111111110110110111111110110111111a1101100111111111111110111111111111111001112P20b22111121002201022101b22a210110111111111111011111011111100111001111011011
1111011111111111010010111111111111011101a01011011101011111111111110111011100111101PP121a10102101211022110021b21a210111110111111111110111111111111111111011001111
1111111111110011111110011111011101111111a011111111110100110101111111111011010011PP01120a01121201022220122120b02b101111111011111111110100010111110110101111111111
1111111111111110011110011111111111111100a11111100111111111111101011101011111PPPP0102211a11221112222012102111a11b111011001110111111111100011101101010111111111011
1111111101101111101011111111111111001111a110111110110101110011110111PPPPPPPP01011112211a22222110112111221022a12a111100011111011111011110111101111101011010111101
0110101011111110011110110011010110001111a00011111111111111011011111P0111101011111112210b11212102220120111002b02a211111111101111111111111111111111111111111111111
0011110111011111010111100110101110111111a0011011111110111110PPPPPPP10111111111111111022a02021101222220222221a12b211111111101101111011011111111111011011111011011
1110111101101011110111111110111111110111a100111101111011111P011111111101011111111110110b21222101211120121120a22b111011011111111111111111111101111101111110111011
1111111111111111111111010101010110011111a11100PPPPPPPPPPPPP1000111111110110011110121112a20122222021221122021a02a210111111110111011100111111011111111110111100111
1111111111111111111111111110111111111101aPPPPP01111011100101111110010111011111101112221a10022201110122222112b01b211110111100101110101111111111101111011111100111
0111111011111011111100011101111111110111P0101111110110111110111101111101111011111002222a02211211211022102222b21a111111111011011011111111111111100111111111001111
1111111101110101111111101111111110011111P1111111111111111011110001111111111111111122012b20221112000121022011a12b211011011111111110011100111001111110111101111100
1111111111101111011111011101111011011111P1111111111001101110111011101111001111101122122a11121011121221212202a12baaaaaaaaaaaaaaaaaaaa0111111111101100011111111100
1110111011110100101011111111000111111111P1111101111111111111111110111101101111111112221b12120110011112101112abaaaaaaaaaaaaaaaaaaa11a1111110111111111110111110110
0111111111111111111111111011111100111111P1111100110011111001101111111001111101110110222a0221101121210212121111122011111110111111a11a1111111111101111110111111111
1111111111111111111111111111011111100110P0110111111110111011111100111001101111011102110b2210110112102111010212212000011110101111a01a1011011111111110010111100101
1111111111110010111100111100111110100101P0101110111100110110110111111101111011101110120b0022110112200021121122202110111111111100a11a1111111111111111001111110111
1101111110P11011111101110111111111111011P1111111111111011110111111110111111100111122211b2102121121012010211202101110110011110111a11a1111111101101100101100111111
1111110101P11110001111110011011101111111P1011111101001110111110111000011111110011110212b2020011212002122222121002110110011111011a11a1110110110101111011001011011
1111111111P10110011110011111111111111111P0111110111101111111111001011101111101010011011a2120202002112110021121212100011111111101a11a1111001011111111101111110111
1111011111P11111010111110111110111011011P1110101110111110011111010011111011111111112112a2220012122211121202212122111111111111111a11a0111101111111110101111111100
10111110100P0111111011101010010111110111P1101110111100001111111011111101011111111110212a0221022221211121221011111010110111111111a11a0111111111111111101101111111
01011111111P0111011111001111111011101111P1111111111111111111100111111111111111011001111a1101220111211021111222221101000111011111a11a1111101111111111011111111111
aaaaaaaaaaaaPPPPPPPPPPPPPPPPPPPPPPPPPPPPa1110111101011101101111111101111111111111110011b2222022121021210221221112011110011011101a11a0010111101011011111111001111
111111111111111111101111111101110011111000111110111111111111111101111110011011111101102b2210001111122112112221220111111001111110a11a1111101011111111011111010110
111111110111111011111111100001001111011111111111111111111111110011111010111110110121010a1122211221102101122200002011111111111011a11a1111101111011111111111111101
101111110111111111111111111011111111101111011111001111110110111111111111111111110001011a1111111111111011111111110110101111111100a11a0110110111111101111010011101
101110101001111110110101111111111110111101111111101111110111111101010011111111011001011a1111111111110111111111111111111101111000a11a1111111011101110111111111111
101101101101011010111011111111101101110011001111111011101111111110111111110001111111011a1100111111011011101111111011111101111101a00a1111111011111010111111001101
100110011011111011111011111111111101101011111101011111111111111110011011111100101111101a1111010111110111111111100100110100110111a11a1011111110100101110111110111
111100111111111110011110101111010111111100111111011111111011111101110111111111101111001a0100001011011110111101101111111111001011a11a1111111111111111111111111111
010111111111011111111110110111011111011111001111111010111011111111011111100011110011001a1111101011101111111111111111011111111111a11a1111111011100111111011111111
001110111111011111010111111001111111111101010111111101111111110111111111111100111111111a0011111101110111111111111101101111111111a11a1111101011011111111111111111
