17 10
132 106
118 42
15 7
76 66
86 2
64 26
50 31
133 26
97 97

221122112122101001011021212021211111111111111011101111110001010001111112221221122211000120212122121122110111101111111110a101111111111111111111111111100100101111
222221101211210221121212201122211111111111101101111100110110110100011112100021121112202102222112111121110111111111111101a100111100111111111101111100111110011011
112122222122011012100110220121210100110111110111001111011111111110111112221101210111222022121202211021000110111111111111a010111101111101101011111011111111111111
001211110212021222112212221111011100010111111111101111111010111111101011002222110120212101221202021121111010111011111101a111111111111111001011111011111111111101
110212121210210100122212222112211111011101111101111011011111001111111111111102102122022010212201221110101110111011111111a111111111011111011011111111111111110111
212111121201212121120102011212211101111111111111111111111111101101111110111222200212120112012222011121111111111111111111a110110110111111111111101011111111011111
121211222120021111221111120222011111111011111111001001011111110011110110201020122011022222001221220122100011111111111010a111111111110110011111111111011101011111
212120212111201010111220121022211111111011110111101111101111111110111111222110110102111222211201212012011111111101111111a111101111111011111110111111101111101110
222112012122220111202111211201210011111110101111001111111110111111111111111220111101222100210221212101111110111111110111a101011000110111110111101111011010011011
211211221022001210201212202010111111011011011011111110111111111111101001212110202221201212212221120221111011111111001011a111111101111111100101111110101111111110
baaaaaabbaaabbaaabaab1011222211111101111111111111111101101111111111111010122201222221221021220112011aaaaaaaaaaaaaaaaaaaaa110111111111100101111111111111111111110
11111220112212212121a2112222211111011111011111110021211021222101212112120111220210100201211121111110b01101111111111010011222220011101112011101112111200111111111
01222021001112212212a1022111002111111111111111011221122111111111111122221222120012210121111111122122a20111111101111101201122122221122221110121012102211111001110
21220201020011012212a0220202201111110111111111111222222211201002202022212211221122222212100222011222b11111101111011110210212121210021122011212122112210101110010
20122111221012212200a2201122121001110111100110001112201000222111211212022221102111212100201121111011a21111110011110111112220122021221221122101111212011111111111
21222122210121221112a2221222121110110111111111111111112210111101210012120022022012121211121021021020a21111111111101110120202222122212120110222101010110110110011
02211112021112221011a0022211211011110210221022100221122222221221022211210010121021202221202122122122a21111101111111111111210202120101021222221211212201111111110
02212222011212010022a1021111110111110211202120022001202222211210201221120200112211102021122011112022a00001111001111111000110012211221212211222221012011011101111
02201110111212121120b1120101202101121211212122211000020222022201221222221200102211212111211212210221a11111010111110111212211112202112221111221110222201111110111
00102211110211111220a1222202002111101011212112110022220222021122110221121212222221221212212012221000b21101100111111111212022212222010212201222211222001111101110
02111121100022221220b2211102121100010221211202012122220112122212222212122022220212122111101021120110b11111111101111011112101112121211110011200210111110110100111
21210212111200221221a2220111222111121112211221212010222211222001222111121202222221010211222021102210a01111111101101011211012110101022012012211212021111111110101
12200121121122001211b2112102112111101002222222112222022222022212211112122120122111222111221121011210b11010110111111101010022211200112012112220020222111011101111
21222221122111212111b2212121110101112101121101100112222022120122222212120222222102210011211221221201a21110110111011111121222112111011220112bbbbaaaabbaaaaaaaaaaa
11222200121112101120b1012110111111112002222011222222002122212212102001020222222220011022010022010022a11110110010101110201101011112211211102a20122212101011101010
22121011220002102201b2222122210001100101110110102210000121202201022212222220202220121211121212022211a21110111111111111010112111120111210111b10201212101111011111
22202101002212221221a0012221212111111211221120101222121222122100110011101222120220120210001010212111a01101111110111101222112222111111120112b12122201110111111110
21001012221012101221b1210221101111010201102100121222222022222222220110122222221210122220122211111120b11211122210012111020022201221202221220a11221212211011111101
02000222100110211112a2201001221111112121221012102220120022022020221122202212222202220111211012220221b21021211220122020221202212212212200111a01112122211011111111
10221222012110102222b2121111112110111202121121121221121220212201212210122021222022022210120111001210b21222012120222222222222000222222021100a20012202111110101101
01210012102222110110baaabaaabbaaaaaaaaaabaaabaaabbbabbaaabbbbbbbababbbabbbbbabababbbaaabaaababbabaabb01121012111120211122200120122002210212a11222010201101111101
1110111000111101111111111011111110110211212112122212022000102222122212221012021110111111111110111110110221221022122112012220220021210220220a22111101210010111101
1111111110001111111111111110111100111222212111202112211111202002200111100121111211111101111111111100111101002220222122221222222120222212221a00222112111011111110
1110010101111110111111101100111110112222211111200022212121122022010002221011122111111111111111111111111022120010221122020112022122011201021b12212210111111101101
1111111010111111101011010010111101100122112212210222221222022120202211011021020211111111111110111111111122102012222212220220022222222211212a21021121201111011011
1111011011111111111111111110111001120022120212122222010210222121222221022021211210111111111111001111111101212120120001222111222221212211022a10111211211011111001
1111110111111110111101111111110111102221101222220222221221212122221220221202101210011111111011111011110121222120102221122122012122211122012b12202101111101111111
1101101110111110011011111111111111112212112211120222122222202122111212212122212111111111111101111011111022211111112121022122122220222221222a12012210111101111011
1111111111111101101111111111111111021022201222212222022212121101211201211201202211110111111111111111111111122222021111221222222212222101222a10212100011111011111
aaaaaaaaaaa01011110111101110111111011121110120101000221102222221002001201112112011111011101101011101111022211121112111221221221110110112202b11211111111011110111
1111110111a10111111100111111111111011000122111101111100202202101212122220111011011101111111111111111100101210221111202122222012222210210202a22211201210001111111
1011111101a11111100111111101011110120210212120101012222022212021211101112102011010111111111111111100101020220102212022020202002212220012002a20021012210111111111
1111111111a11111111110101111110111022021210222111220122110112120101111111101111100111110111011001111111122122112200111010122021220121111111a11011111011101111110
1111111111a01111011100111011111110122012221201122002121121012122211111111111111110111001111111111111110110212122101212122211011221001111111a11101111011110110111
1111001101a11110110101111011110111110100120222120210111122220111011111101111111111011011111111111101101022102122221210111110010102221101101a11111110111111110111
0111110011a11001110111111111111111122221122202122110012222211111221110110011011111101101111111111110111022022020210010022110122212212110111a11111011111111110001
1111111111a11011101111101110000101120212212212012122110120121022211011111111101111111111011111101111011222012221011221222110221212111011111a11010101110110100111
1101101001a11111101111001110111111111111111111111110111011111010010111110100011111110110111101100110111212122222222122011202211201101111011a11111101011110111000
1101110111a10111101110111110111110111101111011110111110111111101111111111110111111111111001011101111111210111121111102221110121101221111010a11111101011000110110
1111101110a11101010111111101111110000110001110111111110111110111111111010111111111111101110011110111110122210200022122112010201010211111011a10011111111100101101
0110111111a11111111111110111111111001011111111111111011111111111111011110111110101111111111111111111111122220222101001012212111111201111011a01101010111111001111
1101111111a11110111011111111111101101011111111111110111011111120120212002022221111212011201011111111111100211022022021212221111012112111111a11110110111001111111
0111111101a10010010111101111111111101110110111111011011010111021012000102111111220221111220211111111100022210001121121001002220212122010111a11111011111111110111
1111111111a10011110100101101100110111111110111111110110111100102012220012121002221021020210211110111111102221120111001221010212001101211111a11111110100101111111
1101111111a01111100110011011010011111010010111101111011111111212221022121222222121121212221111101110111110020222210001122120012210012011011a11101011111110111111
1011111110a11110111101011111111111010111111011111111111111111102120102011001222201122110212211111111111202112220122021222022211212220200101a11111111111111110011
0011111111a11110111111111111101111111111011111100110111111110201221022202022100221222212112100010111101211202022111121022202220002100211111a11101111111111111111
1111111111a11101110111111011111111110101010101110111011111111121111210211211112021212211101111111111110121201112202211122100112022210211111a11111110111110101110
1011111111a11111010111111111111110111111110101000111101111011221101220221112021210122110111111111111111111111011111101111111110101111101010a10111011110101111111
1101111101aaaaaaaaaaaaaaaaaaaaaaaaaaaaaaaaaaaaaaaaaaaaaaaaaaaabbabababaaaaaabbaababbbaaaababaaaaaaaaaaaaaaaaaaaaaaaaaaaaaaaaaaaaaaa11111111a11111111111011101111
1111101111101100111101111011101011110111111111111111110001111220211211212121221221111111101211110111101110010101111111110111111111a11111110a11011010101111001111
0111111101111111010111011101111111101011111110010101110101101221112121122002100102022001212011111001110111111101101001111111111101a11011011a01101101111111011011
1111111101101111110111101010011111111111111111111001111110101121201111112121122101101121202110110111111110110111111111111111101101a11111011a11110110011111011101
1111110111111111111101111111111111111111101111111111111011011200111121102102222012222111212111110111011111111111111111110011111111a11010101a11111111111011111111
1111011101111011101110111101110111011111111111111111110111111122121111011121210120211112102210111111011111111111111110101111101001a11111001a11110111001101111111
1111010110111011011111111110111011111101111111111111101111100001212222111221220202101221021001111111111111110111111110111100111110a10111111a01100110111110111101
0111011110111111100101111110111111101101110111101111101110111111022122001222201112102012010211111110111111111001111111011111111111a10010111a00110101111011010011
0101111111111101011110011101110111110111101111110111111011101100112220222222122010101001210001101110101111101111111001110011111111a11011111a01111110111110011111
1111111111011111111111101110011101011010111111111111111111111212201010121012220102202220112201111111111110111011011101111111111111a11011111a11111110111111101111
1011111111111101101111111111111110111110111011111110111110101111220121200202201101021110021011011111101110101111111111111110011111a11111011a11011111111011101111
1111111111111101111010111111111110011101111111111001111111011020120122122202120110111220111111111011111110111110111111111111111101a11111111a01111111111111110101
1111101110111011011010100111111111110100111110110111011110010002112101222112111221111121122111111101111111101011111110110101011110a11111111a00111011110001110101
0011111101111111110111110111110111111111111110100011101110111011221002111012110202111111221111101111110011111111101111111111011111a01111101a01110111001111111111
1011111101011110111111101111111011101111101110110111111010111111212011101121012102122010202011111011111111111101111011111111010111a11111101a11111111111101111101
1111011110101111011111101101111111011110111110111111011101101010001121221110221021222221012101011110111111111101101111111101111000a11111101a11101111111111111101
1111011110100111111110111110100011111001110111100101111011111202222001102122221210111022212111111011111111111111111001111011100101a11101111a10111101111111110111
0011111111111111100011011111100111111111111111111111111111011010112021211222022222001012210010111111111011111111111111111100111110a11111011a01111100101111111101
1111110101101101111111111101111111110111100111111111101111111022221211121222210202202112222211101111110111111010111111111001111111a11101001a11111111111111111110
0101100111011111111111111011111011111101111111111111111111111002202211112110211211012111012211110011111111010111111111111111011011a10010101a11011111100110111111
11111110111110011111111110111111011111101111001111111101010112001122221120220222102221221102101111110111111111aaaaaaaaaaaaaaaaaaaaa11111111a10101111110101111111
01001100011111111101110011111101010101111111111110011101111112122112112121111002202212101221111111110111111111a1101111111011111111111110001a11111110111010111011
11010111111111111111111111010001111111101111111111101111000112221122111021120222021211212200111111111111101011a1110111111111111111110101111a11101101111110111101
11010111110110111111101101011110011110111111101111010111111111011011011111111011111102000211221202021122211111a2011111111100100011001110101a10111011111011111101
01011011111011110111111111111111111011111101110111101011101011101111111101111111111201112212112220121112211011b2011011111110111111111111111a01101111101111110111
11111011111111111111111111011111101011111111100111101110100111111100111111111111111221202202111220111222111211a2111111111111000111110110011a11010110111101011111
11111110111111011101111110111111111111111111110010111111011111111111111111111111111222221221112022121122111121b1211011111010101111010011111a11011011011110111111
10111000111111011110110111111111111111101111011100111111110111001111110101101111102101212110020201102221212210b2211111011111111111101101111a11111111111111111010
11111101111101101111111111111110001111000111111111111010111111111011111111111011110112021221220212212212021211a2011111111110011101011111110a10111111111011111110
11100111110001111001111110110110111110110111101100111111110111111111111110111111111010120022022222211021122222a0011111111111111110111101010a11111111111101011111
11111101011001111100110111111101011010110111110011011111101110111111111110111111111111202111001211011111111112b1111111111111011111101100101a11001101001111111111
aaaaaaaaaaaaaaaaaaaaaaaaaaaaaaaaaaaaaaaaaaaaaaaaaaaaaaaaaaaaaaaaaaaaaaaaaaaaaaaaa12200102212202022110111110112a1111110111110111110111111111a01101101110111111111
11111101111110011011110111110111101111111111101111111110101001111101111011011111a12102200120221221112211122100a1011111111111011111111101111a00111010101111111111
11111110111001011101111111111100111111111110111111111011101111111111011101100111a11121221211111101202222212211a2110100111101111001111101110a11101111110110111111
11110111110101111111111001111111000011111111011111111011101101111111111101010111a12202222211001220112122112212a2011101101110111111011010111a10111011110111110111
01111111110111111111010011111110111111111101101101111111111110111101111111111111a11000101221021011021222112112a1100110111111101111111111011a11111011111111011011
00111111011111011111110111010101110001111101111111110111011111111111101111010101a12220221111022110010022221121a2010011111111111111111111111a10111111110111011011
11101010111101011110110111111111111110001111101111110111111111111110110111111111a01101002111111111211121100212a1110111101111101001111111011a00101111011100011100
10110001011110111111111011111101111101110111101111111111110111111111001111111111a10111222001212221210212011112a1011101010111111111001111111a11101111111010111111
11111011111111101101111111101111111011110111110111111011111111111011111111011011a12110112102021110120020122210b2211111111111011110011111011a11101011111110110110
11111110111111100111111111110111111111011100011011011111010111011011101100111110a12120102200211112111122201101b0210111101110111101111011111a01111010111111111111
11101110111001111111111111111111111101011101100100111101111111011111001110111100a11221021122210112212210111111a1011101011100011111010111101a01011111111111110111
11011111110101110011111111011101111001110100111100011111101101101011001101101111a12202202111121211211121221201a1201101111110110111111010111a01111111101111101110
11111111011110100110111111011111110111101110100101010110000110111010011110111111a02221112222202212111112102111b0011101101101111111111111011a11111010111101101111
01101111111011111111111101111011111111111111111101110111111001111111111111111011a10121221102202122222012221122b1111111111101100111101011111a01110111101011111111
11111111100111101011111111111111111100111101111110111011011111111110011100111011a11111010210211102201022101021b1211111111101111111111101010a10111111001111111111
01111111111111111011110111110101110110110101111011111101111111111110111111011011a12221012111112112011111012022a2211111100011111100111110111a11101100111111111110
11111111110110100111110011111111111111111111110101011011111011101111101101111110a12022221220202201121120222021b1111111111111111111111111100a11011111101101100101
11111101111111010111110111110011111110111101111111111011110111111111110111111011a11122121111222202022022101222a1210111001111111011111111111a10111111011111011111
11101010110110111101111111111100001101101101111110111111011110111101111101110011a10020211022121121122211201100a1211111111111111011101101111a11111111111010010111
01110011111111111111110111101111111011101101111111111011110111101101111110111111a02022211202121110001102120121b1001010111111011111111110111a11111110111101111011
aaaaaaaaaaaaaaaaaaaaaaaaaaaaaaaaaaaaaaaaaaaaaaaaaaaaaaaaaaaaaaaaaaaaaaaaaaaaaaaaa11121111220101122110011122221b2101111111111101011111111111a11111100111011011111
10011111110111011111011111111111111111111111101111011110111111110010101001111011112100010212202122202211202200b2110110111111111111111111111a11111101111111111111
10110111111101111010011101111001111111111111101111101110111111011110111011111010111212121221112121102022101110b2110111111111101101111001111a11111111111111110110
11011111101011011111111100111101101010101011111111011101111001111101111110011111101101111111111111111111111111a1011111101011111111111001111a01111111111001101111
10111101011100011011111111111111111010111011110011111111101111110011111001111111111111111111101101101110011011a1111100101110011111111111111a11111111100110001011
11111111101111101111011100101101110101011111111110110011111101111110011110111011111111010111011111101011101011a1011111101111101101111111011a11111110111111101011
10111011111111101001111111101011111101110111011111111111111111111111110111111111101111110111001011111111111101a1111111110111011011101110011a10111101111100110011
11111110111111111011111010111111110111101010110111011000110001011111111111110111111110011101111111111011110101a1111101001111111111011111111a10111101111111111101
11001111111111111111111101111110111011111101111111001111111011111111110111110110111111101011101111111111111111a0011100101111010111111011110a11111111110110111111
10111111111111101100111011111111111011111100011011111101111110001101101110101110110110101101111101001111111111a0000111001111101111001111111a11101111011111110111
