22 2
103 11
118 42
15 7
76 66
86 2
64 26
50 31
133 26
97 97

1a211112a2011022101111122112112111111011111011111011011011111111111111121122112002211122101120211010211111111111111110101110111111111111111010111111100111111111
1b201211a0122212211121012111012011101011000111111111111011101110111111112121202010022001122221112110001011111111110100110111111111011101111101110111110111111111
0a120220a0210121022111111211222110111111111111111111110101100111101110111122111112110220111010221120101111011011110111110110111111110101111111010011111010111111
0a121012a0212112222121212101210101110111111111110111100111111111110110012220201212111110010210122121010110101111111111111111111001111110111111011111111111001111
2a101221a0121222221022211011112100111111101111111011001111111110111010102111110201122120212211222122111110111011101111111010101111111110111110111010111111110111
0a221122a2222002212012111021212111001011111111111111001011111011110101021210122210122112111111102101011010111110111111110111111111111110011111001111110001111110
1a112112b2211112100112122011110111011111011011111011010111111110110111012121221000122220221122112012220110111111111111101111011011111111111101111111101111110111
1a222221a2122101120202222101211111101111111111111110011101110101111111001010200021011111021122221222120111111110111011001111011111111111111111001111111111010111
2a100122a1001222222101110010222000011100110111100011111110111101111110022121021021111021222121201021221101011101011101110111010111111111010000111111111111111101
0b222222a0221212101122121022111101111111010110111111111111111111111010111102111211102101110211120122121111111101001110101011111101011100010011110111110101111111
2a012222b2111110002210000102022111111111100111111100111011111111101111120102221220102012122111020112211111111101011111100111111111110111110111110111111101111111
2b111122b1211101211101110211012111101111111101111201212112121022110021022021222201212121111111010012121110011101111101110220212210221112221222112122211101111001
2a222222b1212112112110201022212110111111111111010202220210010020121112122122222211120111022200010122211111111111110011222222221112111120122112112121111111101111
0b112122a1000121211001211210011101101111101111111121101121102210210221122122101211202112200121210121221101111110111111201221201021202021122012201112211111111111
2b121120b1221120212120121210110110110110111101111201210111010022212011222210022200022222121220111121121101111101111111101111011101021112121112220221211111011101
0b211111a2220211111010102212221111101111111111111222221112121202212220120222212202121222211021211022201111111011101111112102102211202011011210121210211111111011
0b110221b1021021021011211111012110002200221211112222222211210222222010122212120010101210122110212222211110111100100111112100002011112122100221012121211111011111
1a222212b0121221112112210212101011122111121111112222022102022010111121120212122212112112112211202012111110110110111101111212212220112211120122002121211011111111
1b121221a1111122221122022211111111111212001111021120201221212222102122121222221201202011212220121110001010111010110111221121122222122221010201121011111111011101
2b101220b2110212102202022211222110120111222211002222212212122222220211221021021212222202112020111022011110111111111011022222122021220112121121120221211001110101
2a211200babaabaabababbbbaaabbbbaaaaaababaababaababbbbaaabbbababbbbbbabaaaaabbbbbababbbaaaabbaaaabaaaabaaaaaaaaaaaaaaaaaaaaabbbbbaababbaaabbbaababbaabaaaaaaaaaaa
2a21211121110122021121220122222111120121112112022101211221220222022112221120022212222200111111122111221111111111111101221102210112112111112202101120211111111111
2a10122111120102221220122122121000112201111212121022202212221222221120221222120122022111002121100211211111111111011101210212000111101110121022102112111111111111
1b22212121121212201122210212000111112221212122220112021000222221221222222122202222111012220212202102211101110110111011100022012120212022021211212110111101111110
2b21222202222210211222211111101111112102110011001222122102120022022101020122220020021101021211212202021111101111101111012102122122001220012121221201211111111111
1b02120101212211100210211122121111122021002211020012212221102022211222120201122212110012022111101222021011111100101101221012211110221111212121222202111010100111
1a21010222112120211100202021201111112221101221111222221022212100011211000222222212201222210021100121011111111111111111110120112121201101012122210110111101111011
2a21211112002112211122022210112011020202101212111002022212201011021000122100112221011100022211220120111102221222201221222212202022020210111020110210211001111111
2b02200210202201101212211101002111011121011111011222001220211211221101022222221210120220211222000011021210222220112012222111222222200222212022002111101111110111
0a02111112001221122212112021211111112212111111111022222222222211222012012120222222112011222020102122021212210200122122212221220222202121111221011111011111110111
1a21221012211010221112122022112001102020220111210212222222212210221020220222222222101011121121010120120001021111222212122220122222222202211221112121110111111110
0a10011111111111011111111111111111111011122221222212221222220100222122011111101111111111101111110111101021121202101222202212220201202212121111121212210111110111
1a10101111111111111011111101111110021102002121010222122122212212121021220201110101011001111111111111111110121221220102222022222122021111200112021222110011011110
1a11111111111111101011111110111011122212012222122201212222222222121202222010202211111111110101110011111220121221111222200012122212020212221210211212110111111111
1a11111011011101011111111110110111122222221022110022202112222022100211222111210100011111101110110101100022222100020100201222020211222022012202001101211111111111
1a01111111111111101110111011111111122110000212221020202122012221121111210201201111111111101111011101110021121111221201222221111222020022211010211112111111111110
1a11111111101111111111111011110011112121122212202222220021211112201012100202121011111111111011110111111122212120211122222221020100222012002211202002111111111101
1a1011111111111111111111111111111111221221202221211122212220212020211122221222121111011111110111110aaaabbaaaaabbbaaaaabbaababbbbbbbaabaaaaaabababababaaaaaaaaaaa
0a1111011011111110111101110111110112111221221101122212002112112221021000111221211111111011110111110a011121111210210001122222220120220122222112211212111101111010
1a1110111011110110111111111001111102112010121211122122221002202220110220022221100111111011111010111a101212202020122222102221202222212112001200102112210111111111
1a1101111111101011111011111101111100012012121220222002200021002122121212222120110101111110111001111a111022211110122110222022022221121201221100221022111111011111
0a1111111111110011111111011111111110201222121022221120122222200202221111112011021101011101111111111a110122210121211210210120112022212210120120112112201110010111
1a1111111111000111111110111111110102022021212111221202122101212212111111111111100111111111111110101a101012111212212121020220212122022210111111010111111011011110
1a1111001111011010111111101111011111022110200101021021122102020122111100000111101110011111111111110a101121212121222111202012111222112110111011111010111111011111
1a1111111101111111011111111100111110022122221012112021121111211121001111111010111111111111111111011a111102222121211222221221021122200100011011111111111111111111
1a1110011111111111111111001011111112021211211011202020001112212221111111111110111111111110101111111a111112102001120111222202202020111111111011101111111011111111
1a1101110111111110111111111011111112001102112100221222222112222201111101011010111101011100100111101a110222011010222021012200111220100001111111100001011111011110
1a1111111111111111011111111101111111111111101111101011111101111111111010111101111000111101111111001a111112201012111102102121121112222111111011111111111101110111
1a1111111101011111100011111110011011111011011010100101011101110011111111110100111111101010111101110a110122102210110120222001121222122211111101111111111111110111
1a1101111011010101111001111110011111011110111011011111111110111111111111011111111011110111111111111a101122111012112010112212000021111200111111110110101111111101
1a1111111111111111110111111110110111111100111101111111111011101011111110111110101110011111111010111a110121120012120002021102012110102211111111101101111010011111
0a1100101100110111111101100100111111111011101111111111111111101121211210121112212110021122221111111a101022211221212101121121202021100100111111111010111111110111
1a1110010011111111111111111111110011111011100101101111111111102001122001211021212111121101211110110a111211121200001201200111112212112011111111111111111111111111
1a1111001100001111111011011101101110111011111111011010111011012101122122211211110221222111111101011a111221210111010110222112011012221211111011111111011101111011
1a0111111111111111110111110001111111011111110111111111111111111202121222222212210112210212011101111a110112110220001211221101012222122211111101011111100100110111
1a1110111110010101101000110101100101111111111011101111111110111100222111112121201222221101211111100a101212120121120212202122121220120111000101000111011101111111
0a0110011011111110111101101111110101111111110111111111111001102221121010211202110001121112011011111a011221221120111102122111121121202111111111011011111111100100
1a1001111111111111110110111101100101111111111101101111111111111221011212000201112210110221121011010a111212111001121002202220011221222211111111101011011110111111
1a0111011101111110111111100111111011101111101110110110111111012112212001020111211112020212011111110a111011111111011111111110101111111011111011101111111101111111
0a1111111001111111011110111111111111010111110111111111110111122211111212001102100222212212221111011a101101111111101110011011111010100110111110111111111110111111
1a1111111111111111100110100110111111111111001111101111111111102112212121020101121202211020121010011a111111111111111011111111111111111111110111111101100111100111
0a1111111100010011111011111111111011111100110011111011101110121210112110212220112121022122121110111a011111111111001101110111010110101111110101101101111110111110
0a1101111101111111111011011111001011001101011111110111111111102010222001020112212211111002110110001a110111111101111110110111111111111111101111110100101110011110
1a1111110111111110111011011110011101111111111011111111111011011102222112221010012221200011111101111a111111111111101111111111110111110111111111101010110111111110
1a1111111110111110111011111101111011110101110010111010111000100221212100102111200122221122101110100a110111011111110111111110110111111111110111010111111111111101
0a1011110101111110011110101111111111111101111011111111111011121112111102122011122022201122100011111a111111101011110011101000111110110011111100011111111110010101
1a1111111111111110111111110111111111111110111111101111111111011122221221012201212112222112221111111a111011101111010001111011011111111010100111110111110111111111
1a1111111101110011111101111110110111111111010110111111010011011211110122221211121221111012001101111a011101111011111111111111111111011011111111111111111111001011
1a1111111111111110011101111111111110101111111101101011110111122202222122012201101212111121101111010a110100101111011111101110100011111110011111011101101111101111
1a1111011111110111101010111111011110110010111111110011111111112221201020202022121222221220101111111a110111111110110110101111111111111111111110110111111111111111
1a1111111111011101111111111011111110111111111111111011110111110110121112012111221200011122110101110a111111101111111111110111111111110011111100111111111111110101
1a1101101011011101110111101110111011110111110011111101111110000112212111021120122122121211021111111a111111111111111110101110111001111110110100111111011111010111
0a10101111110110111101001110110111110111aaaaaaaaaaaaaaaaaaaaa21222111220221110101121220010121111111a111111110111010110110011010011111110111111111101111110101011
0a11111111111111111111111111111111110111a1111011111111111111a12111221121212220121222120122020111111a111111101111111111100011110011001111111111111100111100111111
1a11110100011111101111111111111001101101a1111100111111101111a20220121120112012111111002111210111111a111111111111101011010111111111110111111111101110111101010101
1a11011110111111111111011011111101111010a1001101111011011111a12100011022211212212201021200111111010a111111111110011011111111111111111111111110011111111111100111
0a11101111110010101111001111111111110110a1111011001111111110a11111121212221021020011121101101001111a111011111101011111111101111101111101001110111000101111101111
1a11111111110011111110111111110101111111a1011111111111110110a10222221201112011122110002202111001111a010110111110111110111111111111111010111111111110111111010111
1a11111111100111110011111101111111100111a1101110101100110011a12101110121001011221222102211021111111a110101000111111010111111111101111110111101111111101110001010
1a10111100110111111001011111111111001111a1110110111111111110a01110210121121221120012220122121110111a110111111111010100111111011111111011011111111110111110011111
1a11111111101111111111011111111111111001a1010110111101111111a20212112222121112202211110211211111001a111111011011111111111001111111111101111101111111110111110011
1a11001111110001011111111110111111111111a1101111111101010111a21222122021222000011122021220200111111a101111110111111111101101111111111110111111011100111011111111
0a11011111101111111010101001111001111111a1101111111111111011a01111011111101110001021112212122201222a222222211102211001111111111001111111101011011110111111111101
1a11111011111111111011111111111001110110a1111111101111110111a11100011101011111111112211102222221121a012121121111211111110111111101111011111011111111111111111111
0a01111111111001111111111101111010110010a1111111111111101111a01110010111101110111112200002121211120a121202122222211111111101111111011111101111110110010111111111
1a11011111101111111110111110111111110111a1111111111111111110a11011111010111111001122112211222221210b221202221111011111101011101111110101101101111101011111111111
1a01001111110111111111110111001111111001a1011101011111111111a11110111011101001111111201000122222200b021121202200011011011111111111110110101111111111111110111101
1a11111110111110111111111111111111001101a1110011111110011010a11111111111010111100122220222111221112a021221122112211111111101111010110010101111111111111010111111
1a11101001011110011111011111101110111111a1111111111111101111a11111111111111111110122222022011210222b101111111021211101110001110100011110100011111010011111111011
0a11111110011111111111111101111111111111a1111111110100011111a11101111000111111110100222212020112011a112211102010210111111111111111111111111111111111111111111111
1a11111111111111111111101111111111110011a0110111011111011110a10111110110101111111112200121112211222a121222012102101111011111111111111111110100111111111011111111
1a11111100111101111100111111111101110111a1110011101111101111a11110101011101111111011121200111121112a201101222222211111101111011110111111111111111111101111111111
1a01011100111111101110111111100111101111a1010111111101111011a11110110111101111011120121122121122122a211111210102211111001110111111001110111011111111111111111001
1a01111111111101101110110111001111011101a1001110101110101101a11100111111011110110122110111212101121a121221201121211010111111001000111110011111110111011111101110
0a11111111101110111111110101100111110101a1111011111010111111a11101111111110001011120022022210222010a210012222212111110111111101111111111111111111101010111110101
1a11100110111010011101110111111111111011a0111111011111111011a11110101101111111111121112211221222212b211112222110111111111111100100110101011001101111111111100111
1a11110100111111111101000100111111011111a1111111010111001111a01111111111111111100112111110002222120a112212102121111111101111111111101101111101111111111111111011
1a01111111110111101101111101111111111110a1101111111001111101a11111011111111011110100121211011221012b221202002220210111111111110111111101110111111001101110111111
1a01101111110111111111101100111111110101a1111111111101111111a00010111111101101010102121121222222122a221011211102111111011111111110111111110111011001111111100110
1a11111001111101010110111111111111111111a1111110101100111001a10110110101101111111111211122021212022a222122201122211101111100111101111111011111011100110110011101
aa11011111011111111111011111011111110111a1111011101111110110a11111111011010011011111222210122200200a202122101211210010111010111010001110111101111111110111111110
0111111100101110001111011111101001101110a1001111010110110111a10100011011111111111122120111112022211b221121222112211001111111011011011110111100011110110011011110
1111101111110111111011111111111000111111a0111111111110101111a10110111111110111111112222121201202221b121222101112111111011001111111011111101001111111111111111011
1011111011111110111111110111100111111111a1101101111111111111a11111101111111111111120112202211200122b111101012001011111110111111111111111101111001011111111101111
1110101110001101111111100111011111011111a1111111110011111111a11111111011110110111111212121201122122a101200222201010101111111110111111111111111101111011101111011
1111111111111110100101111111111111111111a1101111110110111101a11111011110111111110110001222022221200b221211222212111110011110011111111110111110011110110111111101
1111011011011111111110010111111111111011a0111110011111110111a01101111111111111110001121111121120101b111112012120211111101111110111110001111111111111110111101111
1111100111011101111111111010111101111111a1110111100100110111a01111111010100111111111122002010221212a220102102211111110101111111011111001111011111111111111111000
0111111111101001111111111101111111110111a1111011101111110111a10011111111011011011121122222202211121a020211122220201111011111011111110100011011100111111111101111
1001011101110111111101111111100111111101a1111110011110101111a00111111111101011110121121101112102102b221021111122211101110110111110111111111101011111110111111111
1111111111111010111111111011111011101111a1111111110101111110a11111111111111111010112111021112221012b102101001122200110011110111111110111111110111110000101101110
1111111111101111111011011011011111111010a1010111101111111111a11111111001101111101121220211122021212b122100222000111111111011110101110111111001111011011111100111
aaaaaaaaaaaaaaaaaaaaaaaaaaaaaaaaaaaaaaaaa1110111111110110111aaaaaaaaaaaaaaaaaaaaa101012111111210222a210110020122211101001101011011111111110101111110111110001011
11111111111111111111101111110110111011111100111111100101111001111011101111111111a111110011101101111a111111111010011111001111011111001010011110011111111110111111
01111110101001011011111110101111111111110111110111111110111011111111011110001111a101011111111111000a111011111111011111110111011111111111111111101111011111111111
11100110111101010111111111101101011101110110011111111110111110011111110110111101a111111111111111110a111111111101110111111100111111111111111111111110011110110111
10111111111111011111111111111111110011111111100111111111011111111111101111111111a111111111111111011a111110111111111111011111101110111110001010111111111111011100
01101011011101111111110100011110101111110110111111111111111110011101110101111011a111011111110111111a111111111111111111111101110110011111011111101111111111111101
01011110101101010111011111011100111111101101111010111111111011111101001110011110a111111111111111101a111111101111111111111111111111111111111101111000100110110101
10111011100111111111101111111100110111111111110111111011111111111111011110111111a111011111111111011a011010111111011011101101111111111111111011101011111110110110
