17 10
132 106
118 42
15 7
76 66
86 2
64 26
50 31
133 26
97 97

20212112201202222112120121021210111111101111111011111111111111111111010001111222a1011110022102112101111111101101110111111111110101111100111a110110a0111111101111
01121020012002021212020122101221111001111111111111101111111101111110010121222102a1111121222121201212201111111111110111111101001111111111010a111111a1111011110111
21021220121022112102001122111021111110101111111011101110111111011111111021222220b2221210122102120102210111011111110011111111111101111111011a111101a0111110111111
10121012122012221202111221120211111101111111111111111111101111111111100211101122a2211210111211121120211111001011111011111111110111111011111a011011a0101011111011
20211121212120221212111011122011111011111111111111011011111111011111111022112210a0211022002202001121121111111011110111111111110111011011010a101111a1111101111101
11121122210021211201110222102111011011101111111110111111110111101101011211212121a2110121221111100221211111111100111110111111001111111111111a111101a0001111011101
02102021122202211020101210212221111111101111111001111111110111111101101122222110a1222200210121201110111110100101111111111111101111111101110a110011a1110011111111
21221012111101210121121102022200111100111011111111111111011111101111111121221122b0200112110221211221021111111111011111011111111111111111111a011111a1010011111111
01221212111112220211100222111221111101011110011110010011111011111101111200011222a2112101222111222110201101100101100111111110111111101111011a111011a0100111111111
11211112111110211221111222210120111111011111111101110111111111111010100111122212b2111120100011111012211010101101110111111011010111011011111a111111a0111100111111
12122001212001022P02222122012100110110111110001110111111111111111011111222122110a0212222120112022211220111011111111111111111110111111111011a101110a1110110111111
20121101211221021P22120002112101111001111111111102212202120120222022111222012222b1011011221221010011221101111111111111020110210211122112120b122012b1111111111011
011110012212011110P2210212222111111011111011111111210100221002012022001222202002a2211201202002021012211101011011111111201212202101211122021a221202a1111111111110
010210222110212122P2202001112211111101011111111012111110212101101222220212211020a0122122212102220011111111111001101011221022000112210002201b111211a0211011111001
1111221122021222110P201222111221010111111101110010122010000212211212211202221222a1011100212101021012111111010111101111102111211201011121212b201021a2111111011111
20012121220200112222P22202222101011111111101111111111221112101101201221101222002b0111222011121012122211111111011111111121212220002212112111a220011a1010100111110
121002022101202202102P2212011020011202221112111112220221212221100212021102222201a1121211121222012202221010111111010111122112001112122120012a222211a1111111011111
20211101121120221120P22212110111111122201001201221122211201200220221212101212202b1010111120110112122111111111111111011222112222101212122011b121121b1011101110011
210222110122211121201P2221120201111021220122121102222122022222212021210001022220b1002011101221202120211111111001111111201122122122002120221a112101b2211001101111
2102211212112110201200P221021021110020021111021011220022020122122122211212222012b0202012112002102011100101111110111011100022011121212121120a100211a2211111001111
1210122121121221111111P112012120011212212102021121222212221222222211222222022122b2221221211122012101111111111011111111211210201221121120211a211102a1101111111110
2202211112102212220222P210122121111201221210111212222020222220012221020210222111a2222202121002111202111111111101111111002000122001120111121b212111b0011111111011
12201010222110122100112P02111221101011202120102022211220201220122011121202222222b0202122212121111100101111111111111110102111222221011201122b122120a2110000110111
221201212020122112221220P0220121111111201210110122022112020221200102122222121022b1211212212121111221110110111111101110111212100021212120122b222121a2111011101110
111120201022210000201212P2112221111112121111111221012220221220221122221222220121b0102111211211221221121111111110001001102112222121112122111b121102a1211100111111
120012211221021222122221P2101001100112021222112022221120220202222202102120210202b0100201112010102212120101111111011111201112122120202212221b222220b1111111001001
2121111110122222020121012P122111111212020122011222220202110202222011211001221212b0121121220020221101021111111010111101021021011122112221111a002220b1211111111010
0112222121111000111212211P121101101112211111112121012212222101221122022102222222a2121122110021211222121220201210022112222221221221110221112b111012a1011111100101
00021202112210101221012022P21200110111101011122121022220200222122212122222012011b1122112201121110201111110002221221012222222200221221121111a210220a0211101111111
22222021110121222011220122P22211111122120111120211222202110202222200110202202222b1020212120112121220211221001211002111021122022220122221212a112100b1211111011111
22001011120120202121102101P12210111111221121212110102202022220220101112011000221b2200010222111122211121212112101220102201222122122210022112b120201a2211111011011
011111111111110110110111010P0101100102221111102221022201212222122222222011012202a1101111001111111111111111021110222212210020022202222201011a221211b1211101010010
111111111111101001111111110P1111011222121210212201202222220222222211222010011112a1111110101110111111101221221111011011222122222210222211012b210220b2111011111110
101011111111110111111101011P1001110222202022212122221220220100201211121210000112a1001100111111011111111012111010102222202222202012020020021b100221b2111111001111
101101011110111111111111110P0111111222221221002012221022212001212211101111122222a1011110011111111111111211020022122011212212012022222011220a111221b2201111001111
111111111111110011111110011P1111101011112112222222022122222210222200122211110122a0111111111100111101111111021100112020022202222002022101122b210112a1110101111111
111111110111111111111010111P1100111022021122000122220202222221220212222121002002a0111110100111110111001111222102112201120012221202111211122a212001a2211111111011
100110011111111111100010111P1111110222110121211012121020002110021200120020002100a1010101111111111101111122110211220212200222201012221200210a020220b2000110111110
0111111111111101010111110110P111111002011212220012202222122121222012201110112001a1010111101111000110110201122122100222222122220202111222222a122122b2110101111101
1011011101111110111111111111P111011221211111121100222202122222202212021211121011a1111111110011100111111211101211111101010122220022220221022a022101a2111111111111
1101011011000100111111111110P001111122201222101102222121012222122222121101221211a1111110111110111110111221000012220100122212222221111011121a112222a1210100010011
1111110111011011111111111111P111011002122212201122220121222202202200222212111020a1111101101101111011111001222200211020210210221222202212122b021122a2110111111111
1110011011111101110110111101P110111212201222221122202221110221112211110011111111a1011011111101111111100210211100122222122222112120212211110a111111a1101111111111
1111111110101111111111010111P011011120100211112110120211222122111111111011011111a1111111011010100111111111021220112102222221101102120111101a111100a0111001111001
1111110111101111111111011101P110011201201211010100221211012112122010111111110011a1111111111110111101111201022211121121212102022121001211011a110101a0101111111111
1111011111111101111101101111P110011012022122211011112111111120212211111111111001a1001011111011111101111102221211111212121211222200210201101a110111a1111111111111
aaaaaaaaaaaaaaaaaaaaaaaaaaaaaPPPPPPPPbaabababaabbbabbabbbbbbbaPPPPPPPPPPPPPPPPPPP1101111101111111111111111111211112102121212221102012201011a011111a1111110111111
1100111110101111111110100111101111111P11011110111111110011111P0011111111111101111PPPPP11101001001111111120120111222111022101212021102111111a100110a1111011110111
1111101111111011101111101011111110111P11111011010111100100110P110111111101111101111111P1110101111110110210102202111102221222222220112101110a101111a1101111101100
aaaaaaaaaaaaaaaaaaaaaaaaaaaaaaaaaaaaaaPPPPPPPPPPPPPPPPPPPPPPP11111110111010111001101111P000111111111110111110100002210112101211022112111111a111111a1011001101111
111111111100011101101111101111011111111111111111111111111111a111111001111101110111110101P01111111111011212222002111221210112211221112111111a111010a0111111011111
101111101111111111111111111111110111111111110110110101111011a2022112212211222210022111221P2110011111111111111012102202122112122122221011111a111111a1111011110101
111111011111100110111110101111111111111010001111111111111000a11011121120022121211202222002P101111111111122122021112212110102202121112010110a111111a1110111111011
101111011111111101111111011111110111110111011100111010111011a212022102121001120112220212221P11111101011111112220222020122221011012012101111a011101a1101111100111
111110111111101101011111101111111101111111100111111111110011a2222012122122122220012112122111P1111110111002112212012222221101112202111011101a101111a1011111101011
101111001101000101111110111111010110111111111111111101011111a22212111122111220112122112111020P111111111112212121222211121111111201002111111a011111a0111111110111
110111010111011111111111001111111111011111111011111111101111a02101221222222000102112012111211P111111111221220210222222112212221120120011111a011111a0100100110111
111110110101001111101010110101111110111011011111111111111111a22210101111101111210121101121101P101011111201212112222222211012112110212211111a111100a1111111101111
011010101111110111110110111111010010011111111111111111010111a112102222102212121112212122120111P01110110111000111011111111110111111111110110a111011a1001011111111
111111111001111011111111110111111101111101111110111011111111a1222101011112121110012222211000110P1111101001101101100111111110111001111011101a110111a1111110010111
011011001111111111111100111111101111111001011111011110011110a1212212222212111101012100101110011P1111011100111100111110111111111111011111001a110111a1111111111111
111111101111111111111010111111111111011111101111110110001110a12212211211221101020211211220121101P111111111011110110101011111111111011011111a110111a1101111110101
011111111011011011111111110111111011111011111100111110101111a121100112101121011102220212221111110P11111011111111111010111010111110011111011a011111a1111110011111
011111101111101111111110111101111101111101100111111111111111a2112110122112222110121010121022111101P1011111110101111111101111111111110111111a111100a0111111111111
111101110111101111111111011111000111111110110010011111010101a22112220120111122202001021222200110011P111101110001111111111111111111100111010a111111a1100110100111
111110111111110011011111111111111011111111101101111110111111a201212201021001001211212020101211101110P11110011101011011111111111011111001111a111111a1001111110111
001101111101011000110111010011011010111111111010111111111001a122212202012100221121022101120211011111P01111111111110111111111011010111101111a101101a0111111110111
111011101011101111101111111111111111111111110011011110111100a2112012102120221122121021211022101111011P0111111011010001111101111110101111101a111111a1111111111111
111111111011111111111111110110111011111100111101101110011101a11112112220011020110011101101121000110111P111111111101110111111111011111111100a011111a1011111111111
aaaaaaaaaaaaaaaaaaaaa010011011111011111111111010110101111011a111221212022012212222122211112001111100000P10111111111111111111011011100110001a111110a1111111111111
11101110100111111001a011011111111101111111111111111111101110a101222122112202120101202102212111001101111P10101011100101011111111101100110111a001101a0111011011001
11111011111111111011a011111011011111111010101110111111110011a2201221120221212221222122212222110110000111P1111111101111111111011011111111101a111101a0111111110111
01101111111111111111a100111111111110110111011111110011101111a00112112211222110210202121121110001101100111P101001101110111111111011111101011a111111a1110011101111
11101111010110101100a101111011011001101111011111101111111111a111122210200111222121002112011210111111110101P11110111011111111111101111110111a111111a1111100111111
11010111111111111101a111111111011101011011111111110101101001a2000102121011101121212022121222111111110111011P1111110111111010011110011110111a111111a0111111101110
11011001001111011111a111000110101101011111111101111010110111a11212122112011222212110122111121101111011101010P110111101100101011011001110110a111011a1111111110100
10111011111100111111a111111100101011111111110101111011111111a202121212011212121101112022120101110001101111110P11111001111101010111111110111a101011a0111111011111
11111110001111111111a111111010111111111111111111111111111101a2121202212212021021211220221020011111111111111110P1110111111111110111111111110a111111a0111010101111
11111011011111111111a111111111010111110011101111111101111011a22212212020121021222221012121101111001101101111111P111111111010011111111110010a111011a0110101111101
11110111110111111111a111111011111101111101111111111101111111a120101210221202122211111111122211111111111011100101P10011111110110111101111110a111111a1100011101111
11100010111111111111a111111111111110111111111111111110111111a1222111100212212020111221111201111011111101101110111P1111011111100101111111110a111111a1111111111111
11111011101010111111a101101101011101111100111111111010010111a21102012202112110222122012121210101111111011011110011P101111001111011101111111a101101a1101110111111
11110110111010111011a101101011111111011111011111000101001111a010111101011101111111222122221212222122121100211202001P01111111111011111111011a011101a0111111101011
11101111111111101101a111111111011111110111100111000111111111a1100111111111110011110112111112210022211112000221122100P0111111111111110111110a101110a1100110111111
11111111111001111111a111111111011111101101111111111111100001a11110111111000111101122101111221212122202212122112101110P111111111111111111111a111101a0110101111001
11111110110111011110a111111101011111110111111110010111111110a111111111111111110011121110222112012222012200120012200110P11110101011011110111a101111a1111111100111
01101110011111111111a011111101111101111101110010101101110111a0011111110111101111112122112212121112220112221211021110000P1111111111110111111a101111a0111111110111
11110111111110111011a111111111111011111011111111111110110011a10011111101111100111121201211201212110011122211211121111111P111111111010111111a111101a0011111111010
01111111111111001011a111110011101111101110110110101101100011a111101111101111111010121100212112111012020222212211211101111P11111101111111110a111111a1110111100111
11111111111111110011a111110111111011111111001111111001111111a0111011111011111110112202021222212121122112122110002001111110P1101111110111111a011110a0111010110111
11101111011111011011a110111111111111111111111111111111110110a1111011010010111101111202212121011222121112212211011111110111P1111111111101111a011111a1111101111011
11111111111101111011a111111111111111111111110111111111110011a11111111101111101111111112222121200201011120011111110110111110P111111111111010a111111a1110111111111
11111111111111111101a111010111011111111011111100111110011111a110111111011111110111120221222110202112212021101012101111110001P10111101101001a111111a0001011011111
11111111111111010011a111111111111011101101110110111111011101a1111111011101101101110011221101111121212012212221222010111101110P1110111110101a111111a1111111111100
01011110011111011111a010110111111111111111111101011111111101a1011011111111111111012110211122212002211011112121021111111111111P1011011111111a101111a0101010001011
11111101111001110111a111111101111111011111111111110111000111a1101111101111111111112221112110200120122221200111122111111111111P1111111111111a111111a0101110011111
11111111101110111011a111110111111111011101110111101110110111a00111100001011111110111121212201101221121101201212220111111111110P110111010111a010111a1111111111110
11111111110110011101a011111111110111110111101111111111101111a00100111111111111111111222221111002210102100211102220101111111111P111110111111a110111a1111111111011
00110111111111111011a111111111111011101111110110111111010110a10011101011011111111112222200222222122212121211222121010111010111P111101111111a111111a1010110010110
11111011111111111110a111111111110111111010101110111111101101a11100101101101110111121122211111112122222122121111011111011111001P001010111111a011111a1111111110111
11010111011111111111a110111111111111111101110111111111111101a10111111110011110111102200021022012100210220202111221111111011111P111111111101a101111aaaaaaaaaaaaaa
01110111111011111011a111011101011001111110110111010000011111a11111111111111101111012222122122201202220202221222211110010010111P110010110111a01111101111011111111
11001111111011011100a010111111111011001001011111111111011111a111000011111111101111101201022212122211020111111122211011111111110P00101111111a01111101111110110111
11101011111100111111a111111011101110110111011111011111111111a1101111101111100111010010122112221012002212112110221110111111111111P0111111110a11011111010011101111
01011110101111011010a111111101111101011111011111111011100111a11011111110011111011122111201001022120011222211121221011011110110110PP11011011a11101111111011111111
11101111110111110101a111111111111011111111011011001011101101a1101111110111101111111122211202201122201011002112211111110001110010111P0110111a11011111111101011011
11011111101111111111a101011101111111000111111111111110011011a01111111011111111111110001222122222221222222022110111111110111101111010P110111a11101101111111111011
01111111111101001010a111111111111001111011101110111111111111a111111111111111011001110210111220212011111122111111211111011101100011101111111a01111111111111111111
01100011111111111110a111011111110111111111111111111111111111a111111111011011111110211022112021001102012220101222211111101101101101111111111a11000101110110111110
11011111111111111111aaaaaaaaaaaaaaaaaaaaaaaaaaaaaaaaaaaaaaaaa111111110101111111111222200112122212112200211221221011011101111111111111110101a11111011100111111110
1001111100111111011101111111111111111111111111110110101111111111111111011111111110211210221212111212111110110222111101111101111111101011010a11110111110001101111
1111011111010110111101110010111111111001111111111111111111111001111111111111101111220111221222021021210022102020011111110111111111101111110a10101111110111111011
1111111110111011111111110010110111001111011111111110111111001111111111011101110101212011121211012021221122222002211111111111111111111110111a11111111111111111111
1111111111111011111100110111111011011011111101100111111111111111111111111011111011101111111111111100111111111111011011100111111111011110011a11111011011011101011
1110110111111011111001111111101111110011111110111111101011101111111111011110111101101111111111111111101110111010011111111011111110101111111aaaaaaaaaaaaaaaaaaaaa
1001101111111101010111010111111111111110111111111111111111111111010010111101111111111101111111101100111101101111011111111010110111110101111111111011001111110101
1111111110011111011111111110111111111111100011110110111111011111111011111101011111111111010111111001101110111011111110110110111111111111111111011111111100111111
1011011111111111101111111111111011111110111111111110111101111100111111011111111111110111111111111111001111111110011111011110111101011111010110011111111101111010
1011101101111100111111110111110110111011111101101111111111111111111111100001111101101111111011111111011111011011111111111011011101111011111111001111111111111000
1001111111111111111110111111001101101011011111111111110110111101111111111111101111111111100111110101111001011110110111011111111111101111110011111111110110111110
