131 112
126 19
22 23
138 34
46 38
18 4
125 115
31 103
80 5
1 47

1110121222110221020201211211210211111101101010110011111101011111011111201012010102120212b2201020110111111010a111111111111101101111001111101110111011111111111111
1012211212012101112222112101212111011001011011111111110110011111012102111202120122211212a2112122001111100110a111110011110111111111111011111101000111011111111111
aaabbabbbbbabbabbaaabbbbabbbbaabbbaaaaaaa11111101111111110111111111211122022120121112111b1122212111011011111a111111110111111110111110011111111100111110100100011
1101102100102120212212212012211111111111a11110101100011111110111122021211011120222102111b1211212111111100011a111110111111111111100101111111111111011101101111011
0101111222212221111121122212120211111011a11110111101101110111111112120210121022122212121b2202120110111101101a011101101111001111111011010101111001111111111011111
1111012012022102102101120112111002111100a11111111110100111101100112212121122110121011221a0111201111111111001a111011010111111110101001111111111111101111111111111
1012211212121101111110112211121221111000a10110101100111111111111011001212112101021101220a2111211100110101110a001111110111111111100110111111101111111110011111011
1111010102112220121220000120211111111111a01011111111101111111111111102211201002222222111a2211212111111101111a101101111111111101111111110111111111111111111101101
1112021021002200120202212101202201010210a11111011111011010101111121212212222212100120112a2102201011101111101a110111111111111111101111111101111110111110011111111
1111112022122220121221012102201212222201a11111111101111111011011111122111120011211210222b2202220111111111011a010111110111111111111111110011101011111111011110111
1011201201222222222210211220111022122001a11111101001011101111110122221010202210201011110b2121222110011111011a111111111111111111111111111111110110111111100101111
1111212221221111202210022111222122211110a11010111111111010001101111101011122012221101121b2212201111111111111a111111001110111111101111111111111111100111111111011
1100200220221220220212122112020202211211a01110110111100011101011112211200001122000020122b2121121101101010110a111101011011111011100101101111111101111011111011111
1012221001212010222022022212220020011011a11111111111111011110011021220210222222111212020b2211200111110101111a111111001011111111111111110010111111111101101111011
1111120121201122222222022222212000220010a10001111111101111100110110022201211121111021112a2221200011111111110a111001110111111110110110001111110111111111111111111
0111211112122222211212111202220222201201a01111000011110101110101100011222112101211220201b2001022111111110110a111111111111110110111011110111110101110111111111111
1011111202222211221220122212221222212111a11111111111111111111111121022211212010112021120a1022110010111111111a101111101111111001101111111110111110111111111111001
1112222200120220221122222122201222212111a10111111101111111010100121021112221222102222201b1112112111110111111a101111101110011111111111111100110110111111011011001
1101201020222221202222121220022022101211a10111111110011110011011110200102021001212221200b0121202111111111111a111110011010111111110111111111111111111110111001111
1111222202222220022221222220012020211211a11011111111011111111111121221222101210120110202b2211211101111101111a111111011010112122211012221002010101011111112101000
1011022222120112202202220222012011200111a11111111111110111101111110110001102010211220212b0221211111101111111aaaaaaaaaaaaaaabaabbb2012120020112121001111011111111
0101122221201102022001212221212222122111a01111111111111111110011121121201110221112221211a100120001101011111000111111011111110102b2012222222211121221121010101011
11101100022200222121bbbbbbbabbaabbaaaaaaa11101111111111101101111112121212212121121222201a222112111011111111111100111101111121011b2212212002112102211121120111111
11111012012212201112b2222211022220200201110121221001221021111211112002220021221100122122a101012111011101111111111111111111111202a0110111112011221001122220101000
11120122222222202221b2122222222222220221212011211121212022202111122101122220121122211112a222011111111101111111001111111111002212b2222202212112111111111112111111
11112020200222212220b2012101222222222221102112102022001021221010111221010221120020112211a210222211111101111111011110111101020011a1220101021121201101111112001011
10122112122220202022b2112011220022222212210212121112202112122210112211221212111102211121b110120110111111110111010111111101121122a0202111102221001021222102111011
11122200210222222202b0122202020222211222221211122202120121111211111101211201202122102221a121210011101110111111111111111111122111a2112221222222112111111111111011
11111202221202112222b2122122002202221112021100102210002012111211110002000110011202221111a021221101111111111111101111101101122102b2222222111212112122111201111111
11101212202222122122b0202222221222211222020121022120120110200101022212211112121010022210b112110211111011011111111111111111101122b1021102212122210222220010111111
11102110212222212021a1122222002112021102201112121122122111121111112121221101210220111112b212020211001001010101011011011111120101a1022222012010222120011121101111
11111112202121210010a1221211002201201201202022221221201200101111001111101111101111101111a111111111101100010110111111111111121212a2001221221011200101001221011101
11112112222100022112b0201121122211200211221111211002001122201211111111110101111101010101a011010111111101011111011111111111112112b2222220120012101111112201110011
01221120020001202002b0121110022122122111212122111011012012111010101111111111101011111000a111111101111111111101110011111111020211a0201200201211011212112122101011
22212121200122221222b0222112122221222220221120201011102222101111111111111111111111011111a011111111111111110110111011011010020212a0222102101220002221011021111111
21200021222021220122a0022121222222200021100011020022122212201011101000110101110101010101a111011111011111101011001101111111121220b1121221122110202002021220111111
21100222202200222221b2220222102222221220121012200201002022210211110111111110110111011011a111111110110111111110111111111111101001a2102102222211222110112211111111
11221012221220222022a2200102222210022112210212112202011212200101011111011111111110101111a111111111111010101111111101100111111211a1012120212220000211222222111011
12221122001201220201b2022222220221212112222112112121202112121110111010111111111000110111a110011000111111110111111111101111112121a1020212201212120221102001111110
12222120112111112121b2121001122012121222222221102212002122121011111101011101111110111110a111010111111111111111100111111101121222b1211212221021221202102211101111
22002112022202222212a2012221012120120201111210202102101222112211101111011111011011111010aaaaaaaaaaaaaaaaaaaaaaaaaaaaaaaaaaaaaabab2210211212111222212210000101111
20202212102011102111b1211111202222012221121221111111122211121101011111011001011110111111111011111110101111011111111110111111111212002211021121211201110111110111
bbabbbbaaaabababbbbbb2110102122211212221102000022011020021001111111111011111111111111111111101111111011011111111001111010110021210011202211222202121210021111111
2011221120121201121021221112112020022202101212102111120022122111111111101111111111011011110111111111111111110100011111111112002011020222222101121022122111111011
1022222011221002212111111110212202221021122220222201011211010000110111111110111111011101100011101111011011111001111110000112221120022222100121221111110101011111
2101212012101201212211111020122020220020102220212100221011212011111101111110111111111011111001111111011110111110110111111102210211111011122212222111222220111110
1222212111211222112222101111111002210212022121222121002020222101111011111100110110111111111111111111001111111011111111101112222102210202122200012101211112111111
1222211110222012121101201120120201211212111111110220111110210211111010110111110111101100111111111111111110010111110111110112211010211121111211122120222121111111
0221010221221220211011122210110121221122220012102112112201212211011111101111111111111111110110111111010111011111111100111111112212211220220112211221121121011011
0021212202222022022211121210112121122010222211211021012021110011110111111111101011100111111111110011111011111011111010111000110020212211122121221201221111111110
1021201221002101122221111101201122002222212211200220010122212111111111101111011111111001011111111010110011111111101001010111001110101101101111111111011111011011
2112202222202202212120120121211212122221221222112202221112222111101110110111011111111101101111111111111110111111101110111111110111110111111111111010111110111111
2001112212121212010021211211212011122100100201100211212222212200111111111111111011111111110101111111110011110101110101011011111011110111101111111011101111111111
2002110022110221101211121222112110222122120110001201211021222211111100011111111111111111011111111101111111011110111111111111111111010011111111111111111111110000
2221210022220022221211101111111101101101110001000110110010111000101111111111111111111111111101111111111111111101111101110101101011101011011110110111101011101111
1012211112211110110212121220222111111101111111111110011111111011111010011111111110101111111110111111111110111111001111111011111101101011010111100111011110110111
1212201102122121122212022210110101111111111111101111011111111011111011011111111110111111010110111111110101111111110110011110111111111111111110111111111111011001
2011012222112221212121111000212011111111111111111111101001110011111111111011111111011111111000011111110011100111111111111110001010111011111100111101111111100011
2111202120122021112201102112010111110111111111111111111111111111111111101111111111111110111111111110111111111111111111001111111110010110111111111110110111011011
022211211222112022222012102121111011101110111111010011111011111101111110111111101111110111011110101110111aaaaaaaaaaaaaaaaaaaaaaaaaaaaaaaaaaaaaaaaa11100111111101
111120021011111112110002112021201011111110111111111111111101110111011111111111011101110011101111111111001a111111111111111101111111111011111101111a11111111111101
001100211201112222201110111021201111111111011111111111111111101111111010111111011111111111111111011111111a111111111111111110111111111111111110111a10110111111111
111012012122121102112222122122201100110101100111111111111011101110011111111111111111111110110111110111111a010110111111111001110111111111111101111a01001110111110
101110111101111111111111010111111111111111100111111111111110111111111111101111111111110110100011110010110a111010011111011011101010011011111111111a01111111111111
111110111111111111001101010111011110011110111101111110011101111111111111011111110111111111111101100110111a111111011111101111110110111111111111011a11011111011110
111111110101110111110111111111111110011011011111111111111111111111111111001110111111001111101111111111111a111011101111111101101111101111010110011a11011111011011
111101110011111111111111100001001110011010111110111001110111111111111100011011100111111111111110101011111a111111111111110111110111100011111111111a11111101101110
111111111111001111111011110101111111111111101011011110100110101111110111101011111011111111101111111110101a111111111111111111111110111011111110110a01111011100111
101111101111110111011111111111111011101101111111111110111111111100111011111111111111111111101111110101111a100111111111011101111011111111111101111a01011111011110
111011111111111111111111011111111111111111001011111111111111101111111111100111111111100001011110101110011a111111101101011111111111111111111111111a11101110011111
111111110111111101111111111111111110111010111111111011111101111111011110101111011101101111111101111110111a011110111111111111001111100100111101100a10111111111111
011101010111111011111110111011111111011101011111110111011111111111111101011111111111111110011111111101111a110111011101111111111011111111111111111a01111101111111
111101101111100111111100110110011101100111111010111111101111011111101101101101101101101111111011101011100a111011100100111111111111111111001111111a11100111101111
011011111111011011111110111111101111111111111111111111111001110100110101111111111111110001011101111111111a110111011011111111111111011101111011111a11011101111111
111101101011111101111111011010101111111111011011100111111111110111011000111111111111111101111111111011111a011110111111111111001111111110111110111a01011111001101
111111111110010111011010111111111110111111111111110111101000111110111111101111110110111111111111111111110a011111111111111011110110111111000111110a11011111111110
111111110101110111110111111111111111101111111101011111111100111111111101110111111011000011111110111111111a110111111111101110110010011111111111110a11111111111111
101011111111110000011111111111111111111101111111100010111111111111111111111101111110110111111111111111101a111111111001110010101111101101111111110a11001111110111
011100101111111100111011111011110101101101011101111110111111111111011111100101111101111111101111011111111a101100111110111110101101100100111010111a00111110111000
1110110111aaaaaaaaaaaaaaaaaaaaaaaaaaaaaaaaaaaaaaaaa101101111011111111110110111110111111110101100110011111a010101110111011111110101111101111111101a10111111111111
1111111111a111110111001111100111111110101111111110a011111100111111111111111110111111111011111111111111111a111111011011110111011111011111011111110a11111111111010
0101101101a111110111011110011111110101011111101111a111101111011101110111111101010111000111111110100011111a110111111111111110110001111111111111111a11011011111110
1111110111a111111111111111011001101100110101111011a111111111111111111011111011001111101111111110111111111a111111111011110010110001110101011011111a11010111111111
1111101111a111011011000111101111101111111011111111a110111111101110011111011110111111101111011111111011011a011111101010111101110011011111110110111a11011111111111
1111111111a111111111111011101111011100101011101111a111111011110111011101111101101111101111111101111111100a111111111111111111111011111101111111111a11101111111111
1111111111a111101100110111111110110010011111110111a111111111101011011110111111111111110111100101011111101a111111110111111010011011110101011011111a11011111011111
1111101111a100101111111111011111011101111110111111a111111111111110111011111110111101111111111011110111110a111111011111110101011111111101110111101a11010011111111
0111110011a111111011111111111001001011101111111111a111101111011111111111111011111111010111111111000111111a111101110111010111010111111011100101111a01111011101111
1111110110a111110111001212222221212212122022112011a111111111001101101110111110011111111111111011111101110a111111110111010111111110111101111111101a11111111110100
1111110101a111112001120220222112121101221101111100a011110011110111110111001111111110111111111111011111111a011001111111111111110110110111101110011a11101111011111
1111111111a111112120012222112212111222111212220111a110111111010011111110101111110111001111101111111111101a111110111101111011100111110111111100110a11111010111111
1011111000a111112202220212211012222221121211122110a110011111110111010111111101111011001111101101111111111a100011111011110011111111111000111101111a01111111101111
1100111111a011012101211110102111111220022010122110a100111111110100111110110101011011110111001111111111001a011111111111001111011101111011111111011a11111010110111
1110010111a111111110112122202021110210211020012011a111101101111010010110111111011110001011110111111110101a111011111111111111111111101111111101111a11110010111011
1110110111a111111220000122012111011112022202100101a101111111111101111111101011101101111111111010011111101a111111110111111011101110100110011110111a00111110111111
1011111110a111110211212121112222112120010221202011a111010111111111101101011011111110111111101111111110111a111101110111100111011111111111111110111a11111111111100
1110111110a011110021221011110121022211111011221100a101110101111110111101001111101101101011011010101011111a001110111111111100101011010101100110111a11100011011111
0111111111a110012202111111122201122211122110021101a111011111111011111111111111001101111011111111101110101a101111111101111101111111110101111011110a11111111001111
1101111111a111112201112110221202021221111211120111a111111011111110011110101111111111111011101111111111101a011111100111101011111010110110101111101a11101111111110
0111111111a011112110222011121120101111201212000111a1101111111111101111111111110011110aaaaaaaaaaaaaaaaaaaaa110111111111001111101111101111111111111a11111011101101
1101101111a110012202100111210021121212022212220110a0111111101111111011110101110110011a10111101010101111111110111121112202112020111210021121121111a10111101111111
1111111111a111012212221212110202212121212222222111a1010111111011111010111010111111111a11111111011111111011111010212211212000222012201011211221111a00101111111101
1110001101a111102212222211101021121120120202021111a1011111101101111010011111011010011a10101111110101111111111122212210102211101122220102000101111a11111011111011
1111111011a111112112121200112111221020211211010111a1110101111011111100101111111111111a11101101110111111111111111021111202120122012122122221210101a11111101100111
1011100111a111111010101001021021121101211122102111a1111011001011111110111111111011011a01111111011111110111110111110120110112102111021221121211101a11111011110010
0011111101a111111201011211022101222222120111122111a1110111111101111111111110100111111a01111111111110111101111011220102221222212221211211122211111a10111011101111
1010111111a011111222221222222211001111222012222111a1111111110111101111111111100101111a01101111011110110111111010222111210221011221111021111201111a11111110011111
1111111110a111102000211122112211110200021022112111a1111111111101111110111111111110111a10101111111011101111101111212112020121212212002121112100011a10011111001111
1111111111a111110121112111102121211121210220112111a1011101111101110011011110111101111a11011100111111111101111020012212112211112202121112001201111a11111111111111
1111011111a111112122112211002212202111021110012110a1111110111110111111101101011111111a01111001111110111110101101211012021002022212121111110220111a11001110111110
0010111101a111102212011221120110211120010112122111a1101011111111111111110111111011011a11111110111111111101010021202201222210211101112210011021110a01101101011111
1101011111a110111200211201111211221000112222022101a1011111111111111111010101111101111a11011111011111111101111101112112211201212221000222022101111a11101101011011
1011111101a111102022111211122101200101221122011011a1111100111111111011011111011111111a01111111111101111111101002101212121221212112222011200211111a11111111111111
1111101011a111111212220221111121212020111112211111a1111011011110111111111011011011111a11110111101110111111110102011002102012122111221222111120011a11111111111111
0111110101a100111221101011221111121110212212222110a1110001111101101001111111101110111a11111011111111001101111112201220222210122222001111122111111a10101111111101
0110111111a110112211212122200111202121112202121111a1111011110110101111011101111111111a01001111111111110111111121100220220021211210002111122211111a01101110111111
0110111110a111101101221202011211201112120102122111a1011111111111111111011101111111100a11100111111011011101110121120110101212111222111112221020111a11111111010110
1111110111a011101212222012120221211201122120100111a0011101111111011111111011111111111a11111111101111111111101111100001212112121212221020111221110a10111010111011
0111111101a111111010221220122111222210222000211110a1111111111011101101111110111111111a11101101101011111111110121120221122210011022011020022111110a01111100111110
1010011111a111111000111111111111111111111110100111a1111111111011011111101111011111101a11110111101110111010111002022101211221012211012020122021111a01111101111111
