11 112
157 33
22 23
138 34
46 38
18 4
125 115
31 103
80 5
1 47

111222210012120111100021121212211111110111111110110111111101110112012012211122112122212012112121101111101111110101111111a101111111111011111111111110011111111111
111110210211121212112101022112101211011101011101110111111101001102211111211222101120121122202212111101101111101011111111a111111100111111110111010111111001111100
101212111212211210110221201112212001111101110111001010111111110112110211121121022110000010202222110000111111011110101111a111101111111111111101111111111111011111
011120022022112012211111222202211010111010111111011101111111001112111121221101210000110222122111111101111111110011111001a110111111111111111101110001110110111011
111220112221122111111211022001012111011101111110111111111111111111221111201222111000222111010221011111011011111011110111a110011111101111111101110111001101011110
111110220101111221121112222022011110110111011110111001111110111111102001022201122201221222022112111110111111011110111111a111011011110001111111110001111101101111
111111201101112121122102121200222201111111111011101011111110111001210221102121102122222121210222110000000111011101111111a111001111101111111110111110011111111111
110200021222010222112222211100002111110010111111100011111111111010022011121012212110222122201221111111111111111111111111a111111011111111100111110101111111011111
111111122220221120122222012202222212221111010111110111110101011012011110221110000110221202112112011111111111111111011111a110111110111111111111011110101111101110
101200210212220210222222201222222202210110101111111110111010101112220212202111112110021220221022111111101111111011111001a101111111111011111110111111111101001111
111121010002122121112021022212022021110111111111111011011101011011120121221122222122022100120022010011101111111111111101a110101111111101111101111101101111111011
111110222012211022002222222012102110021111100111011111111101111110220221110210110210211210112012101111111111000111111110a011111111011111101110111011011111010011
111211022221022221101212122022202212120111111011111111110111111110011122001211222002102111120211111110111111111011010111a111101111111111000110011101011111001111
110211222122110212212222120212200222211011111111111111110111111012011122121101220212112210012121110110111100110111111101a110110011011110111111110111111111011110
111101220220220221220221221212122111111110111111001111001011101112021221122212122112212112111020101101111111110011100010a111110001111111111111110101110111111111
111120002012222220220202222022222021211111111111111111111101011111010010212111220201220112122021111110101101111101011111a110010101011111110001111111111111111101
111211202022201211122102102221201100011111111101111111100111111012111211101220201112121202020121011111111111110101101101a011111101111111111111110110001011101101
010210212001221211222202111012021211100111111101111111101111111100022101011101211110021221012111111101111110110111101111a111111111111111111110110011111101111110
aaababababbabbabbbbbaabbaabbbbbbbababaaaaaaaaaaaaaaaaaaaaaaaaaaaababbbbbbbaabaabbbbbbaabbaababbbaaaaaaaaaaaaaaaaaaaaaaaaa111101011111111111101111011111011111011
1112022102122221221002220212220121112111111011111010011111100110011201120021012212010022102121221110111101110111111111111110120112121200201001222212202002101111
1110220122201222120202222122202002010201110110010111111111010000121212222012210101122211201222201111111011111111011111111112120101221212101202211111212021101001
0111210210222202222222221202112022110111001110110101111111100111121221222220200221122211212111121111111101101111011111111110222011112210210002211221122222111111
01121022221112222222222120212122121122111111100110011011111010101022210220201200abbbabbbababbbabaaaaaaaaaaaaaaaaaaaaaaaaaaabbabaabbaabaabaababaabbaabbbabbaaaaaa
11111111122210121221222212220222220122211121011102111220122111011102221202211112a1021102210101101011101101110010111110111110021011222210111010112221122022101111
11111210210022201122122222122222202200011020120020112221211211111200221111211222b1121012112211211111110111011111100101111101111201222121111202222001212212101011
01120212222201221222200222122110122222020111122200022110221210110122121102001202a1121122212212200110101110101001111111100110011111212112011012011110222120111101
01012122122021200221222222222202220222112222211011112010112111111102220122112222b2212202222222211111111100110111101111101110102221221112020102211201220021110101
11111021012200202021020210122022222212111221221111021012220111010021221222212221a2222122120202121111111011101001110111111111002221102212201001211112201111111111
11112102222212220212222212020022022020122102002111121120112112111121002122200211a2121111222122021111111011001001111011111110011111221222122021221221211122111101
11121212212220012102022121112212222202110201112112011210211010101211112221121110a1211012222002210111101100110101011111101101021121210112222211012021112012111111
11121022122122222222202222222202220102111222122112211012200120010020222221122212a1211212011001201111100110111111110111111102121021121110121121212220210222111110
11010111121212211202111222122202022002212220121211102120112211101110111110111110a1011111110111111111011111111111101010111112022221110120122110000121100101111111
21110202220222212202120222001200200122121122120112111000121222111111111100101011a1111111111110101011001111110101111011111112222112020221011121011121121102111011
22212121212220121221222212220211102011121021012211222110022222001111110111111111a1111001111111111111111011011101111111011111022012112212211212122011021100111101
21111001222220221220120120102122222021210101011212111022110222111111110110111000a1111111110111011111110111111111101011111112210211212112212012221210102211111111
22120122111222212022002220222220212202212122111222110111122122111111111010111111a1111111101111101110111111111111111110111100201222220111012110121222012111001011
21201111121212222210222120222122000120112111022211221021112202011011111110110111a1110111111111011111111111111101111111111002111012220110112122121122112012110111
20111211212120221222111222002112220122121012201022102102122122111111111110111110a1111111111110101011110111010111010111111111111212110121212022012110010110111011
11022202201122202222200021122222021002012121002221022212111122101111111101100110a1110111111111011111101111111111110111110012120020121201012021221221222201010111
21021110012201022201121020222111011111220221122212222222211011110101110011111111a1111111111101111111111101111111111110111112222021022201112000012112222121101011
21120111221222210111221211110222222220210221201101211212111211011111110100111110a1111010110101101001111111111110111111111110021111022112202202121221121211111001
21211121212122122220211120102220112201112022122221112112212111111111111011111101a1101110110111101101110111101111111111111112112122102201201210122201212120110111
aabbabbbbaaaabababbabbbbbbaababbaaaabaaaaabbbbabbaabbabbaabbaaaaaaaaaaaaaaaaaaaaa1011111111110111110111011010011001111111101211111212000112220221121121221111111
1212021122021202221111211210221202000210211212020102101020222101100111110011111001111010110111111111111111101111110101110111201011210122122220122222212122111110
1112020220121012221111201121211112111120211022221022221221210110101111111111001010111011101010010111111101110111111011111111210101211202212111121221012101111111
0221221022221111212210022121222220112212112121221221221221101211011100111111111110101111101011011110111011011110111111010112101212111111211112211011021022111010
0211210201102021022210210101112110200110222112010102122111112100111110110011101111111111101110000110111111111111111111111111222010210112010212222220220121111111
2222002222101212220110010120112121101102221110202111002221121010111011111101101111111111101111001011111111001111011111100012222000121202211212202111211222110011
2221101210111121211210212112001222110222212222200202111111000201111111101111111111110101101101111101111111111001011111111112212021120220200202112211022220111111
2021121212101212121200011021020021000112201122121201120220211211101111111100111100110111010101111011100100001111101101111111021202120021012121210101112111100101
2011122001222020011112121211021112010210222121111222111221212011111101111111101111111110111110111100111111111011111110110111011110111111001111111110011111001111
2221111222112202021221111112211220212211112210210211221110201211111111111111111111011111011111011111001111011001011010111110111111111110110111111110111111101110
01222220210211222122baaabbbbbbbababbbababbabbababbbaabaabbaabaaaaaaaaaaaaaaaaaaaa001110011011101111111111111101011111011aaaaaaaaaaaaaaaaaaaaaaaaaaaaaaaaaaaaaaaa
22121012220210012002a22121212022112202211111121222022120211020011111011111111011a111010011111101011101111111010101111111a111101111111010111111011111111111100111
21201102112201112010b11121112221111111111001110111101111100111111111111111101101a011000011011010111111111111111111111111a111111111111110110111111111111100111111
21022222110002112121b22112221201111011111111110111101111111101111110110101110111a111011111111100101111011101111001101111a111110101101110111111111110101011101111
12122120221211121211a11210022021010110101001110111011111010111111111111101110101a111111011101110111011010110101111010111a011111110110111101011111000011110101001
20111120011222010111b11112212101110101011111001111110111111110001111111111111111a101011111111101111110111010011110101111a111101110111111111111111111111101101101
20221022221202220122b10212102101111001001111111111111111111111101010111110011111a101111111111111111101111101001110110101a111110010111111101101011100101111111111
22110112111121222211a12220111121111011111001111111000111101011101110110111111110a111110111111110101101111111110111101001a111111111111011111111111011011100010101
12121002112112101212a01010122101101101101011101101111111101101111101110110011111a001111111101111111111111111111101111111a101111100111111111111111011111111011101
12222020220212112212b10112111111111110010111111111111001110111011111111111011111a111100111111101011011111001111101100101a111111011011110101111111101101111101111
22122101202212111212a01102112221111111011111101111011111111011111111111111111110a111111111111110110011111110011111111111a101110111101111111101101001001011111111
01111110111111101101a11111111111111111111110011101100111111011111111110111010111a111111111111011111111111111111111111110a111011111101101110011111111111111111101
11111010111111111111a11001101100111011111111110110110101111111111111111011110110a111110111111110111111111111111111011111a010101101111111111010001111001110110010
11001110110111110101a11110101101101100010110111110011001110011110011111010111011a011111111111111011111111111101110111101a101101001110101101111111101111111101111
11111111111100110111a11110111111111011111101111111101110111111111111111101111111a111111111101111110111011111110111011011a111101111111111010110100011111110111111
11111011111111011110a11111111011011100111111110111011110111111111111111111101111a111001111111011111110011110111011111111a111111011001010011111111101111011110101
10110101111111111011a11010111011100111111111111100111101101101111111101111011101a101101001111111101111111101111111110101a111111110101111011011110111111101111011
11111111111111111111a11110110111111111110111011111111010010110101111111111110111a011111110010111111111111101110111011111a111111101101111111111110110101101011110
11111010111011111111a01101001101111111111111111110111111111111110011111111111111a111111111110111111111010101111111111010a110111101111111111010111111111111011101
11011110111111111111a11111111111011111111111111001111101111111101110111011101111a111111111111111111110111111111111111101a111111111111111111101111111010111111011
aaaaaaaaaaaaaaaaaaaaa11111110110111110111101111100100111111110101100101110111111aaaaaaaaaaaaaaaaaaaaaaaaaaaaaaaaaaaaaaaaa111011101111101111111111111111011110111
0110111111101111111111011111111100011111111110010111111101110111110111111011111101111110101010011011111111101010111110101111011111111110101110111111000111111011
0111111011110111111111011110101111011001110011110111110111100111101101011011111011111101111111110111110111010111111011110111111101111101111111111011011011111111
0111101111111101111111111110011111111111111011111111011111100111110110111011010110101111111101111111110111111111111011111111111110100111101110111111100111110111
1111111111101110111101111110110111111111111111011101111111111011111111110011111101111110101110111011111111111111111111101111111011111111111111111101111111011111
1111111111111111011110111011111111111111111001111111111111111110101011111111011110111111111010011010111010101011111011110111111110101111101111010111111110111101
1111110110111011101110101011101011101111011111111011111011111101010111110111011111110110111101111100111100101111111100101111110111001011111110011111111111011110
0101111111011111111011110011111011011111110111011111101111101111111111111110100110010111011110111111101111111111111111011111111111001011111110111011111111111111
1011111100111111111111111111111011111111011111111111101010111110111011011011111111111111111111111111111101111110101111111111111111100101101101001011111111111111
1111110111111011110111110111111100110111111111110100101111111111111111011111111111111111011111000001111000111101001111111111010101111111111111110111101001111111
1111111110111111110011110001111111111101110001011110111111110110111111011111111111110111111101111111101111011111111000111100111011111011111001111111001111110111
1001111111110001011111011111111111111111111111011011111111111111111011111101111111111111111111111111110111110101111111101111101011101110111111111110110011111111
1111111111000111111011101111111011111111111111111011110111101011110011111111111011111100110111111111110111100111111111111101111011011111101101101111111111111110
1110110111101111111110010111111010111111101100101101111011111100011011101111111011110101101111011111101110111101110101101101110111101110111111111111101111111111
0011111101111111011011110111111011111110111111011111111111011111111011101100111111111110010111111011101111110111110101011111110111111111110111111111111111111111
1111110111110110111111110111101111011101011111101101101111011101111011111110011111101110111111111111001110111111101011111011111011111111111111111011111111110011
0111111111111110121102001120111022012100020120211111111110111110111110111101101111011111101100010110110111111101111111111101101111011101101100101111011100111011
1110111111111111112112110221120102122210221022111001111011110111111010100100101111111101110101111010111011111111111111111010101111100010111111111111101111000001
0111110111010111201222122222221121200012201221111111101010101111110111101111001111111110111011010111101110111001111111111111111111011011011111001111111111111111
1011111111111111211110222210022121222021111102211111101111110111110111111111011111101111000100111111100110111101111111101010000110111110111111111110111111111111
1011101011111011022112102222220122211122202211101011111110111111011111111011111001111010111110101111011110111111101110011111111110111111100111111101111110110111
1111111111111111220202210122112222122212021012211111011111111001111101110110110111011011101111111111001110011100111011111111111111111011111111111100100111010011
1110111001110111212222202112212110211111112022211111111011111110101111011111111110111111111001111111111101110111101111111011111110110111001011101111010111111110
1101111111011110020111112220121121022222110111211111111111111011111111111110110111011111111111110111111101111111111110111111110110111111110111110111101111110111
0110111100110111112212221222111112111022110211210101101111111001110101110111111010111111111011011111110111111111111111101111111011111111101111111101011111111011
1111111111111100102002100111222102112220222210101101010011111111111111100011111111010101011110110111111111110111111110011110101011000011010001001001111101110111
1110110111101111121111200111112111021010122101110111110111111111111011101011110011111111111001001111111111101110111111111101011111011110001011111111111000111111
111111110aaaaaaabababbaaabbaaabbabbaababaabaaaaaaaaaaaaaaaaaaaaaaaaaaaaaaaaaaaaaaaaaaaaaaaaaaaaaaaaaaaaaaaaaaaaaaaaaaaaaaaaaaaaaaaaaaaaaaaaaaaaaaaaaaaaaaaaaaaaa
111001111a001101121101111221222201020222102012211111111011111011110101111111011110111111111011111011111111101012021202112121200112222211111101010110011110111111
111011110a110111201120112120122221112111121022111111110111100010010101111111111110111011111001110111111100011120122200210211122222112122102121011111011111011110
110111101a101001012210111212210120111122110101200110111111010111101011111110111011011111000111110101111111101111212202111101121110122210220221101100111110111111
111011111a111101120212112220222011112212011221211111111110011110111110111111111110110111111111010011111111101021210112121121002210102221212111111101101111110011
001011100a110111212112100022202011201102102112011111110111111111111111100110111111000011111011101111110111110121022201111202221101211112222211111101110111110111
011111111a111101202111112112121121001222212221211011110111111111110010100111011111001111101111101011001101111121202210211220120220122121211211111011111111011111
111011011a111110221211211122021212222122121120011010011110111110111111111011111111111011111011011111111111111022221210211202201102010021110011011111011011111111
011110101a111111021122001011221210110111211222101111111111111111011111111101111111111111111101100011101010111110222220121021122221212110011111111011111111111111
111110111a110111210221221002221222122212200220000011101011111111111111111110011010111111111101111010111111111120112101200100221112112121102211101111111011000010
100111111a111001021211210210122211122211112111011110111111110101100111111011111111111011110100111001110011111111120121012210112001011121110021111110111101111111
111011111a011011212211112110221112121002101022011101101101111111111111101111011111111110010111111111111011111112210121201021111101212212012121110111111110111111
111111111a111011222022021021210100102112112221211011111111111001100011011101111011111111011111011011111100011110220111212212210201120122211121110111111111111011
111111111a111111121022221201122122101102102011010100101111110111111111111111011111011111111111011111101110001111221101210120212121211112012110111010111111101111
101111111a111111222012021212202001021201212201211111101111111110001111101111100111111011111011101111110110010112220121121212112121210212110011011001010111111111
110111111a110101211021101021221111111221111010210111111111111011111111110111110111111111011101101111111011110112222211121220202122011020112221101001110111011111
101111111a111111222201211212220112110220122202111111101111111111001101111101001100111101110101011101110111100122120201100011001101121121100111110111111111110111
111111111a111111220122111112002111020022001221200111110111110110010101111111011101111110111111011110110011110111201122201112222111210002111111011111111111111111
101111011a111110010111122122220202001212211121211011101111111110111110011101110111011000111111110111111101111101220111121021012101201211202111111111110111111111
111110101a111011012112221221121020122011021102211101111111110111111101111111111111111111111111111110110110111112120222020212201221211021112221101110011111111011
101111110a101111111101001111111111011111011111011011011011101101101111111101011111011111011101111101110110011112112210122211112020211120202211111100111011010010
