131 112
126 19
22 23
138 34
46 38
18 4
125 115
31 103
80 5
1 47

11121201222011111222b10210221010021111110111011111011110111111110001212112212211a1212111102212111011111110110010111000111110111011101111011111011111011110111011
11112012012221021012a20011111221211111001111111111111111111111101222221101122012a2211121121012011111001111111111111111111110111111111101111001111111100111111111
01121122122112112121b12211222210211111110110111111111111011111111121221012220010b2112102122112210111101111011110111101111111111111011101011110111111111011011111
11010201211101222221a00020112211211111011111101011011111111110100112122221110111a1121012011221021111101011111111011111101100111111111011100110010111101111111101
11121220212220122110a01111210212111111101100111101011111111111111212112212002002a2121121211120021110111111111111110110011111111111111111101110111011110111111111
00021211000021022101b01122120120121110111111111111011111111111111222012112222011a1202120211212201011111111110011111011101111101111111111111111110111111110110111
11122121101221112021b11011112212121011111111111011111111101111110011221222121221b1121121002011211111111101111101001101110111101111111110110101011110111111111111
11112112222111102121a10211211121211111111011011011111101111101111211211010121212a2120112202111120110011110111011111111011111111101111110111111111111111110111011
11101022122112021221b01222122122121122011001101111111111110111011210221222022012b1111120021102101100111111111111111111011111110111111011111011101111110101111110
11121022212222020121b20221121012102102111011111110111011100101111222200121220111b2122101012012121011111111110101101111110111111111011111111111111011111110111101
10102222220212202202b12112212220222102111111011111111111110111111221220001022220a1212120121211221111110111111101111111111011110110011111111111101111111111101111
10121220202220222220b12222100222022222011111011101111110110111011010022222222020a2112010211222011111111111001111111111111110111011110111111111111101110101111101
11110110222202221202b12002021222210111111110111111111111111111111110202010221111a1121110100111021101011011110111111110111111111111000111111101111111111111100011
11122022122211122210a01121220011022222011111111011110111001111101102211122221122b2011210021021201101111111111000111111111110111110011110111111110111110111111111
11121011122222202202b02222221220011211111110011111111101101110111122010201121110b2112111211122101111111111011101101011011011111111101101101111111111111111011111
01011022212222202022a22022020122212202111111111111111111111010111111112122122210b2121220221001211011111111011101001111111110111111110111011111111101100110101111
11120022212201122221a22202210202201202011101111000011111011001111211221212111102b1012122202202211101010101111111101110101111111111011111110101110111110111111111
11002210222222222222b20202110222200220111111111110111111111111111222121020220122b2210221111222221110110110111111011111110111111111111111101101111011111110100111
11000202212212002212b20111211222021212110111010110110110011110101202122222010122b0221120221120200101111111111111001111101100111111111011001111111111111111100111
00121112121222020012b11222212222221121101111001111111111110101111101212011100210a0121001211211111010011011111111110101110101112222110111122011102002210120111010
11111022202212220222b22200202122212012111111111110111111101011111210021202102222a2122100210112101111aaaaaaaaaaaaaaaaaaaaaaaaaabbabaaaaaaaabbbabbaaababbaabaaaaaa
11121222102120202022a22222121120022011110111111110011111111111111222122122212222a1122112222201111111a11101111111111100111012212101110200212110121102222121111011
01102101222022200222a21021211210212221111111111111111110011111100211220011221111a1001212021120211111a111111110111111111aaaabbaaaaabbaaabababbbbbabaaaaaaabaaaaaa
01120202221022211022b12221221012201212111122122212121120101101111021222112111210a1222212121221020111a110101101111111111a1112121022112122201222112210021212010011
11112122221222211220a10201220122222011101210112012101021122211111211111110122121b1222210122121211111a101111011110110110a1112111221100112202022202102221111110111
11021112222212212122b02220201202221222221112101021212120120221101122221111111101a1121122110201221101a011111111111111111a1102120020011220122122120112012210110111
11110222202221121220b22222211022202212212220120222101220010100111202011102211112b1101221012101011011a111111011111111101a1000210111010011101122211200120222110111
11102111222122222222b12220112212002221122211200212000122022002111121202121011121b1220220201222001111a111111011011101101a1112122201111002111210210122211112011111
11112222102201020022a12210212122202222101211112011201111111211111110022110112212a0122221101122101111a111000101111100111a1011212022222210122111222221012221111111
11112212122202121122b22222222221022122211111212221022112021221011210210202221220a2222220022222220111a111110111111111101a1110200102121202101110001101120221111111
10112200212211221011b20222122020222012122111122012212212021112111212211122021112a0022112111202221011a111101100011101101a1112022211122212120111221111100110111101
11011111211212012111a22021112220112022212111121212101122120201111111110111111001a1110111111101111111a111001110111111111a1111221200102102122021222112121201110011
11211222220211220122bbbbabbbbbbbbbabbbaaa212011121110101211110100011111111111111a1111011011111111111a010111011111111111a1011100212222212111121112111111202111110
1021022122212120222221002222202211212222b202202220112211110122111111111111111111a0111111111110001110a111111110101111101a0112021221022121121112122121201102111001
0121110112122222221220020102222200210212a102222120211211122211111111011111110111a0011110111110111101a101111101100011111a1111022120211201122112011102212212111011
2022112201201221020222222022020202202121a221121121212101122221110101101111111101a0111111011111110110a111011001101111010a1112212011101012111001122210121011111111
1001111222222221111221222220221201122221b100011011122111021112111011111110111101a1111110101111101111a110101011111111111a1110210212012212112210211111111222111111
2222012021222112022122212110121122221012a222002212112101210121101111111111101100a1100001111111111111a101110111111111111a1012121222121012202022100121120220111111
1222120122222122220210210222222121100221b221121210110210002110011110101111000111a1101101101111111111a111110011110111111a1012112121100111221210222200202112111111
0112220212211121201020020121102121212222b001211012221121012121111111111111011111a1101111111111010110a111011101010101011a1110020210212121111221112012121102111100
0022022210221210222012112201122222112100a110222102221200110211111111111111111111a1111111101111011111a110111111101111111a1112200022111222221120221012122201010101
1011020211201222221122211022202101110122a122121101111220222121110101111101000111a1110010101111111011a111111110111110011a1111022120212112212122222220022111111111
1222211122212221220221200101200120212100b110012211122202201222111111111010101011a1111111011111110111a111111111111111011a0111210012011021111211101202102121110101
1222200011101122000212101111121021110212b211121021212122102122101101111111111111a1111101111111011101a010101011100111011a1112001021121101112201012212222111111100
0121211211101102100210122201010221221012b222200222221121202111110111011011011101a0111111110111011011a111111111011111111a1101201102221102212221112021122022011110
2012202001220212221022222121021221220101a022122202121111102011011101111111101111a1111110110101110110a110111111111110111a1102211211120012202210101202221102101100
0202112210211112111112200112021112022222b021220112212012200110111011101111111111a1111111101111111001a001110111111010100a1012102221122222020121221110111112111111
1020222022111111220112012102011221112212a211212102102122022220111011110111111110a0111111101111011001a100110111110011110a1111120211221212021210112121111212111011
1002121021112121111100111221220122221221b111212210121011112222111000111110111111a0111110101011111111a101101111111110111a1112112121212111201122120222112022100111
0101122211210212122220212122222201122112a122111100221111022100111111111111011111a1111010111011001111a011111111111011001a0112121220121121001010000001120102101111
1122021122021111121222220010022222111221a100022011201021101112110101001111111111a1111011001011111111a111110011101110011a0100111111111111111101111110110110111111
2111221222222212112222122221210112202011b121220111212220110111111110111111110111a0111110111110111101a111111111110001111a1110111111011111011011001111011011100111
2210100202201211210211220222222220100212b222001022112122111100111001111111111111a1111111010101110011a110111111110111011a0111111111110011111011111111011101111111
1122210012020201201211212012222011202122a222112121111122211002111111110111111111a0011110101110111111a111101111010111111a1111111101100111111111001111111111111110
1020010100012020202211220012121011011111a111111101111101011111111110111111001111a1111111110111100110a111111111111111111a1111110101011111111110001111101100111011
1120112112221211122211112221221101011111a101011011111110101111111111011111111101a1111111101111111111a011001111011110101a1110011111111111111100111110101011011111
0211122212001120112201102210112111111011a111111111101111110110100101111001011010a0110111111111111111a101111111111111111a0011110111101011110111111111011010111111
1222222002212201122222022202211100111111a111100111111111111111110111111100111110a0101111111110011111a111111111111111011a1011011111011011011101111111111111111011
0201121202102221221010022111112111011111a111111111101110111111111111111111011111a1101111111011111111a010111111111000101a0011111111111101111010111011010111111101
1021111221012110222021022222101011111101a111111100111111110111101011011101111111a1011110111101111111a111111111111111111a0011111111111111111110101111001111010100
1002221121122201210201222202211111101111a110101001111111111111111110110111111111aaaaaaaaaaaaaaaaaaaaa011111111111011111a1110011101111111111111101101101100011111
2002101001221122122020211110100011110011a101111010111101101110111101101011111011111110101111111001111110011111111101011a1111110101111110101011100111111001110111
1112101121101220210010202021212101111101a111111111111011110110001101110111011001111111101111011111111111111111111101011aaaaaaaaaaaaaaaaaaaaaaaaaaaaaaaaaaaaaaaaa
1111110111111011110101111111101101110011a11001111111111110100111111110111111111111011100111111101111111110011101111111111111011110111011111011011111111111101111
1111011001111100111110101111110111011111a11101011111011110101011110110111101010101101111011111111111110110111111111111100111111111111001111011111000111100011111
1111111011101111111011111111110100101110a11111101111111101011111111100111011001111011111011110010011111110100111111111111111111011111001111001110011011101111111
1111111101101110100111100110111111110111a10011110111111111001011011111110111011101110111110001111111111111100001100111101111101101111011101111111110110110111111
1111011110111111111110101110110011111110a11111111111111101111111111111101101111011111111101111111011111101111111101111111111110111110111111111110100101011111111
0111010101111111111011100111110110111111a11111111111111011010111001101111111011111110101111111000011111101110101111111011111010011111111111111110111001011101110
0111011111101111111111111110111111111111a10101010111111111111111111111011111111111111101111111111101111111011111110110011111101011111101110110110111111001100110
1111111111101101111111110111111011111110a01111101110111111111111011111110011110011011101101110111111101111011110101111101111111111111010011111111111111111110110
1111101111111011111111111101111110101110a10011110110110110101111111111111111110111011110010110111001101001111111100011110100011111111110011010011010110111111011
1111110101100111111101111111111011111111a01111111110111111110110100111111111011101111111111101111111111101011111111111101110111011111001111111111111110110111110
1111111010011111000110111111110111110110a11110011111001101011111111001111111010010111111111011111111111100011011111111111011111011110111010101111111101011111011
1101100111011111010111111111111101101111a11101101111110111111111101101111111111011111111111011011111111101111011111101011111111110011110110111001101111111110110
1101111111101111111111011111111001111110a11111101111111011111111011111111111011111011111111111011111100100110111111111110101111100111111111001001110011111111010
0000110101111111001111111111111111111111a11011110111110011111111111011011110111111110011111111011111111111110111111111011111110111011111100101011111111011110111
1011111111011111011011111111101011101111a11111101111111111111111111101010111111111110111101001111111111111100101111101011111001011101111111011111011111111111111
1111111110111111101110111111011111111001a10011111111101111111111110111100011111111101101111011111111011101011111011001101101110111111111110100111111011111111110
1101111011110111011110010100111101101011a1110111111aaaaaaaaaaaaaaaaaaaaa1111111111111111101111111111110101111111100001001001111111110101100111111111111111111110
1111101111111001111111010110011100111101a0111111111a1111011011111101111a1111111101101111011111011111111101011111111111111111011011101110011111101111111001111111
0110011110101111110111101111011110111011a1111111101a1111110001011011100a1111111001110011111111111110111101111011111111111111101111011000101111011001110111100001
1111111110111111111110011101111111111100a1111111111a1101101101011111111a0101010111111101111111011111110111111101111011111111111111011111110111101111111100111110
0111110101111011111111110111111111101111a1111111111a1111110100111011011a1011110110111111110111110100111111010111111011011111110111011111101110111111011111111111
1100111111111010111101111011110101111111a0111011111a1100011101111111111a1101101110011111001010111101110111110111111001111001111101110111101111111111110011111110
1101110111110101100111101011101111011110a1110111101a1111111110111110111a1111011111111001101100101110001111111111111111111111111101111001111111111111111111110111
1011110010011111111111101111111111111111a1101111101a0111110110111011110a1111011111101111111011111101111111111111011011110010111010111111100101011110111111110111
1110010111001111111111111101100111001111a1111111100a1111101111111111101a1010110111110111101001111111111111101110100101011101001111001111111011111101111110101110
1110111011011111110121002112121122121212b2112211111a1111110011110111100a1111110111000010111111111101100110111111110110111101111101110101111111011111011111111111
0111111111111110111120111122221211201211a1212210111a0011011111001111111a1110011110100110111111010011111111001111111001111101111101111111011111110110101111011101
1111110111010111100122122201122012212120b1110010010a1110111101110111111a1001101111101111111111111011101111111010111111111110111111111101111111111111111110001111
0010111001111110022212021101202211112001a2221211110a1111111010011110111a1100011101100111101011111111101111111110001111110111111111111111111011111111111110110011
aaaaaaaaaaaaaaaaaabbabbaabbbbabbbaaabbaba1221221111a1111111111001101111a0111111101111011111111110111111101111111110111110110011011011101111110001101111110101111
111111111111101022100112011121222101221111012200011a0010101111111111111a1101111111111011111110111111110111110101011101100111011111111100111111101111010101111111
111011111111000110221001022211001022001101112211101a1001111111000011001a1110001110111111111111111011111010110100111111111101111101111111111111111110111001110110
101111111111111121111122122222220021221222002121111a0001100100111111111a1110111111101011100111110110101110111111111111110111110111001111111111111001111111101010
111111111111111102012201102022011110110112200011111a0011111111111101101a1111111111111110111101111111111111110011110111011110111111110111010111001111011111110110
010011010111111020122211211222102220122122210221101a1111100111011111011a1110111110101111101111111011011110111111011111111111111111010111111111110111110111111110
011111110111111022111120202211102121110121201210111a0111011111111110101a1111011011111111111011110011110111011110111111111100111111111011011111111101110111111111
aaaaaaaaaaaaaaaabbbbbaabaababaababbaaabaabaabbbaaaaa1111110111111110011a0111110111111111111101111111101111111111010011111111111111000110011011111011111111011110
11111101011111011111222220210011112211120002112111111111101011111111111a1011111011111011111111101111110111111120222221211222102200001111122221011110110101111111
11111001111111001120212122112121222211222122212110111111011111011111111a1101111111111100111111111111111111111111122200221120001212120222011121111111111101111111
11100011111110110022201111211121121110112211220110110011111111101101001a1111111110001111111110011010001111101111111122221122112021122201222221100111111011111111
11111110111101111002222210001020101222102111222101110111111000111111111a1111111111111111101101111111011011101121222212120211011122221110122201101101111011111101
11101111111001112120001211212222102112221201220111111011111110110101011a1111110111111111111011011111011111111101201222220211201002211211110110111101111111111111
01111110100111012221010101100012110101111110211111111111111110011111111a1101101011101111111111111111111001111111201110212212022011211010012111111111111110111111
11111110101001112202222121012121012221221010212011111111111101011111111a1100111111111111010100111101111110110120121110212200021112112100210120100110110111111111
10110111111101111102222211221112222100022120211111110011101101111111111a1100111111111000111011111101010111100111022021111022201212212000200201111110011111111111
11101101111011112022120210221211212121120201002111111110101011111011110a0011111100111100111101111110111111111002120220010002211001110120011101111111111111111111
01111111111101112112021110201012211011212121211111111010011011110110010a1111111111100011111011111011011101111022001210212022111222112101111021111111111110111100
11101100101111011111222100112112011022112221221001101111101110111101110a1101111011101101100110111111111111011110002010201222101121112022211221111101111111111111
11111111011111111221022020001201120122121021022100110011001110110011001a1111101111011111111101001111011111010102120210112211111212011112112101110111111011101101
11011111011111112101201122101202111002121222210111111111101011111011110a1011111011111111110101111111011111011021011011101222122111111222111101111111010011111111
11111111101111111120222112111110021102220212222011001111111101111111111a1000111011111111111110110111110111101112122212222202011012012011222111011110110111111111
11111111110100011211012202121022111022102122110100111111111011111110101a0111111100111111011100110010111011001110111112221121022122202221122021101111111101101011
11101110110111010111101122122020220021100021222111111100111101111111110a1110111101111011101011100011111011111120221122121221121222222122022211110011011111011110
01110111111101102112221221212002222002022212200001111111111111011111011a1111111111011110001111010101111011101111211110221111100121221111222221100111110111001001
11111111111111011210111021210210121102201101101101111111111111111111111a1111111111010110111111111011001111111111002112111111012120111121111210001111111111111101
11111111011101112212111110110010121002011001222000011111011101111111110a1111111111110011101010111011111111011100000021001002221010200001120001110111101111111111
00011111111101111110111111111111011110011110111111111111110111101111101a1111111110010011101011010111111110111122102110202201200101200120211121001111101101110111
