54 17
98 106
22 23
138 34
46 38
18 4
125 115
31 103
80 5
1 47

111220012122211121122211021110001211010a110111111011101011110110121212112022020121201122112201210111111111111111111111110001011101111101100111111111110101010111
111211211121122222222102020021211011111a111011011011111111111111111121022122121221201222111101210111111011101110011111111010111110101111111111111011011111111101
110210121121111211121121222111021211111a101111111011011011111111111200122201122112201121211021121111111111111101011001110110111111011110111111111110001111111111
011212112020102102200220222002122110111a011111111111110101111100102202221122122222212210101211121110111111110111111101111101110111110101011101111011111110111111
111121121222020211102122112211211111111a001001110101110111110111101101100202001211211201011220211111110111010101000101111010101111011111111111111111111000110111
011112222122220112112222011211220111111aaaaaaaaaaaaaaaaaaaaaaaaaabbaaabaaaabbababaaaabbbaaaaaaaaaaaaaaaaaaaaaaaaaaaaaaaaaaaaaaaaaaaaaaaaaaaaaaaaaaaaaaaaaaaaaaaa
1001121121222221211222111120022211011110110111110111001111011111112211202222222122112212020211220111111110111011100011111011011111101011111111010101111111111111
1111111012020202211022221221112112111111111111100110101110110100010212121122121102102012220212110100101011101011011011101110101110111011011111111111111111111110
0112211011222202221020122022222221121111111111111111111001111111122021202112101221021222120112201111101110101111010111111111111011111111110111111001011111110101
1111110202111022221222222202012202220211011111010111111111111110112021121121101101122211022210121111011111111111111111111111111000111111111111111110110110011111
1111121212222212221222210202120212212211111011111100111111011111121211211111220221112111002012210011110110111001111111111101011110111111111100111111101111110110
1001201222202020102201202212222220222201011111111010110111111011122101221210212110202020022112201111001011011110111101110111111111101111111111111101001111111111
1112221121102001202222220211222201222011010011111111111111110101022101122021211212102000122111221111111111101111111011101111111111110111101010111110011110111110
1112211012102211211212222122202220010101111011010111011111111111112220120210112101122111122121111101111111010110111111001111111110011101110101111011111101110111
1100112222220021222110222121222112100210111101111101111101111011122022110022221112122111001102010111111111111111110101111111110101111111011101111101111100011111
1112112222210111212222211021210221011201110111111111110111111100111121022111220110221110201102121100111111111110001110111110010110011110110011111011111000110111
1112121012221222222220222212000020011211111111111111001010111111100222111111222212122101212112220011111011101111101101111111001111111111111110111111110111110110
100211021022012012021222110211222020200101110111111111P011110001001120001021110011201012012011100011011110111111010110111111111110100101011111101110110010010110
111211212011210122122220121122220211121110111111010111P111111001122122211212222112120121201211210111011111111111011101111111111111101011111111111111101111110111
aaabaaabbbbbbbbbbbbbbbabbaabbbbbbbbabbaaaaaaaaaaaaaaaaaPPPPPPPPPPPPPPPPPPPPPPPPPPPPPPPPPPPPPPPPPPPPPPPPPPPPPPPPaaaaaaaaaaaabababaabaa21011212110222212220baaaaaa
111222222022222022201222102211102220110101111111101111111111110012221112221012100220111122112121001111101011111P01101001111211001221b21121221002110121211a111111
101101202221210110221022020212221222211111111111111011011111101002221122211212012111211102222222110010111111011P11111110111021002112a12021222002121121110b111111
111202222022222222012012222222222221120101101111111111101101111110221111101102001112221222022120111101101110011P11111111001221211222b12122011212021121220a111110
101222020020221002222222222122021011021212220012011201211211211000022112022211121200222122222110011110111111100P10011011001002121112b11022201221121102011b111011
110101222201221100101221002012222222201012202122000212222122010111012111001012221122102121221212110111001011101P11111011111111221201a12222122102110211022b111111
111111020011220220200212021002222220212110121221111221212222001012122210210121221122111112221222100110111111111P01100111111212201211b22222121210202201211b111011
111111112221121021122012210201112222012101200111221021102222111111221021212220111021121112111121011110111110000P11011111110010212211b21221121012211221212b111100
010212202212212120022200122221022220211121012211021202221212021111110211002220102202222000022122011111101101111P10011111110122201221b22102000102100120010b111111
aaabaaababbbbbbabbbbbaabbbbbababbabbbbabb1122221211202222020201102212212112221221211112010221121111110100111010P11011001101222212202a21212221102221112210a111011
1111211202222221222221022022222020222211b2211122221122221121121112012012122211121002111202122111111111101110111P01110111010121122112a12102210212210121122b011111
1112022022220021202200022201220220221222a1101112002202101112201110211112121100222202211122111110111111111110101P11110100111112011122b22112111020112120212a111101
0111001201212220222022012011011220122222b0222120221201221002201111001011110111111011011101110111111110111111101P11111111110212101111b11221011112201002010b111101
2101210202022222022220202020220222222111b1101102120101001002021011111111111011111111101110011111101101011101111P01111011101222102221b11110100222211222211a111111
1110102112122102202211222222021022122201a2112222222222012012110111111111011011111110111111000111110111110101010P11111111111121222122b02202200110121001202a111110
0222120012012221211012022222122112011111b1112202120211221022111111110111111111101011111111111111111111111111001P11111010111202122211a22001121112212201122a101111
1212211200222202211200202212202212222212b1112120222212020121211110010111111111011110110011011111111001101111111P11011000111212010212a01212022111202202010b010100
2101020120100012221221120122210221022020b2011110111201201211221111110001111111111011111011111101101111111111110P11101111111210121211a20222111111012112200b111010
1210221222212220022121121022210210022122b12121122111212220000201110001111000111111111111111010110100010111111110P1111111111111121021b21012221102111212221a111111
2112202120221202202222022222222222222212a21212201110110220122110101001111111111111100011110111111111110110111111P1100111101120112112b02021212221121212211a111110
1200122211212100211102212102012122220102b20020222110111022122101111110101111110111110011011110011101110110111111Paaaaaaaaaabbbbaabbaa11011120112110202121a101111
2020202111021222012020111201221102000211a20220222021222121122111111101101111001111111111111001111110110010111111P0110110111021211102221211120111211021221b111001
2111202102212211112210202112121011100001a00202221212221222121111111110111111111111111111111110011011110111111111P0011111001001112222212012201111110212222a101111
1111112212210220220221111222111111111021b12222200210111121110211111110111111111111111111110101111111101111011000P0110101011012022022110202022220210210102a111101
2002122110211112121211222022021110202122a11111221120021002201110111101111110111111000010111111001111111101111111P1011111111121212122211121022121221211211b111111
2012221022120222222110022221202110102221a22210222111102121110111111101111110011111101011011111111001111110111111P1101101110212122210122120211202210210211b111101
0022001220122121020102112220222121021221b10222212111110222001211110111111110100011011111010011111111101110111111P0111011111200011022210221202111222201110b111111
1122220021111221122221221122212212102111b11211210001021222222011111011111101011010111111010110011101111110101111P1111100011200121012211202212122121122222b110111
0112221121021222202021012001112121221110b12212211221021020120111101111111001111011111111111111101101110010101111P1110111111201011121102212211201212212200b011010
2222210212111122211211112100122211112220a12110020221022122112011001011110011111111111111111010111110111110011010P0111110111111222210122101220212120222020a011101
0101211111221122202122212211222120222002a01202110210101202012211101101111111111111010111010111110111111111110111P1110110111121111120100121022122100021222b111111
2111022210121120221112001102102021201101b22010120020221122221111111101010111010110011101100011101010111111111110P1010111111011111111111011111110110111111a111111
2110212201022212020120210011221222211211b21022212212010212220100111101110011100111111111111011001111111111101110P1111111111111111111111111111111001111111a101110
2220122011121110112220122200101121100022a02222101201111221121201111111100011111111111110100111101111110011011010P1011101111011011111111111110101111111111a011101
1120211012112210112012212212201220112121a20112121221221222101110001111110110110101110111011001011011011000111110P1111011011110111110111100111111101111111a111111
1202211210012111122212021101120100101110a11110111111111101111101111111100111111111101011001101100111110111111101P0111111111111111111111111111011111111111a111011
2010212022201120211200212021212001111111a11011111111111110111111111101111101111111011111111111111101111111110111P1111001111111111110111101111110111111111a110101
2101122121221222112120100222022001101111a01100111011111111110001111111110110110101111111011111101110111011011101P1110111111111101111111111111111111110111a111111
2222102221101101111212112221120100111011a11111011001111111011011111111111110101111111111111011111110111111111111P1111111110001101011111111111101101111111a101111
0012112110211022212201120222011111111111a11111111110111011101111101111111111110101011110011011111111011111111110P1111111111111001111110111101111111111101a111110
2111222011222011212102011222121110111001a11111101111111011111011111011111111110110110111111111101111110111011101aPPPPPPPPPPPPPPPPPPPPPPPPPPPPPPPPPPPPPPPaa111111
2212222100211201012111121210210111111110a111111111111111110100011111111001111111111110111010011101111111111111111011111111111011111110110111111011111111Pa111001
2120202002121010222102212121201111110111a111100101011111111111111111110101110111100011110001100111100110111111111111110111011110001011110111110111111111Pa111111
2022112122221112101211112202210111111011a111111101111101001110111101001111101011101111111111111111111101011111110111101111101110101111111111111111111111Pa111110
1111111111111111111111111111111001101101a111111011111111111101101111100001111111111101001011111111111111111110010111101111111111011111111111000011101011Pa101111
1101111111101110111111111101100100011110a111101110111011111111111101111111111111111111111111111101111101111110110101111111111111011010110111111111110111Pa111011
1100111011111111111011111011111111111111a111111011111110111101111011111100111001111111011111111111011111111111101101111101111111010101111011110111100111Pa111111
0110111111101011111101111110111011111110a111111111110011111111111011110111111111111111111111110011111111011111111101011111111110111111111100011101011111Pa010110
1011111111101100011111101011111111011111a100111111011111111111111111011111111111111111110101101011111100111111111111111111110111111111111011101111111110Pa111001
1001110111111110001110101011111111111011a110111111111110111111111101111110111110110011111110010111111111010111001100111111111011111111011111111101111111Pa111111
1111111111001111011111111110100110111101a110110111111110111111111001111111111110111101110011101110110111001111111111111110011111001111110100111011111110Pa111111
1111111111011111000101011111111011111111a111111101011011111111111111110011111111011111011101010101111011110111111110111111111110111110110111111111111101Pa101111
1111111111111111111111101110111111111101a110100011101111010110111101111110100111111111111111111111000101111001111011111111111111111111110011111011110001Pa011100
1111111111111011111111111101110111111111a111111111011011111111111111111110111111101011100111010101111011011111110111111111110111111010111011101111110110Pa111011
1011000011111100010001111110011111111111a110111111111111111111011111110111111111111100111111110110111101011110011111111111111101101011110111110011101110Pa011110
1001010010110010111101111111111111110111a111111111101101111110111111111001111111111110100001111111111011100001111111111011111111001101111111111111111111Pa111110
1111111101111011110101111111111111111011a110111111101111011101101011101011011001110111101110110111111110111101111111101110101111111111111111111111110111Pa111011
1110111101110110111111111111111111101101a111011111111111111111101111111111000111010111011110111101110110111110001111111110111111101110110011011111111111Pa111010
1010111011101100110001101111111101011100a111011100111111011100111111111011111111001111110110111010111110111111110011111101111110101111110111110011111011Pa111111
1110111111111111011111111101110010111111a111110110101111111111111100011011011111111110111111001011111111111111111100110111111111111111101011011110010011Pa101001
1010101111111110101111010111111111111001a111111111101111111011111111101011110111110111011111111110011101111011101111111111110111110111111011111011011110Pa111111
1110111111011101101010111111111011111111a111111111110011111111111111100111001111111111010100011111111111111101100110110111111011111111111111110111111110Pa111101
1111111110111101101101100110001110110111a110111110011010111110111111010111110101111110011010111111111101100100110101111110111111010111111011111011111111Pa111101
1011111100101111111111111011111110111111a111111111111001111011101111111111111110111111111110011101100101101111101110110101100111111111111111111111011011Pa111111
1111110011111110011001111111100011110100a111110111110111111111111111110011111111110111101111111110101111111010111101101111111110111111111111111110111111Pa110101
1111111111111111011111111100101011111111a011111101011111110111111111111111111111111110111011110110100111111101001110111101111101101111101111111110111011Pa111111
1111111111111111111110111111011101111111a110001111111001111111011111111110111011111111011111111101111110111111111101111110111101110110101011111111111111Pa111111
1111111100111110111010101111111111110111a101111111111111111111111111101111111101010011111011111011101111111111111111011111111111101111101010011111100101Pa111111
1001011111111111011111111111111111011101a011111111111101111111011111110101001111110110111110111111111111111111111110011101111101111111110100101111111110Pa110100
0111101011110111020221112110120111202211a200111111111101110101111111011111111111101110011111100111110111111011011111100111111011110011111100111111111111Pa111111
1111111111111111221210121212212112111220a112002100110111111011111111111111111001011011111011101111101111101110111111111111110101110111111111111011111101Pa110011
0111011111110111201201121101021002121111b220200111111111111111110111101111101111111111111011111111011101111101111111011110101011110111111011011110110111Pa111111
1101101111111110221202121222210221222221b020112101111111001111111011111111110101010111111111111111101010011111111001011111011110101101111111111100011101Pa111111
1101011111011111212221022020110221220221b221221111111111011111111111111110110111111100111010111111111111001111011001110111111110111111001111011111111111Pa110001
1101111101001101211121111012111212011212b101011110110111111111101011111111011111111101101001111100011111100101001111011110111011111111001111101011101011Pa111100
0111111111110110220011211121102022120101a021012111111111111111110111100101111111001101111011101111011111111011111011011111101001101111101110111101111011Pa111111
1111111111011111111221221120111211201121b200110111111110111110000100111110111001011101111111111110101111110100101111011110110111111101110011110101111101Pa011111
1110111011111110222101010221112211112020a220121101111111111111110110011111111011011111111100111100110111111101001111111110111100100101111111011011010011Pa111111
1110110111000100212111101111111100102102b220211111101100110010011011111111111101111111101101111110011110111111111110101010111111011101111111011111010101Pa111111
1011101111011111121110120121011121012201a221121111100011111101100001011001011111111111001110110111111111111001101110111111111111101011111111101101111111Pa111010
1110011011011011111220121120221110110220b22122211111101100110110111111010100110111010111111111011101101111001111aPPPPPPPPPPPPPPPPPPPPPPPPPPPPPPPPPPPPPPPaa111111
1111101111111111012021110110221201011122b00202211111111111110111110001011100111111111111111111111101111011110101P2022221111112121002121122112101111111110a010111
1111111111111111202222012220122221221212a10222111111111011111101111101111111111111111011110111100111111100101100P0111220121122100121112021002111111111111a110011
1100011111111111122021021021112012022111a11102211111111101111111101111110111011111111111001110010111110111011122P0102210121022201111112212102111011011101a111110
1111111111111111012112212010221111220111a1122211010111001001010111111101111111110111111011111011111111010111112PP0021112220021010222210122122111111110101a110111
1101111100111100211221122112021121212222a1021211110111111111111111101111101111101111111111111011111111111100PPP0b1222112000012211111101211011111111111111a111110
1111111110011001101211020122210011202012b1221111011111010110101111111010011001111101011100011101110PPPPPPPPP1101b0112212220020102202221222111111101110111a011110
1110111011111001002122221111122222010112b002201111111111111101111111110111110101111111111111111111P1111011111120b2022200200022021212220022111111111101011a011111
0111110101011111222220111221202101210101a12221211110111110111111111110111011101011111011011011001010101111111111a2221010221221222112121221210111111111110a110100
0111101110110111112210221100221220222220b11111210110111101111110011111111111111111111111111111111101111110110112b1110101221201021222201122102101011101111a110111
1111110111011111222110101111211201101122a21222211111111111001110100111110111111111011011011110011111101101111002b2120010211202102111210122102111110111111a101111
1111101111111011220121111211012012112120a11220210111111010101111111111111011101001110110111111110010011111111111a2112212110222022022121121112111111101101a111111
1010111110111111220110222011211120020221a01121111101111111111101111011011111111100011111110110011101101111110111a2211011122221212121200210220110111110111a110111
1111011100110111112021221020021202221122b22101211011110111110100111111011011111010111111111111110110110111111111a0121022202002222212121222222111011111111a111111
1100111101110111220021221201201112121121a01001210111111111111111011101110111011111000011111111101111011111111120a2101212001022221021100122221110111111010a111111
1100101011001111111001212112212201120221a22121011111111110111111110101110011101011101111110111011111110111110102b1100120222200202101212012012111011111111a111110
0111111010110000222112112102212101220211b22221111111111110011100111101110101111111111101101111111111101111111121b1211221010111222202122212011011111101011a011011
1111111011001111202012221212222222102001a20222110111111111111111111011110011110011110110111010110110111111111112a2011022122212002222221121222010111111111a011111
1111111111111011001212211122212112202201a12021111111111111010111111111101110001001000100110111101101011001111002a1010120201122222122221121110111111111111a111111
1111111010011101201121111120112111012201a01201211101111101111111111111111011110011111101110111111011101111111022b1022210211112102001211221220100111011111a111111
1111111111111111111111101111101111011111a10111110111111110101111111100111011111111101101001111011111111111110112a0111222221222120201122222212110111110110a011100
