17 86
145 4
22 23
138 34
46 38
18 4
125 115
31 103
80 5
1 47

1112021122121102021111212211112121101111a111111111111111101a1010112211220222012121110111111122120011011111111111101111101101111111111100111101111111110111111111
1011220222122020112111212021211112111111a111101111111111111a1111102122122222210021221222112210111111011011101111111101001111111110011111110111101100111111111111
1001221212111011021122212221111200111101a111111110111110101a1110022221211122021001111122000112021111001011100111011101111111011111111111111011111110110111111111
1111112112221120122122122111221120111110a111111111011111111a1100111011212201121211111212101112221011111101111111111100101011101111101111111101101011111111011111
0111111201221211111021210110011120011111a111000111111011110a11101120101220211111221010112201020110111011011111110001111aaaaaaaaaaaaaaaaaaaaaaaaaaaaaaaaaaaaaaaaa
1111121022111002221121112111222011101011a110111101111111101a01111021211221121000210112221011111211010111111111111111011a1111111111111110111111101011111111111111
1110221012202112222211222221200121101011a111110111100111111a11111201221221212222110121211022022210101011011011110001001a1111110000111111110111110101111101111101
0111121101221211221012000011112100101111a111101101111111110a01111011102200020220122222012012211211011101111110111110101a1010111101110111111110101111110111111111
1112202010212211222022222122220211102210a011011001111111111a11111221100110121022122012122211122010111111011111110111111a0111100011110111111101111111111111111110
1111010220222202120220212222021022102101a111111110101111011a01111011111112122221211001122212121111111101011111111011111a1111011111101111111111101111111111011100
1110201220020012222220102122201022110111a101011111111110111a11111202201120120221011111012002221111111101111101010111111a1111111111111111111010101111111100101101
1010220022222122221221020212222121210111a111011111111111111a11111122122101102211110212122201212011111111010011111111111a1101111011111011111001010111101110110100
1011021202022212222222022120102212111011a111111111111111011a10111221121200221200112111102211210011110111111101011111111a1110101111111111111100111110101101111111
0111010222202220222221101222122220112101a101111111100011011a10111112211112222211221120122210211111011011111110011010111a1110111011010110111111101111111111011111
1110112021202122202211220102222222110211a101010110011111001a10101022001011112211021012210102202211111111111111111100111a1111101111011111110001111110111110111011
0110202222222022112220222020222221221111a101111111110011011a11111000212221022100212201012200201011011011111001101111101a1111111001011111111111111110111011011101
1012212212122122022022220220122112221001a111111111111101111a11111210020120210120212211120121121211111111110101111101001a1011111101011100001111111111111011111111
1101211221012010102022200222220122102011a111101110011101111a11110221120212121111212211102100010111100110010111111110110a1111101111111011111111011111111111111111
1112222222102121220200222002112220122100a111111111111101111a11111021122020111112211222121222121211111110110011111011011a1111010010111011111110111111111111011111
1112112022200212202100222121022202021010a111011111111111011a11111121222022020211222121201112020111111111111011111101111a1012212221022212121111222222012022111111
1111110222112112012022112010020022102211a101111111010111100a01111211110001002010011200220121101111111111001111111011111a0110212210012222120222211122212112111111
1111022212212022222221222110102102021110a111010111111010111a11010110112101212211111112002021122110110110111111111111111a1101100200102012221121212101211121111111
1112221122020002210202221221222222221101a011111011110111010a11000010212021001202122021210022221111011111010111101111110a1111001010122221202022111211102221111111
1111221111202221221202222122202220022101a001202211022211122a21100122211012200021112020201120121211110110010110111111111a1101012122221211112021000102220212110111
1110102222221220111222012201112222000022b211221110111201201abaaaabaaaaaaaaaababbaabbaabbbbabababaaaaaaaaaaaaaaaaaaaaaaaa0102020120010221020112100101121212111110
1100120022220202222221022221222210222221a22122211101220221200111111222000120201121122212222021201111111101001101110111111011101101011110201011200011212212111111
1011221222212222212112122222220220112222a12211010201221110211101122201220221111110102122212020001011111111111111111111111012220220102111221222122102022022111111
1011122202022122122211111220221201122022a11110012112121111022211111122122100111110122021122111220101111010111110110011100110100211211212222020011222121111111111
1111122121122220210222012121220222200222a02212121211102211110010101122222211202101220202101122011101111101111111111111111012201010011121222212211112221112110111
1112212212222200001112100022210222022122b12202122111222122221111010121202122222211112002222201201011111011101011011100100012022112012222121120121220021112111111
0110210220222202220222120220222222122222b22111101222112221121011111211121221221000201012212112001111111100111111101110111112222120210012120222121222202002111111
1011101020001022201212112111121222220202a12110102121112110221111100011101111011111101111011101111011101011111001111111111110122211222211222210211112102221111111
1112121122122202222200221222200022202011a21222210101011201100200111011101110111111111111111100111110110110111111101100111111222122111120112212112212012102111111
1220120122222212222122102200122222222212a21122011122112110120201111001111011111111011111111111111111111110111111101011011101210221212212101001221101221011111001
21212112112211022122bbbbbbabbbbbbbaababaa122001021121212201222110111111111111111111111101011001111110011111011101111110aaaababaabaaabbbabbbbbbabaaaaabaabbaaaaaa
22022022212102121220b20222212121222110112010102211201010222101010111111111111101110101011111100111011110101111111111111a0112122210112121102220212212110111111111
12112012121021222210b11122222022120221102212211110220012022210100111100111111111111111101011011010101101010011010111101a1011011110222220001212111212021220111101
02212221222222112202b22222012222221121112201212001212102212212111111111011111111111111111010110111011111011111111111111a1101010122221121112020121101122010100101
10112110221211122011b22020012222100222101011120111121212011212011111011111101111111111111110110110011100010111111011101a1011112020011212202112111111122121111010
01221211122202011222b12212202220210112022212022111212211122101111000111111111111111011101111111111001111111111101110101a1112111121001100111201210122101222110111
21110200112020200210b12111021112222011221201110121122222121122111111011111111111111011101110111111111111110111011111111a1111121212101120211222212110000202100111
11122221212222212121a10020202121120220120211122121221122212102111111111111101111111111011111111110111111111111111111111a1100211202020101112102202021122202111011
12002222211202102011a11211122111121212012201022210102011202222110111111111101111000111111101111010011101111110111111110a1012220201011020220101111102222111001110
12221011202110011201a10220220211222222210010210201112201212121111111111111111011110111111010111101111111110111111111111a0112011212202112011210121121202112110011
22112011010222022222a11012221011222210221001022212100111211200111110111110111100011101011111111111111111011110110011111a0112122210101222212121210212201010111011
12122122211111101220a22210222211121210112100101021222210202002111010101111111111111011111011111101111111111011111111011a1111201211210221012111201212121210101111
22222102220012121111a11111221012220112211221111222102222102121111111011011111110111111011111111110001101101111001010111a1011211012221111012101111110012210111111
10121010212212121221b02121201121121111212112201122112221111110110111111111111111011011111111111101101110111011101111111a1112201200102102000211211212221012101011
12112222211112101120a11112212112212202210121202121202011120222101111011101110101111111110110111111110001110101111110101a0110212212212002011120221020211101111111
21101212122012022221b00001211120222022222121021212122221121201111110111111111111111011110011110010111110111110111110110a1112212011021122120122112201122021110111
22110111221221122122b21112222120111220101211122111211221110202101111111111111110111100100110011111111111111111111111111a0011111111111111110111111111011110111111
11111011222120122112a12122202221222112021112211012111122011021001011101111110111111110000011111011111111011111111111101a1111111111110110111111111111101111011101
20210122120200122001b11222102210201122112102212201122222220201111111011111011111101111101011111110111100011101111111011a0111111111111011111110111011011111111111
12111211212111212112a11110122112212121102122220101211122102211111111000111111111110011101111001111111110111001110111101a1110101111000111111101101011001111110111
21012021110211212201b11020101201111111111111110111111111111111111001111111111101111101011111111110111010111111111101011aaaaaaaaaaaaaaaaaaaaa11011111111011100011
21222012110112121112b0201121211111111011101110011101110111111111111001011011011111101111111111110111110111101011111011111010111111111111001a11111011111110101111
21211202212210222020a2111022221111111110111111110111011110111101011111011111111111111111111100010010111111111111101111111111101111111011111a11100110111010001001
02110212010011221210a0120211211111011111010111111111111111111111011111011011111111111111111011011111101101111101111101110011111011110110111a11010111110111101111
11120222211002011220b2221021022011111111111111101111111011001111111111101111110111110011111110010011100111101111101111111011110111111011111a11111111111101111111
21110121212221001222b2102210122101111110111111111101111110011111110111111111111011111101110110111110111101111110111101011110101111101100111a10111111011100101101
02221210020110222121b1112022211111111011111100101111110111111011011011111101111110010111111111110111010111011101111110011100101111110110111a01101101111110100111
11210210101222101201b0021022221011101100111111101101111101101111001110101111111001011011011100110101111101111001111101011011111101111111111a11111111111011111111
22021111121212120222b2102122220011111111111101011111111111101110101111000110111111101101110101111101111100111111101100111101101111111111111a11111111110110011011
11111111111101101111a0111101110111111110111111111101111011111111111110110011110001111011111111011011110101111111111111111111111111111011111a10001111011111111111
10111110111001101111a1111010101111011101110101011111111111111111111011111111111101111111101110111111101111011110111111111101111111110011111a11111111001010111101
10011110111111011111a1000111111110111110110011111111011111011111111111111111111111111111111111101110110101111110111111111001110111111110111a11111111111011011110
10100111111011110101a1011111110110111111110111111111100101101011111011011111101100011110011111111111110111111101111111101111111111111110111a11011110011110110110
10101111101111111111a1111110111111100110111110001101111111111111111111101111011001111111010101111111111111011011111111111111011111111110111a11111010111111111111
11111111111110100110a1111111110010010111101101011011111111111111110111111101011001011110110011101111111110111111101111011111111111111111010a11110111111111101111
01001111110011111111a1111011110011111011011111011111101010101111110011110111111111111111111101111111011110111101111110101111111011101110011a11110111001111111101
00101111111111111111a1110111011111111111011111111111101111111111111111111111101110111001111111111111111111111010111111111011110101110111111a10111011111111011111
11111011011111111111a0111011111110111111110011001111101110010110110111111111111111110111110110101110111011111111111111111111111111101111111a01111111101100111111
11111011111111110111a1111111111111101011011111001111001111010110110011111111100110111010101000111111010001111111111111111011111111111111111a11111111101100111111
11011111111111011111a1110110110101111111011111111101100111001111011111110101011100110101111011111111010111111110101110111011110110011101111a11111111111111110111
01111110111101101111a1101011111100100100111111111101110111111111101011101110101111111101111111111111111110111000110111111111011110111111111aaaaaaaaaaaaaaaaaaaaa
11101011111111111111a1111111011110101110111111111111011111111111101001111001111111111110111111111111100001110011101001111101111111111111111111010011001111100111
11111011101111011011a1101111111110111111101111110110111111111110101111111111111001001111111111110111011111111110111110111111111111111111011100101111111101111111
11111011111111110111a1101111111110111111011101111001000111111111011101110111111111101111001111010111111111100111011011011110111111111111111110111111111011100111
11111111011111000111a0111111101011011111110111111111011011111010011110111111010011111111111111101001111111111111010101011111100110111001111111111101101111001011
11111111111111111111a111111100111111101111101110111101aaaaaaaaaaaaaaaaaaaaaaaaaaaaaaaaaaaaaaaaaaaaaaaaaaaaaaaaaaaaaaaaaaaaaaaaaaaaaaaaaaaaaaaaaaaaaaaaaaaaa11111
11110011100011111111a111001111011111011111011101111111a001011101111111101111111111011111110111011110111111111111111111011111110101111101110111110111111101a11111
11101111111111101101a110100101111111111111111111001111a010111111111011111101011100111110110111101110011111001111101011100010111111011110101111111111111101a01111
10001111011001111111a111110111011111001111101111001110a111011111110111101111110101111111101101111111011101011111111011111111110111111110111111101001111111a11111
11111111111111101111a011010111100111111111111011111111a111101111001101000110111111111111111111101101111111111111101111111111110011000111110111110111101111a11111
11111111101011111111a011110111111011011111101111111111a111111011111111111111101111110101110001100110101010101111111101101111111101001100111111011111100111a11101
11111111101111101111a111111101111101111110111111111101a111111110010111111111111011101101000111101101111111011111011101000110001011111111011111101011111101a11111
10001111111111111101a111011111011011011111111111111101a111111010111111111111111111111111111111111110111111101111101111111111111111010101011111111111111111a11111
00111000100101101011a111100111111011011111011110010101a001111011111111111111101111111111101111111111110110101010101110110011111110111101011011111101111111a11100
10111111011111111211b121022120001021010102222100111111a111111111111110111111111111001111100011110101110111011110100111110101111111011110011101101111111011a11111
10111101111111112212b122110122210100212122102211101010a111011011110011110011111111111111101111111111101101110111111111110110111100111111111110111111111111a11111
11011001111111112122b211021102210211121212121211111011a111111011111110110101111111111010111111010111110111111101101110101101001111111011111000111101110101a11111
11110110010111111122a200221112201122122212102121111111a111011101011011101111000101111101100110110010111111111111111111111111111101111101111111110101111111a11111
11110101001111110110b011221122112112211221200121101111a011111111110011110110101111101101001110010111001111111111011110101110101110101101111110011111011100a01101
11011111011101002020a021212102212122122222110010001010a011011110110111111111101111111111111110111101111101111011111110111110010110111110011110011101101111a11111
11111101111111112102a211200112012211021222121111111101a111010111110101110101111110110101100111011011111101101110111111111110111110111111111111110010111111a11111
11111111001111111102a122111220211220201212112100110111a111111111011111111111111101111011111011111111011111111111111110011101101111111111110100111111101011a01110
11110111111001110011a011102211112121012121112101011111a111000111111111111111111001110111100111111011001011111111110110111110111011111111111110110110111110a11101
11110011110110100012b112122220100120101112102021011111a101111000101111001111011111111111111111110111111101101111101111111011111111111111111010101011111111a11111
11111101100111110201b202121221220022222122121011011111a111111011111110101111011111111111111011011101110110111111011111001100111111111111101001100011110111a01111
11111111111110012012a022221111111222212211121121111111a110111111010111101111101011011011111110011111111111011001010111111101111101111001101111100111011110a11111
11000111111100101112a222111220221111221211220111111110a110111011111100111101101111111110111111101111111011111110210112220112211021222120112111110110111111a11011
11111111101110112011a201201211112211211221012121101111a101111110110111110100101001111110111011111101101111110100211112012211121122212021120101111001100111a11101
10111111100111111012a101222121111201212110001121011111a111111111111101011111101011111011110011111011111011111120000112022212111212121220122211111011110110a10110
11010101111110110222a121110012111022201121212111011110a111111111011101011110101110111001110111111111111110011011002212200222110001222002201011111101011111a11111
10110111111111110222a211112221221222112001012211111110a111111101111111101111110111110111111111001111111011111022111212211111211102212122010111101011101111a10000
01111101110111111212a220112220121121122011221221111110a011100111101111110101011111101101110101111111111100111110022210011122212211112112111001111111100101a11101
11011011110101112212a120112102110110210020202011111111a111101111111110111111110111110111111110111011111111011111200121102110221221211122010021111101110011a11101
11111111100111012101b121111102201221011110111201101011a011111111111111111111011111111110111111111111111111111110120111221112202111121000221100100111111111a10100
11111111011110110211b210101210112222112121012211111111a111111101111101111111111011111111111111111111111111111122201212111001200020111122221211111110100011a11111
11101111111011102220b120102110111222221022212211111111a110110111111010111111111011101110010111011111111110101021122111110111211121012122121020111111011111a10111
11101111111111101201b111122111122221012211201121011111a011111101111011111111110111011011110111001111010110111120120102122112112022010202200121111111111011a11110
11110111110111111121b000021111012120121111221201001011a111111101011111011111011111111011111111111011101110011101210112111021012011112021112221111101101101a11111
00111111010011102010b010202202122221111122220011011111a101001101111111111111111101111101111110111111011101011111121211101220101201011122111110111111111111a10111
00011111111010001221b121122122211112221111211110100111a110101010111111111111111111111110111110101101100111101122221211011211122122100021122121111110111101a11001
aaaaaaaaaaaaaaaaabaab012110221101121111002121220110110a101011110111011111111111111011011111111010011111111101112221120212222222220221122221211110110111110a11000
111111110101111102110221012110212112120111122211111111a111011110111111111101110111111101011110111111111110011012111021222211122011120010201010111111111111a11111
111011111100111120210221112121221000022020100121111111a101111111111111111110111101111011110111101111111111110121201121212121210202210022111100101111101111a01111
111111111011101101121121212122001222101211011021110001a111011101110111110111101111111111111111110111101111110022102122021222110212211220121121011101111001a11101
111110101111101121121011210021210221121120122111111111a111000111110101101111111110111001111101111111110101111122011121102211122220222110222121001011111111a10101
011111111011111011110111111110011011101110100111111111a010011111111101010100111011110111111111011111111111011122220212222112201212010102221101110110111011a00101
