1 19
143 112
22 23
138 34
46 38
18 4
125 115
31 103
80 5
1 47

1102111121011a122211212001211012021111100010111111101110010a1111010b2001112222102220212112111122111011111111111101111101111111011111110111101010110a111111110111
0100221220222a201201211000221200101111011111111111111111111a1111100b2202201102121010111201011212001111010111111111111111111110111111111111111111111a010111011111
0012010120010a212102010221111022121111101111111111111011111a0011122b1011221010222001001211221022111111101011011111111111011011011111011110111100111a111111111111
1012112120221a220110211121122121211111010011111111110011110a1011102b0112222222112220121201122011111111111011111111010111111010110110111111111111101a111111111111
1111102112211a121221221122201220111011011001111011111111110a1111102b2211222111112112011220111211111010011111111111111111111111111111111111110001111a111111111111
1011001212010a221121220002111211111111011111101110111111011a0011122b1010121210220111112000212222111110101111010111011111111111101111110110001110011a111111111111
1102122211022b211021110222222100211101101111111111101111010a1111112a1021121202220220111111221200111001110110111110111111111111111111110101111010111a110110111101
1112111210120a012221021210221222211110011110110011100111111a1111122b0201122220122022122021020112111101111111111111001111111011111011111010111101001a111111111001
1001211022122b120212022222002222021121110110111111111111111a0110122a0221101220212212111210102100111110111110111111001111100111101111101110111011111a011111110111
1111221210221b110221002222022220210112001100110110001011011a1011111a1211122112201021202110011201111111111111011011001101111110011111111111101100111a011110111110
1111122122011b100022011022022222120012111110111100101111111a1110122a2222111122122211221120202111010111111111011111010011111110110111101101111111111a111011111111
1112110220210b111222201212012012202201101011011001110111011a1011121a2100201021211112221111121111111111111101111110111111010111111111101111111111101a101111011111
1111222021021b202222222200202212222100110110111111111110101a1111101b0211102222111022121111201111101111111011011101001111101111111111010111111111101a111101110011
0101112021020a002220021222220222022111110111111111111101101a1111121a1212111112212012120111101211110111111111111111111111111111100111110101111111101a011010011110
1110222221220b211222111011202022211211111110111111111001111a1010111a2222222000211211220202121121111111111111111011011110111111011101111111011101110a101111111101
1111201002222b222222022222001210102210111111011111011010101a0111101b2221221210011112121211222211101111110111011111111101101111111110101110100111110a111110111111
1012111120200a021212122220020212221122111101111111111111011a1111110a1120212121202122212212011022011110111111110110011111111111110111011111111001111a111101111110
1110210222222b200222220121221222222201111001111111111111101a1101102a2210122002221112111212122111111101101011011001101111111011101010111111110111111a011011111111
1011122202002a222102122202022222220101110111110101111111111a1111110a0210211211222222111121212021111111110111011111111111011111111101111101110111111a111111000101
1111011020022b022122122220222222201221111110110111011010110a1111101a1112122011121021112212100211111111111111001111111011111112121212122121122120211b211202110111
1112222221211b222122221202102222022211111110111101001101111a1101120abaabaaaababbbabababaabbbbaaaaaaaaaaaaaaaaaaaaaaaaaaaaaaabbabbbabaababaabaaabaaaa210211111111
1111010120212a222012222222202212220101111011101111110110111a1111110010022211211022111112220221201011111111110111111111101112222110021121002211201121211210111111
1012112022222b201021222021222001012222111111110111011110111a1111002102120220220211022220112122201111111100111111011111101110202112200121112210202012221221111101
1112210221022a022210221202222212121122011222111222212222211b0211122201011212212101122101122021211011111011111111101111111112111201202121111212210112110221011111
1111212222212a202202012112122222212220202100112122122120121b2101122121122200110111001221120202111111111111111111011111101112002022012122221111012020121212101110
1110201220220b012220202012220220110220222211202222120111221a2211121212112221101211020022022111201111100110111111110000111110122122110211110111221222120111111111
1111101220022b022222012212222112201222121111121201121202011a1211112122222121221112222211212202101101111010111100111111111112211211111122112002101210201121111111
1112021211212b211201022022122022221022222121012122121122021b1211021121010020221112221222222221111111111111111011111111110011021121010202110110022211220121111111
0102202112222b210222222222212221222220122121011121112202221a2211102221122102101221122020022222110111110110101110101011111110120211122121121111111211112221111111
1111122021120b221020222220101022222222220112212210221211211a0011100222122121111222122121111222021101111111101111111101001112120202112102222221112112121112111010
1102120210222a020120222122022020221211121201210220100211220a1110012210122202221222210121220001201111111111111011111111011112121022110021001211112012112102111011
1010111111021a111222021122212122202022202111111122120221210a2211101111010111001011111011111111111111111101111111110010111112022111210002120201001121021112111110
1012202120220a220201222201100021211221221211210202220212021b0211111101111111110111111110011111111111110101110111010111111001211212121022112211221120012211101101
1020102222222b221120022202221002201000120002222101211221202a1001111111000111011111001101110110110100111101111110011100101011212012210112102102211212011002111100
2212121220111b222120112220212120121122112120222100021112122a1011111111111101111111111111111111011111110111111111111111100110221001021221112110020020012110101110
1100222222211b220200222222212102222222111022122212022221222a0211110111011111111100111111111111111101011110111111111110101012211210121202222202120121201122111111
0022110202202b011222220222112222222210012201011200111012020bbbaaaaaaaaaaaaaaaaaaaaaaaaaaaaaaaaaaaaaaaaaaaaaaaaaaaaaaaaaaaaabbbababbabbaabbaaaabbbaaaaababbaaaaaa
0112012202220b10121220222022120222222022220210102121122000012111101111000111111111111111111111111111110100111111100111110110210001021220222100222221210211111111
2100021211121b22211220021222010222011211211202122102112122012111111110011010110111111111111111101111101111111111101110111012122121001012012212102211122211010010
1221121012210b20112201202211022122110211211000220210222101221111111111111110010111111111110111111111101111111111111011101012221211011122202022111201002210111111
2222102222121a21101101222212112121121222210200221021020110212111111111111111111111101111011101111111111111111111111111111112121112011222222220212021111000111111
1120201012111a12120201122110222222011112200212210210021220222200110111001111101111100011010111111110101111110111111110111111101202010210111122212011220122011111
2011002011011a00122221202112120202022221210212211222210122122201111110111111111111111111111011001111011101111101111111100112101121220212102121211102110202111111
0212022112102b22211021221112001202011002112011211211022101112111110111111111111010011011111111110111011101111110101110111112210020112222221120222212012021110111
0101012200111a12211101201111220112111022212211122212201221111201111111111011110111111111110111101111110111111101111101110111011221212111101110201211112111111111
2121202221110a20202102110212212121211221221110221222012121210011011111101011110111011001110111111111110111111110111011100112211221202221111121210011222110111101
0221121111212b11111211212022212001221112222201222222020222002211110011111111111111100111011101011110111111111111101111001111002121021212110102212210210111111111
1222020012021a22121101222002012222021121212212201121111220121110111111111011111111001001111111101110011110011111111011111002122111121211120220202012211211011110
2202221202011b00110220210020211021120021012200221100001221211111011111111011011101111111111110111100111100111111111111111110110121211200012011212111122210111111
0220111102222b22220222111210200012102212212112120022122101022211011110110001110101111111100010110110110111111111111111100111122021111121110002021211122211111111
2220021120121b01101222021021120200022122112122121001222121212211010111011101111111111111111110100111101111011101111010111011111101111110111111011110111101101111
1122111121112a12022121212221221112020010111211100111201000122111111011111001111101111111011111111111011101111111101011111111101111101011011011001111111110111111
1021202222202b01012220022100100111221112111221120021120111111111111111111011011111001111011011110111101111101111111111011100111110101101111111111111011111111011
1221222221112b10122020100012221221201211200111022212120112102211100010111111011111101111001111101111111111111101111111111111111111011110111111111111111111111110
1210112021101a01112002111022020111001110111111111111110111111111111101100101111101111001111101111111110110101111110111010011111101111111111111011101011111100101
2011022222100b21212211101100202100111111101111111111100101111110111011011111001111011111111110110111111001010101101111111011111101001111001111011111001011011101
1222022011200b21021200121221120111111011011011011111111111011111101011010110110110111111111001111111111111111111111001111111111111111111111111111110110111101101
2222122002121a22102212020001210110001011111110111101111111101111110111111111111011100110110100110110101111111111011111101111111011111101111100101111111011101011
2100202011101b22020200111120121111111110001100111011000111101110001001111111111111111111111111111110100111111101111111111111101111110111111011101101110111111111
0211121212112a11020220222112122111111111111111110101011101011111111101111110111111010101011011101111111110111111101101111011111111011110011111110101111111111011
1012102122012aaaaaaaabbabbababbaaaaaaaaaaaaaaaaaaaaaaaaaaaaaaaaaaaaaaaaaaaaaaaaaaaaaaaaaaaaaaaaaaaaaaaaaaaaaaaaaaaaaaaaaaaaaaaaaaaaaaaaaaaaaaaaaaaaaaaaaaa110011
122201112111222102110221221212210111111110101110110011101111111011111111011111111111111101111011111010111111011011111101111110111111010101101010110110111a101110
111202221121210111122211002200211111011101111010111111111111111100111111101111001111100101001011111111111111110111111111111111111111111111111111111101101a101111
011010111011111011111110101110011111111111001111110011110111011111101101111101111001111111001111111111111110111101101011111111111110111111010011101111100a101111
111111111011111111101011111111111101111000111111101111111110111111111111111111111101111110110111111111101111111111110111111111101111111111111110010101101a111100
111111111111110110110111110111111110111011111111101111111001110111110111110111110111111101101101110101111111111111011101101111001011111110101111111111101a111000
111111111111111111110111111111000110111001111111111101101111111111111111111111100111111111111111101011100111111101101101011111111111110111101001011101100a101111
110111100110111110011111111110111101100101111111111000000111111111111111111111011011111111111110001111101111011111010111101111111110111111011101110111111a011111
111101111011101110111111111111011011111111111101011111100001111111101101111011111111111101111111110111111101111101111111011111101111111011011111111111111a111101
111111101101111111111011011101110101111101111111111001110111111011111011101111110111111111111110111011101111111111110101001111101011011111101111111011110a011111
111111011101111010111110011011110100111111011011101011101111111011010111110110100111111111111011111110101001111101111010111110101111111110111110011110110a111111
101111111111111111110101111101111110111101111101111110111111111111110110111011101101111111111000101110101011111011011111101101111111111111111111111111110a111110
111111111011110111111111101011111111101110001111110110111111101111111100011111001111001101111101111111010111011011011111101101111111111111111011010111111a101101
111111111101111011111111101111101111111011111110101111110101011111101101111100111110111001111101111110111110111011111101011111011010111111101111111111110a111111
111111110110010111011001111111111101101110011010100111111111110110111111101101101111011011110011101111111111111111011111111111111111111110111100111011011a011110
111111111100001110111111101111111111101011111100111001111111101111001011111111111111111111111010111101111110011011110111111110110010111111111101111110111a101110
111001111001110111111011001111111001111011101110111101111011001101101011111100110111111110110110111111111111111110011110111111111110111101111111111111101a101111
111111111110110110011111111101111001101011110111111110111011110011100111011111111011111101100111110111101111110111111110110111111111111101111110111111111a111111
101110111000111111100011111110001111100111111110101111111110011111111100111111011010001111111111111101111011110111011111111011111110110101111011111110101a111011
11111101111111111111101110101111111111111aaaaaaaaaaaaaaaaaaaaaaaaaaaaaaaaaaaaaaaaa11001110011110111100111100111111101111111111110010111110111011011101111a111101
01111111011111010111101101111111011111111a101111101111111011011100101111111110111a11111111111111111100110111110111011011010111001111111101100111110111110aaaaaaa
11110111111101101110111110111110101111111a111001110111111111001011110101101111111a111110111011101101101110110110111101101001101111111110011110011111100111011111
11111111111111111110111101101111111111111a111101111111110111010111011101111111111a101111110011111111101111111111110011111011111111111111100101001111001101111101
10111001111011111101110110111111111110011a001101101111110111001111011111111110011a110000110110110111011101101111101111111111111111111111111011111111111111111111
11110011101011111111100111111111111111100a111111111111111111111011010111110101100a000010111111111101111111101101111111111111111101101001011100111111110100111111
00111011011110111111111111111111111101111a111011111111001111111110011111110111111a111111111111111101111111111111110111101101011111111111110111111111011111111101
11101010101100111100111101111111110111101a111111111111101111011011100010110111110a111111111011111011110101111111011110111110111110101111011111011111111110101011
11010111110111110111111011111111101111011a111111111111101001111001111110111111111a111011111100011101101100101011111111110101011011111101111111110010111111010111
11111111111101112122221211022112121221111a201121001110111101011011111111111111100a111111011110111111111111011011111111111100111111111111111110110111100011011011
11111010111011111121212222222120122120121b122121111111010011111111101110011110111a010111111111111110110111111011111110111101011011110001111111111001111111101111
11011111111111110120122220222110101222121a121221011111111001101111011111111111111a111111110111101101111011111111111111101111111110111101011111111101011010011010
10111011111111112101112221110121112221220b112111011111101111001111101101111111111a011111111111011001111111100011111111110111011100111011110111110111011111101111
11101111011001112222221112221211002112001b102121111110110111111100111111011000101a111111110111010011011111111111101111111101111111111010001110110101011111111111
11111110101111112010112100110021002100222b221121111101111111111111111111011110101a101111111011101111101110111100110111101111011111100111111100101111011111111111
11101111111011111121211101202212221212201a212210111111101000111101011111101111111a110101111011111111101101011110010110011111111111100110101111111101111011101111
11101111110111112222200221021020122011221a120221111111111111110110001111111111111a111011111111111001111111110111111111000111111111100111110110011111111000011111
11111011111111102222001210101212200201220b212221111011111111101101111010011001111a001111111110111110101100111111111101100111010111010111011011011111111111111111
11111111111100110201001012112002011110202a122111011111111110100110110111011110111a110100111011110111111101101111101101011011111101111111111101111111111111110111
11011101111111012202110101211110121020102a212201111011111110111111110101111101111a101111111110111111011101101111111111011101111110101111111011111001111111111111
10111110111110100122212201221122022221122b112221011110111111001101011111111101100aaaaaaaaaaaaaaaaaaaaaaaaaaaaaaaaaaaaaaaaa11011111110100111111111110011110111111
10111111111101111112222211212120121120222a2110011110110110111111111101111100011111111111110110111111111011111100201212120a10111011222000210111111111101100011101
00100111001011012122120222202121211220121b2222211101111110011111111111111111111111110111111100101111111111111101100022102b02221212110002111021110111111111111111
10011111111110112222021121110211122111101b1112211101101011110101011100101111101111011101111011111011111111111121221202022a21011202210222221211011110110111011110
11111111111111111101211002220212211221211a1211201011111010111011111111111110111011111111111111101010100111100110221211122a11221012121221112221110111101011101110
11111111111111111222112222220111021211121b0221211110110110101111111001111111100111111011111111111110101100010112111001222b20221211012220202021110111010111111111
01111110111111111012220012212121111211122b1220211110111111110111111101101101101111011111111111011111111011111112121221122a21022220212122201221111111101111011111
00010100111101102212211211211211122021221b1011101111111111111111111111111111111111010111010100111111111110111020222222112a21211112211121120121101111111111111100
11111100111111101212221011220111112112112b2211111011110111101011111011011111111101011110101011111111111011111120001002121a21201022120002211101000111111110111111
01100111111110102021211222211222121111100a1001001111111110111111111111101011110111110111111001111101111110111111112011201a21210102021112221121111111111111100011
10010011111110112220212222221010112120221b2222111011111101101111111111111111110011011011111111011111111111111102212122220a21021212121211111101111111111101111110
01011111110010110211212222212220122012222a1111111111110011111101111111111011110111111111010111011001111000110122102011111b11021110212221221020011111110111111111
11111111111111111020002201211112102112220a1112210011101101111011110101011110101110011111000111111101111111111021202121222a01211102111102202111001111111011111111
11011011111011012211221110021010111101120b1222201111011001110111111111011111111110101111011011111010011111011120111121111b11111120022221222201111001111011111101
01111111111001100202110121022121112111112b2012111111101111111110111011111101101111111111111001111111111011111121112022221b20210012111211001221111111111011010011
11011111110111110011102221010220101021122a0221101111111001011011110111101111101101111101111110111111010011111002122111212a22121210212022201120110111111011111111
11111101111111111221202222001011112122101a2222110111111100111111111110110011111111101101010011111010011111111121111121010b10212201101212221211101011101011111111
10101111111011012112110122111121212110122b2211011011001111011011111111010111111011110111011111110110111111111101212011211b02011211122111212001011111001111011111
10011011111110111000220111201102212202122a2222010011111111010101110111111111011111011011111110111111111110101111120102012b02112201112101112210110111111011111101
11111111111010111100212221001201022212101a2222111101111110111111101111101010101101111101111111111111101111101121112202122a21212101220200100111111111111011111111
11111101111110101111011111111101110110110a1111100111110011010111111111110111111111111101111101101100111111011000222111200a01020120102121100200111011111111110111
