17 86
145 4
22 23
138 34
46 38
18 4
125 115
31 103
80 5
1 47

1110122202222220121022221222201111011111111100011001111111111111022011022220212222220011010120110111100011110111011011111a10111010111011111111111111111111111100
1001212022120201221111121222102221011101010110111011111101111111112221112211122221022221100112220111111110111111111111101a11001111111111011011111011101010111111
0112122121121111110011002120110010111100011111110110111111111101111121112011212222111112221102210111110111111111111110111a11111111111111111111111110000111111111
1111221120001210122121221220201221111111011111111100010110111111111202121122201110112011112100121100111101101111111101110a11011111111110111111111111111111111011
0102112122210121111111201102222122111111110111111111111100111111111020021002111222222020221101211111111111111110111111101a01011111111110101111111111011111111111
1111021010112112111112100220222100111111111111111111111111111101010002111020111022111202211202111001101111111011111001001a10101100110111101111111011001110011011
1110221022122111021120210211110022111011101110111010011101111111110100021112122222102111110111110101111111101101100011101a01101101111111111110101111001111111111
1100222222121101222210221211212122111111101011101111111111101111122021202021121001121001200221211111111111111110111111101a11110111111010111111111010111111111111
1110021221012022210112221222121221220000111111011110110111111111111122221122100222001221221112221111110111110101111110111a11111111111111111101111100111111111111
1111212020212202122222220222222002022001011111111101111011101111102121212001122121121001112222021111111111111101111111111a11111111001111111011111111011111101111
1111110022201221222222212221102220011111111111111011011111110100122221000200120001112100112112121110100111101111100011011a01111111110111111011011111011110111111
1111222221212212220020222022022200102111101111100111101100111111120121101010121020220101212111111111110111011111101110110a11110111011101110110111111111111011111
1112210122222120222202201202112222111211000111110111111101111100102210112002222112212222202211011011010010111011011110111a11011111111101110111111011011111101111
0011211122201221012220221212220221112111111101110111111001111001121121221221222202112212022222211111110100111101011101011a11111110011111111010100010111110111100
1101100221222220211121222222022012112201001111111111111111111110111122101121110112110202201111111111101101010111011110010a01111111111111011101111011001111111101
0111012200222220222212220112121120122210011111101111011111110110111122121220120122202111202110110111111111101110111111100a10011011111110010011101111110010111110
1111122222200212212202222220201122220210111011111111111111101111102202202122220211220112210221121111111111111111111111111a11111101111111111111111101111110111111
1111222201222122122221122222221122211111111101001101111111011011122022110022002022122221201101121011001110101110110111111a11111011010001110111111111111011111111
1111110022122222222100121212222221111011011111111111111110111011112012121121211212212101212112011111011111111011111111110a11111101111001111100111101110111101011
1012221202020022122100020221222212210111111111111011010111111111122020011212122201122120201122120101111011011110111101111a11212002002220222212111111102211111101
1112211202100022222222101221022222111201011111110010111111011111012222222012111112111022022111001110001111110111101111111a10201211221221120112111222212222111111
1110221221221222222020202221220212111111111100101100010001101001011002120102220010112121121201221111110011011111111011101a01010222222012021111222110202012111111
1102222221022212222110112022202012122011111111111110111111011011022201022212022121111202101222210011011100101111111111111a11121211121122012120122102111210111011
1112121220222222222112112212102022022222202222011121121121211110021220112101212121100120220110121010111111111011111100100a10121022202220110122110122212211110110
1111211222222022122212222122210200202211111101212121221122212210012022022102100100222201211202221011111111111011111111111a12111011201222211110210100221122101111
01001021222200122202aabbbabababbbbbbbbaaabbbbaababaabbabbbbba101121211122102101221102221112022021111111110101101111011111a10210100221211212222002201121202111111
01121202202222220221b122222021222020221120120120121121022211b101112111021012122011201021111212210111100111111111110101010a02212120021121201210101101011211111111
11122122102222220122b212012021222100221020222101102222121011a210001021211101210222101002002111201111111100111101111111111a11122102102122122001001122112201111010
11111102211002201122b211222200112222222111211012212221012021b211120212221222122002221122111102101111011111110111111111110a12211202010112102201102121221211110101
11110012121022222120b222222222220201212221101220220210111121b100111110102212211221221011222200111101111011101011001111011a12200111211222112101222022212200110110
10121212121120101222b221102212122222101210202021111111020121a201111101202021112121121122101110211011111111011100110101011a11121101201212002212100101212110111111
11111110201221211111a121111222200212021012101112101122002021a110111110111111111111111111010111111011101111001011110111011a10021111122111022112101222120100111111
12001222121222022211b220212001122222220111121202202221010112b111110111111110111101101011111111111010111111111011100011101a12020112221120101212211111100021111111
11112020202222220210a202120220220210122102112121121110120211b210101001111111110110000111010101110111011111111101011011111a12001120112111112011222221112111111110
22111102222102202202b122222222222202100211121202100221102121a211111111111111000111111010111101111111111111111111111101111a02101102211010120202102021001002111101
21220212210002222220b112021210222221021120212221021020012012a211110011011111111111111111111111111111101111101011110111110a11121020211111101222001012210221111111
12211212202022202221b122122101222211201001111201211101201102b111101010101111111111111101110100110111010000111111111111111a01012111002110201222122110212102101101
20221121222021222122b222222211221222100020202200011222221210a001111110111111110111111111111110111111010111101111100111111a02220122221202220102112212112200111111
12211112222221222122a222222121111211211221012121120202012220a211111101011010001101111111111101111101101110111111110111011a10122121121221122210222221010222111101
11221202122120012121b210201122221221111122102222111221212212a011010100011011011111111110101111110100111111101011101111111a11121220211021201202001121220011111010
01222210222202121111a221121211120012122102202000220222012121baaaaaaaaaaaaaaaaaaaaaaaaaaaaaaaaaaaaaaaaaaaaaaaaaaaaaaaaaaaaa11221212012112202110212211022222111111
10020212110221122112a212211112222212100212211012112112221111bb11111111111011011111111101111111110111111111101101111111111111122102021021121212221111011211111111
11220211121210111122b112221112211201122111221101221212202221ab11010111111011101101111111111100111111101111110111111110011111211101122211101211100121220121110111
11122222021110111111b002202101121001221211212122211221022221bb01111111101111101110101110111111111001111010111111101111100111121120001100220212022112201010111111
02212201120211121212a211122212221122221211121202122120221221ab11101110010111111110111110111110111111111110100110111111000011202210011110021221111121212211011010
aaaababababbabbbabaab011202120011221012011122212012220110220bb01111111001111011111111111111111111111011111101111011111111011021101122211212202222122212111011111
112120111202221120212221122222001122120022120220022202112212ba11111111110111101011111111111101111111101111101111101111111111220121022111222012020202102210111111
122212111011212012221001202020211211212012221221112021220011bb11111111111100001101100110100110111110111110111111101111101012122222111111111221111121212222111110
211001110020221220022012212120011212111022112122212122121122ab11111111111111110111111111110111101111111001101011110111101111221102021220110112121120210022101100
122221021100102111221201102202221001220221212120120122210211ab01111011100111111101110111111111111111111011101111101011101111111102021120200220222111211212111111
120211121121220111210212112221111101100221011121021020210221aa11111010011111111111110110111111100101101111100100111111111111110011111111011101110111101100111111
121111022112011111221212111121002102211201121111121202012210ab11101011001011111111111111110111111111111111011111011111011111011111111111111111111111111101000101
112112102112121211011112221211202211120112221121001220221222aa11111111110001111111111110111100111101111111111101111101111111011101101111111110011110011100010101
121202222211220111122221110101222002002211112111222211022212aa11111111111111111110110101111111111111111111111011011011110111111111111111111111011111111111011111
221110120122122022011220211201201111101111111111110111110010aa11111110111111110111111111111101111111111111111011110111011111010101111110110011111111011111111011
abbbabaaaabbbbabbbaabaaaabbbabbaaaaaaaaaa1111111011111111011aa01101010011111111111111111110111101101111011111111110111001110111111111111100111001111111111101111
2122202222222121111202110222102111111111a1111101110001011011aa10011111111111101010101011101111111101101110111110111111110111110110111111101110110111111110111111
1211121201222022221101012022011111110100a1010101111101111110aa11110011111111110111111011111111111111111111101111111111010111111110100111111111111111111111111000
2121012122210102121022120211100111111111a1011111101111111111aa11110010111101011111101111111110111111011111101011111011110101111111111111100010011111101111111011
2021020022211211122110120022001100011110a1100111111111011111aa11111111111111111111111111011111111111111010101001111111111111011101111011110111111101111111110111
2110201121121101110120111202122110011111a1011111111111111011aa01111010111111111111011011001111111010100111111111111111111011011011111110000001111101111111111111
2210202111012102202022101120011111111101a1101111111111101111aa11111111111111111011011111011110101100111101111111011111001110111111001111111111111111011111111111
2211011010202212021212122212212111111111a1011011111111100101aa11111110100111111011111111111110011111111011111100101011111111111101111111111011101000110111110101
1111110111111110001101011111111011111111a1011111011111111110aa11111010110111111101111111111000010111011111111011111011111111101110111011100100111111011111001111
1001110111111111111101110011011101011111a0111111101111111010aa11110111111001101111111111111111100111101110111111111011111011111011111111110111111110111111101110
0011110110011001111111111011111111111110a1110001111101110111aa11011011110100111001111111111111100111111111001101110111101111111111111011011101111111111111100111
0110110010111111111110111110111110111010a0110111111111111111aa11101110111110110111111111101111110111111011111111011111110101011111001101111010111111110111011111
1110111111111111111111111011011110011110a1111111111101111111aa11100111000111111111011011111111111111010001001111011111111111111111111111111111111111111111111001
1111111110111010111001101111101111111110a1110111111111110111aa01111010111111111011111111111010110010111111111101111111111110111011111111101110111101011011111010
1010111110111101111101110111111110101111a1111101011110110011aa11100111110111101111001110111111010101111011111111110011001101111111011111001110111100110111011011
1011111110111111111101101111111011101111a1011111011111111111aa11111111111111111111001111101110110101111011011111110110111111110111111111110111111111111011010111
1111111111111101101111111011110011111101a1101101111111111001aa11101111111111111111111111101010111111111111111101110010101011111111111101111111111101010110110110
1111110011111111111111011111111111011011a0110110111111111111aa11111110111111101010111111101111101110111111110111111111111011111111011111111101110111001110111011
0111111111111111101111010110110111101111a1111001110111110110aa11010111111111101100111000011111110111011111111111001011011111100111011111101111011110111011110111
0111011101101001101110111111111111111110a1100011111111111111aa11111101010011110111011110101111111111110111111111110011111001111010110111001111101111111110111110
1101101011111110111111011111101001111110a1100111011010111010aa11111110011111111101111101111111111111010111111101111111111110111111111011111111111111101111111111
1111111111111011110111111101111111111111a1111010111110111101aa01111111111111111001101111101111101110011101111111111011111011110111101111111111011111101111111001
1111001011111111001111111001101111110110a1011101111001110111aa01111011111111111111111011111111011111101101111111101011011110001111011111111111111111111110111111
0011101111111111101101111111101111111110a1111111011101111111aa11101100110011111111111101101011101011011101011101111101110110110111111111101111111111111111001111
0101111111111101010111101011110010111101a1011000111101111111aa00111111011111101111011101011111111111011101111101101111100111111111111111101101110101111111101111
1111101111110111101111110111111111111111a1001111101111110111aa11111110111010111100111101111111111111101111010111101111111111111111111111111011111111001110111001
1110100101111010101011100111111101110111a1100110111100011111aa11111111011101111110110111101011111111111110111010011110111010111111111111111011100000101101110101
0111111111101111111011111111111011011100a1110110101101101111aa11111101111111011111110110111111111111110111110011111111111111001011111111111010111110111111111111
1111111111111111111111110111011111111110a1111101111011111111aa11101111111011101111110101110110011110011111110111111111000110011111111111011101111011111011011111
1101111111111111111111110111111111111111a1110111111001111101aa10101111101101101011110111011111110111111111101111111111111111011110111110111111100111011111111110
1110111111111111001101011101111111001111a0110001110111111110aa10110101111001111011111110101111011111101101111101101111101110011111011111111011101110011111111010
1111101111011111111100111011111111111111a1110111111110111111aa10111101111110110011010111111010111111111111101111111111110100101101111111111110101111011111101111
1011101101011111111111110111101110110111a1111111111111101111aa11111111110111101aaaaaaaaaaaaaaaaaaaaaaaaaaaaaaaaaaaaaaaaaaaaaaaaaaaaaaaaaaaaaaaaaaaaaaaaaaaaaaaaa
1101111111111111120220110212112112112111a1010111101110011101aa11111111100111111a11111101110011101010001001111111111101011111101111110111101111000111000110101000
1101011111111111121221211120222220111200b2011201011111100110aa11110110110111110a11000111111010111111110111101110110011111101011111110101111111001110111111111110
1111011011111111100220112001022120111110a1111111111111111111aa11110101111011011a01111111111111111111110111111111111111111111110111101101111111111011101111111111
1111011111110101212002002020112121120112a2111121101100111110aa01111111111101001a11011111111011111011000001111111111101111011111010011111111110111011101111111010
1111111111111111202210110111221110110101a2222221111111110110aa11001011101101110a11111111111110111111111101010111111101111111111111111111111111110111111110111110
1011111011011111201212022111122022201222b2112221111011111011aa11111110111111110a11101111111001111111111111101011111111111111111011111110111110111111111111111111
1111110101111110221212121111211121011211a2210111110101101111aa11110011001111111a11111111111001111111110111101111111111011111111110111111111101011110111111111111
1111111111111101101220211001020102122212a1210111011100101111aa11111101101110001a11111011001111011111111111110011011000110011100110111111111110111111111011111101
1110111111111111112120012211111010011210a2011110001111111111aa11111100111101011a01110101110110011111110111111111110111110011011111101111111111111011111011111111
0101111101111111212000121200021211022112a0120010111110111111aa10111001111110000a01101100110101111111111111101101011100111011110111111110111111111111111111011010
0111111111110110112222022120222211212210a2102221101111111111aa00101110001111111a11111110001111111111010110111111110100111111111000111111110111111110111111111111
1110111001111111122221201111121210111112b1012221111111111111aa01111101111101111a01111111111111110101100011111110011111111110111110110011101011101011111111111111
0100011011111111212222111110010212202012a2011201111111111111aa10111111011110100a11000110110111111100111110101022112221021012200201020220221011110101101110110111
1110110111111101220011212202221212221112a1112220111011111111aa11011111110111111a10000011111111101111001011011112112112021120011212120011222101110111101111111111
1110111010111111112220110121110222021122a1111111111111111110aa11110111111111001a11100111011111111111111011010121022200121112212001201211211101111111111110011111
1011111101011111121202121111122122222110a1112221110111111101aa11111111111111011a11111010111111111110111111101012122202211211121110012200121021100111110011101000
1111111111011101200212112210222221121122a1111211111001111101aa11111100101111111a10011111111111111111100101101011021012102211111121020002221211101111011011111101
1111101001101001011222221222021011210012a2111220111111110111aa01011010111111111a11111111111111011111011111111111012221112200211011220120212121111110101111110111
1111111101111001122121010212201221020202b2220111010111101011aa10110111111101011a11111111111111100111001111011102221211220221210212202020020210101111110101110100
1001001111010111212121202110121111120111a2121221011111011111aa11111111011110011a11011110101001011101100101011121100022112121221102112101201121011010111111111111
1111011111111111021212211202221221220110b2021201101111110011aa00011011110111110a11111111110011111111110111011120222211012012211222100210101011101111011010111110
0010111111011101121011122202211112021121a0102111101111010111aa11011101111111111a01111111111110001111111111111002201212202011212212212020102220111111110101111110
1101111111011110201102201221102220210221a0222101010011011101aa11111111111111101a10011110111101011110111110111120002222100212012122121120201211111111111101110111
0111010000101111011122221210112210112111b1122121111111110111aa11110110111111111a11011011110110111110011101110111112012122102111222222211212121011110101110110101
1101001111100111122201212001120222211012a2102211111011110010aa11111111110111110a11101011011111111111111111110110102111021122112121122111111210111111110110111000
1101111111010111002021202202122000122110b1010000101111111111aa11111011110101111a11101111011101111111111111101121202200220012112110112001020121011101111110110111
1111110011111011222111221210122211202212b0110201011110111011aa11111111101101111a11111011111111111111011101111012112112110012120022222122111211110111111111101111
11111011111111102000abbbbababaaabbabababb2221121011111111011aa11111111111111010a11111111010111111011111101111121211111222001201212012201010221101100011011111100
11111011001101111121a120122221011021112121222211010110111110aa01111111110101111a11110111111011111111011111100102211102122211112121012012110111111111111110111111
11111111011101102202b202112220022101101210110001111111011011aa10111001011111111a11111011111011111111000111011121112020121212120012112111212121111111011111101111
11011101111101112112b212222200221222102012111120111111111111aa11101001111111111a11111011111111111111111110111122010222211222112021112212012211111111011011111111
11110111111110111111a111001111011110001111111111111100000111aa11001111011011101a11101011010111110110111111111122111110122212220211211202122021101100111111111110
