54 17
98 106
22 23
138 34
46 38
18 4
125 115
31 103
80 5
1 47
1112212a2110110212111122101011201011111011110111111011101011110111121212121a1210201211121111020a1111101101111111111100011111111011111001111111011111101111a01101
1112222a2120220210122022201221102211101111110000011010111110111010220201212a1201110112212222120a1011110101111111111101111101110111111110111001111101111110a11101
1112112a2111112222122112211221112211111111111111111110111101110110012222102a1020122121122102020a1110111101101101110111101111101011111111110111111111111111a11101
1112222b1212221221112111012121022211111101111101011111110111111112221120111b2010020021200220110b1011110111111110111110111111111111001111111111111111111011a11111
1111102a0121110222101221011111122211101111111110111111110110111011012101110b1200110110112102210a1111111011111011110110110111111111111110100110100111111110a11101
1110102b2222112100020222100211211111101101110111011111101111101112210212202a1222011222122112222a1101111111111110011011111111111101111011111101111110111011a11011
1112222b2121122211210212021121211101111101101111101111111011101111121200120a2122012122222211210b1111111111111110111010011100011111111111110110111111010111a10111
0111211a2222112121112101022111012111110110111111111011101100111011101120111b0122111111212021102a1111101110110111111110100111110010111010111110101111111110a01011
0111122b1220020222222202221022221212221110111110111101110111010111102211202a1102210012000022221a1111111101111110101111010101111111101111111111110111111111a10110
1110112a2222210202022222021211122112001011111111110111111101111101020110120b1021221121121102212a1011111111111111111111011110111110111111111011110101111101a11000
1001021b1102201212102221212221222201121010001110110010111111001101011210222a2220201212122201222b0111111101111111111111111111110111111111111111101101111111a11111
1102021a2021202021021220222002120122111111111101111111111011110111011222221b2101012022002211102b0111111111010111111111111111111101111011111000111010111100a10101
0101200a0200122102210022121112022102211010101111011111011101011112221102012a0212221212221212101b1111111111101011111111011111111011011111111110111111111111a11010
0102122b2222112001222222222022102211221101101111011111111110100112102111110a2221102222121222221a1111111111111111111011111010011010111011011101111111111101a11111
1112111b2202221222221220021220011221100101011111111111111111001102121212102b1122120100222012201b1111101110101110111111111111111111110111111111111111101111a11101
0112221b1202121022222022122220101222121010111111111111111111100101011111212a1002212011102212210a1111110001001111011111111110111111111011110010111011111100a11111
1001010b2121212222011112012122221122221110011010011111111001111011011202200a2122101210201200122b1111111000111100011111111111101111110110101111001000111111a11001
1112221b1222222112210222020022222210221011110001001011111111111111020002012a2101011210212120222a1111111111001110111111110011111001111111111001111110111111a11111
1112201b2200102021200020200221221200120111111101111110101111111101112020201b1212222101121112222a1111001111111011110111111111010111111111111011110101111111a10101
1110201b2222211011222122201122222222221111101111110011111011100111121021110b2012112112212212010b0111101110111111111111111100222111221022020212212120111211a01101
1112121aabbabbabbbbbabbbbabbbbbbaaaabbaaaaaaaaaaaaaaaaaaaaaaaaaaabaa1001012b1211022122111221111baaaaaaaaaaaaaaaaaaaa11110112221120202212221222122111222212a01111
1112220002020101122220021222202210200100111101111111111111111101120b2211202b212112222101211221201111110011111110111a10110110011002121111120222111212021212a11011
1012010112220222222221222101202221221011001111101100111100111111111b2122220a012211211022211012101000111111110011011a11101002121221022200221012210002010202a11111
1112001222121122212222211222222210221221111021112122102122012111111a2221122b022010211112222211111111111110111011101a11111112222002221221111110222222102021a11111
1111012222202122112221002020211221122102112121021111101102101211012a2221111b211202022220102010211101111111110110111a11101100212120222211200112120211211222a11110
1011122212222222221020202220201222212021111222112221102000120201120b2121021a202102022211122001200111111110111100111a11111112211111201202120011212220120212a10101
1110111211201221212222121222202201021210122121122111021221111011112a2010212b120001222222211212111110001011010111111a11001111002112100101222012202222101110a01111
0012122202002222022122222202211211022221122120100122212101222200111b1222210b202122022222000121221111111111111111011a11101112120010020112212222220222120212a00110
1010200201212210022212022121220220001022212212121021121110011211112b2001012a220200022122020121011100111111001111100a11110002110022202111120112121212102121a11111
1111021020210211022222201122112220212022222122221100122210121211112a0212121a122111211122011102211111111111101011111a11101111211001211222211221200012120021a11011
0111221222120122202222022121222102010222110221201211202120010211112a1121111a211110221112002202111011101111111110101a10111112201222110112200020100021111211a11111
1111111210211112211102211121210221022221111111201221112211221010001a1101111a010101001111011111101111011111111111110a11111111121202221012122210221111101102a10111
2212221121211020221220221012220021222212122221122212002112212111111a1111111a111101111111111111111111111111100111111a10111111121221222222102112212212021221a11111
2220210222221112122022021220210112211121210220122101121121222211111a0011111a111001111111111100110111101111001111110a10111111212121102212012211222221221202a11111
1212112222221221122201210021222122212211222212121201121221222111111a0110111a111111111100111111111101110111111111101a11110111211222211221221202212211122122a11111
2221121222200202220202200210220202021111210020220221112111212111110a1101111a111110111101111110101001110111101111111a11101112212222201112211120121200221120a11110
0211101112220222202102222010022222012220011101210112111111111111111a1111111a111111101111111110111111111000110110111a11111112121102112212111222221212221022a01111
1121111220201022210202202222020221110220101221212220002021122011111a1111111a111111101010011011111111111111111011111a11011112120111220011121201222210122002a11100
1102222212222010220221222120222202222121010101001021210200212211001a0010001a110111111111111011110011011111111111001a11101111112212122121112111021201121112a11101
0221021201001111202121002102221221200221022122210222222122021111100a1101111a111111110011111010111101101110111111111a11111112211202101010121112102102212012a11011
bbababbbbbaaabbaaabaaaabaababaabbabbabbabbabbaba1122212001101211111a0101011aaaaaaaaaaaaaaaaaaaaaaaaaaaaaaaaaaaaaaaaa11110112112121022120122121220222001112a11110
22202211110011022121022121220111221210012111011a2202121122220211111a11111011111111111111110111110111111111110111101011111110120121121110112211022220120122a11111
11221212101221101112100111102122210010011221221b1222110221211111010a11011111011110111111111101111111111101011011111111101111211112100102212222001111111210a11111
11122122212121202111111122202112121100012012222a1122122211211111111a10011101111101111111111111101101101011011111111111100102111202222120111211111112121011a11011
01201112211110120221012022211100211120102211122b0022221111201110111a01111111101111101111110111111111101011101111111101111112112121021011220211122100202100a11110
02220002120111201212112112002022212212211022121b2221111212012011011a11110100111111011111110100111111111111111111111110111112010021000121211221200121222102a01111
20211122202111011222102222110111001222221222210b2110022021210211011a11111111010011111101111011000111111101111110110111110112121122222022212212102220012221a11101
12202220111201212221112102211120020202102022212a1020222011101201111a11101111111101101111101101011101101011101111111011011112221211211002211112221212111120a10111
22111122010202202200111212011101222210221112011a1211212212222111111a11101111111110111111111110011111111111001111111011111101122220110110102002112112212202a11111
12211112111120010212222202122001222122121002122b2021120210112111101a11111111111001101111111011001101111111110101100011111012222011012112110211012211111012a01111
01222121020211221122122212102101012110002122210b2220121112221101011a11011111111111101101111011101111110111111111101011101111001111110111010101111111110011a11111
02212201001101122112211111021200111212122120220a1101121212112011111a11111111110101111111111110011111011111011011111110111110111110111011011111101111001110a11100
20112222022121121011222222211210112112110022022a1111101212120111110a11111111111101011111111111011111111111111111110011111111111111101111110100111111111101a01101
22110222002211222111222220221221102111010201102b1111222011022201111a01011110110111111110011111111111111011111111111001111011111111111101001010111111011111a11011
02102211001212121111122221202021101111111111111a1111111111111100111a11010111010011111110011111111111111100110111111111001111111111111111110111000101101110a11110
21021210121102022001112221220021111111111110110a1100011111101011111a01111111111101111100111011111110111110110111101111111111111111111110110111101111101011a11111
22211221100211221111112012211111011010110111111a1111101111011111111a11011101101110100111101110110111011100110111111111111111111111111011110101111111000111a01001
21002011222212122200112222012211111011111111111a0111111110110111001a01110011111111111111111111110111111110111011011010110111011111011010111111111011001111a11011
12211200212211111112221220002021111111101011111a1010111110111111110a11011111111111110011101111111011011111111011111101111011111011111111111111111101111111a01110
01111122120102211111112210100221001101111111010a1100101110110011111a11111111111111111111111011110001011111001111110111101110101011110111111111111101010110a01110
22121102211220020121021122022220101111101111111aaaaaaaaaaaaaaaaaaaaa11111111111111111000101111111001111110111101111100110111110111001011111111110101111111a11111
1121110121221210101012211211020011111111111111111111111111101111101110111011111011111110111100111111111111111111101101111111111111111111111111101111111111a10111
1121122112000212102121110221110001001111011111011111101010111110011100110110111011110111111101001110100111111111111111111111111010110101011101011101111101a10111
1111011111001111111111111100111011011101101100111110011111111101011111110111110111111011111101101111111101111101111001001111011111111111111101111111111111a11111
1111111111111111111111010010110111100111111101101111110110011101111111101011111111110111111101101011111111101001111111111011111111111111011011111110001111a11110
0111110111111110111101111111111111100111111011111111111111111110001111110111010111111011111100111111100111110011111101111111011111110111011111111110111101a11110
1011011011011111011011111101111100011111101111111111110111110101111111011101111101100101101010110111110110111111111111001111111111111111111010111110101110a01111
1101011101111010111110111111111111110111111101110110111111111011111111111110010111111001100100101101111011101111111010111000101111111110111111110111111010a11110
1011011111100101101111111101111011111111011111011111111111101101111010110101110011111100101111110111110111100111111111111111111111111111111010111101111100a11111
1111111110110111111111111111111001101001111111111101110111110111011111111101111111111110111111111101101111110110111101110111110111011111001111011101000111a11110
1010011100111101111111111111100111111111001111011111111111101111111101111111111110111001111111001101100101110111111110111111111110011111111111111110101101a10111
1111001111111100001111000111110011100111101111111011111111001111101101111110111101111101111111111111110111111111111111001010111111111100111111111011001111a11110
1010010111011000101011111011100011110000110111111001111011001011011011111110011011111111111111111110111011111001100111111101010111101110101111111111001011a11010
1101001110111111111011101111101011111011100111111111011110111111111111111100111101110011111011101101111111101011111110111011111011111011101111001101111110a00111
1111111000111111011011011011010011111111111011101110111111000011111001111111011100101110011001101101011111011111011110110010111010111111101111111110010100a11110
1011111111101101110111010111010111110111010010111011111101111101111111011110111110110110111111011100110111110111111111011111110111111110000111111111111111a11110
1101111111110101110011101111111011001110111111101011101111111001111001011110111111101111111111111111111111111011011011111011011110111111111111011001111110a11111
1110101111001111101111111111111101100110111111101110111011111111111110111011111111111111101011111111111101111111111011111111111100011101111011011111111111a10011
0111111101111111101101001011111110111111111101111100011111111110111111111111011111111011110111011111111101111000111111111011110000101111111110111111111100a11100
1111011110100100011111111111110011101111111111111111001111111111110111110111011111000111110111110111111001011111111000001111111111111111111111111111111111a01111
aaaaaaaaaaaaaaaaaaaaaaaaaaaaaaaaaaaaaaaaaaaaaaaaaaaaaaaaaaaaaaaaaaaaaaaaaaaaaaaaaaaaaaaaaaaaaaaaaaaaaaaaaaaaaaaaaaaaaaaaaaaaaaaaaaaaaaaaaaaaaaaaaaaaaaaaaaa01110
1111100101111111011111100101011111111111101110111111101011111111111110111000111010011011111100100110110000111110011111100001110011010111111111111011111111111010
1011111101111111111010111111111110111110101110011111111111111111111111110111111111010111101111011111111111111110111111011111110111101111111110111111111101110111
0101110111101111111111111110111011011011101101101111111111110010110101111110110110111101111011111011101010111111111101110111011111011011110010101111011111011111
1111101110101111111011111111111011010111111111110111100100010101111011111111111110110110101111011110111111111111110111110111001101110111111011100100011111111111
1110011011110111101101101111111100110111111111011011111111101101111111111111101111011111111101111111010111111101111011101111101111111111101011111001011111101101
1111111111011110001aaaaaaaaaaaaaaaaaaaaaaaaaaaaaaaaaaaaaaaaaaaaaaaaaaaaaaaaaaaaaaaaaaaaaaaaaaaaaaaaaaaaaaaaaaaaaaaaaaaaaaaaaaaaaaaaaaaaaaaaaaaaaaaaaaaaaaaaaaaaa
1011111111110110110a11110111010111011110110111111111101111111011111011110111001101111101110110111111101101011110110110111011111111111111111101110110011110010111
1111101101101111222b10211101012120200220111200211111100110101111111101011011110110110101111111111111111110111101111111111111111100001011011101011111100111111111
0111011011111111121a10112111112111221110111212210111111111111101111111010110101011111111111011111111111101111101011011111111111111011011101111111111110010011101
1011111011111111211a21110112012221112111211120211101011101101110111101111111111101111110110100000001111111111110101011111011110010011011111111011111111111111111
0111101101111111112b12211010002012100122111220110010101111101111111111011101100111110111011111111111101111101111001111110111111111011111100101110111111101111011
1111111011111101121a20201201022111122120022200211111111101111101111111111111101101111001110101111110110010111101101101101111111111111111100111111111111011011111
1011111100111111101b21221210100221120121222121211011111101111010111111111110011011111111111111101111111111101111011100110111111111110111011110101101111111011101
1101011111111011012b22122011121222121210112202101111011111101111110110111111111101111111111111110101111110011111111111111111111111111111110111011111111111111011
1011101111111111222b22120200212122221112022211201011011101111111101111011110110111011111100111111111110111111110011010111111110111111111111010101110110111111111
1100110111011101112b02211011102121222121122211101111010111111111101111011101110111101111111101111111111011111101001101011110111111111111110011111111111111011111
1101011110011111112a12022211021110212111212122010100111111101111111110011111111110111111111101111001111111111101110011100111011111101111010101111111111100111111
1111111001101010222a11122221112100211212201102110111111111101111111001110101111001111111101011111110111110011110001111111101111111111101111011111101001111111110
1000111111010111121a12202021211122222221111212101011111010110111111101110101101011111111110111110011111111111111010110111111011101111111111111111111110111111101
1001111101101010221b01211122101211102211221222111101111011111111110110111111101111110101110111110011100110111112111121221110022220000122011221111111101111101011
1000111101111111121b11111212211211021021002121211111101111011111111111111111111111111111111011110111111011111122211012111221221221221011121211111110111111111011
1111111111110111212a11112011222112002000121121110111101111101111110100011011111100111111111011011111111111111101212111112120020211102212101211110011110111111111
0110111111110111110a22210202011212110010211121211110111100101011011111010110001110111101111011011111111111111111211012011110222022021011122111011111011101111111
1110110111111111222b02221111021022211111221122211101011011010111111011101110011010111110111110110111011111011111010001122101202121021211210111101010111101011001
1111011111011111222a01010122002201211210022010011111111101011101011111111110011100101111111111101101011010111120102120100212101202021212111210111110110110111011
1111111111111111112bababbabbaaaaabaaaaaa121220211101101110111111011111011111111111011100001111101011111111111112112122122101202221122222210121111111011111111111
001101111011101102010211122112220011201b122201201101011111111111111111101111110111111110010110110111111101111022222220221121202020110011101110110101011111111101
000101110011110012211111022012121212221b222012210011011110011101111111111110110111111111101011111111111110011110110211102221212112012200221210111110101111011111
111111111110101111220222202202122122200a110222201011101001011111101011101111100111011111011101111111111111111121211101000212200212101211110121101111111111100101
111111111111111112121112102022212111011b220212211110101010101111100111111110011010111111011100111011111111111121021112120002120211012012112221010101111111111110
111111111011111021111120211222122222102b222100111101111101111111111011010111111110110101101101111111111111111121211000111122211111021221110101011111111111111111
111011111011110112101112022121022222211a012101010111111110111110101111111111111111111111111111111110111111011111112022102201120211112111110211110011111111110101
111111111111111121112221202222122121222a211121211111111011111111111110100111110011111111111111011011111111111101122111222222101011221221101110111111110111110011
111111111111101112112211212222201112112b022222111111111111010111100011111101111011001111011101111111011111100111022112221221201211000111211111110110111111101101
111110111101111122202210121110222111100a212012210111111111001101111011101111111111110111111111111111111111101110102121112121222220111222211200111111111111111110
111100111101011002110012201112111122222a122021111111011110010111101111111111101111111111110011101111111111101122211222121011212010201210120120111011111111111111
011101011111111100122111122122221220120b220201211110101101110011010111111011111100101011111110101101111011111122201100211122111212210221101211111111001110111111
110100001001111112212211212211102220002a220122001100111111110111111111111110101111111111110101010100101101111010221121211200120220220021021011101111111111111111
111111011101111111111111111101111111110a111111111101101011011101111111111111111101110111111100111100011111110020120110120202122110211202212110101100111111111111
