11 112
157 33
22 23
138 34
46 38
18 4
125 115
31 103
80 5
1 47

1110101101022222120222222221222011111111111011111001111111111111121122222122021120121210221212021110111111110a100100110a1111111111110111111111101111100110111111
1112221212102200211112211012112121101111101001001011110010111110122001011111111111010122212111221111101101101a111111111a1111101011111110101111111111010111101111
1100102201121220100010022112111021111101111101111111111110111011121021221212121212212122212112001111011011011a111110111a1101010101110110101011011110111101111110
1110122112122021111211202221110012001111101111011011011111111111120111220012122121022210112021011000101001111a111111011a1011110011011111111101111101111111111101
1102222211202212122202120122200200011110111111101101111111111111111121210121101112102122022201221011111111101a110111111a1111111111111101111110111010110111100101
1111001000221220121122220201210111011111111111111111011110111111120111102022111221011121112121211110010101111a111111111a1111111011111101011011001111111011111111
0102122112111210212101202102201111110111111110111111111011111011122021112221022001200201222121121011111111111a010100111a1011111101101111111100111010111111110111
0110111021212021222120112101122122110111111111011101111111110111000211122011020001102112101221201111011110101a011111110a1111111111111111111011011111111101111111
1110201212022102201212202220121210022011101010111111111111111011111011220211112221110121112122221111111101111a011111001a1111011111111011111111011101101111111111
0110112122201202010222222220001222220111011011111110011111111110122001121001011102012121212120211001111110111a101110011a1010110011111110111110111111101101111111
0111221212122211202212221220022200102111110010111110110011111100121212112210211201111020122212101111110101111a101110111a1111111111111111001101101011111111101111
1112112210102222222020110200010022122211010111111111011100111111122121122010121220211112212102201111110010111a111111111a1111111101110111111111111111111111011110
1112111222212002222122212222121222122210111110100111101101111111012222211022112112201211022122101011111111110a101111111a1111100110000001011101101111011101001111
1112222222201022021212120202221012110211011111111111011111111111112201200022221121211111122202121111111111110a111111111a1110111110111111001111011010101111111011
1112210222222222202222101012222011222001111011011001111111111111111210121222022011101112022122121011111110001a001010111a0111111101101011010101011101110101111111
1111101122222222201222221212212122212101111111111011011110111101122111211211211122121121212022110100010111010a111011111a1011111111110111111001111011111111111001
1112221021222022101021221202202220021111111111111111111111111111000212220222111222110111121122201111110111111a111101011a1111111101111100011111101011001010011011
0110100021101122211222020222220120020010011111110011111111111010111210011020120012111221122210111101101110110a110110011a0111111101101111011010111111111111111111
1112010122220222202212012111220111111201111101111111111111111011120212211121111212201221122222010101011111111a111110111a1010101111111111111010111111111011101111
1110111222222221220202212120222220101211111111111111111111111101012212121211201011211112220202211111111110111a111101111a1110112112102122222100212111201101111010
111021122bbbbbbbbbabbabbbbbbbbbabbbaabaaaaaaaaaaaaaaaaaaaaaaaaaaababbbaabbbababbbbaabbbababaaabaaaaaaaaaaaaaaa110011011a1112222201100112210220222021212212110001
111120222b2202220222102222200022002001111110111111110001101111111211122221211102122211110120122111111111101111111110001a0111222001111212122211221110202122111110
111210122b0222022222222012222222222201111111111111111111111101111221111212201211211222201010111210110110111111111101111a1102000012222222100101022111102122111011
111211112b2222222021220212102122202222201110221211011211101112111020222111210122212102211112021101001110111101110111101a0110200102222112021001201122202012111111
111222122b1021121022220222122012222212201110021112111000111122101102102120111200012211101011112111110101111001011111110a0102211210111211212122202101110111101111
111211122b1222221200102222212112022212211212221021212201201011000011210122012102122022211200200101111110111011111111110a1101200112022221021212101112021120111111
111021111b2102122222220122111212221201111101011011120221121020101202212020121202011022221201111111111111110111111111111a1110112111111010112101000202122112101111
111121111b0022222212211120222222222201011212222122112222211011111211211212201211010212222211001111111010011111111010111a1101010002010112120111212220112112111111
111211221b2122221021121220012222222212212002212011211221201002111201100212111201110011111211212211111110111111111011111a1012111022120112221222122010221002111001
011121122a2021011220012122112220222022121110201221222202021221111111021211221022212022010121212211101110111111111011111a1111110001121111111121222221101102111101
111101222b0220222022022112200222101122022212111102121220121111111122200221212112220222111200021200111111111101110111001a1112122221121011112201220201122122110010
111111110a2121122221110121002022202220212111222012021011122101111101111111111111011110111101101011010111111111111111111a1101221122122121121111220111211101111111
122212220b0220122020122110021211122222021202122201120102202002111110111111011101111010111101011001011111111110001111111a1110222202111002010222220202220202011100
221211121b2121222210122020222202022222020212021220101120112202111110111110111111111111111111111110101111111111111111110a1110011122022212211110221112120222110P11
122202222a2222221022122102221212201222011200020121221121012022011001111010110111110011010111110111111111101110110111111a001121112210021121020102000122120PPPP111
021022022b0021220201220212121202212122111220102211122201210102111100111101111111011111111111101110111110111101111111111a111111121222221122PP021010210221P0011111
212201220b2222122222112222022202022201110122122211201222112112111111111111111100111010111111101111100111011101111111111a11101222020001PPPP22PP0P1200101P21111111
012201221b2022012222222220122102222012012202012112121121101101111000111101111111110011111111111110111111111111111111111a01PPPPPPPPP0PP20122121P0PPPPPPP210101111
101211122b2201121222202122220222222022120211112001020101122222111101111101111001111111011101011111111111111111111011011aPP010120211P2111222021211020022020101101
221200011b0011211112010021211001012012222111111121211012012111011111011111111110001111101101011111111111111111001101100P0110122212122112221001021112221122101100
baaabaabbb0110222101000200102121012110120202110122222202212110110010011111111101101111110101111111111101011111111011111P1112120202022221110122121111112111111111
21021011210212120110210120022102211221111212211012101211102011111111110111111011011111111101111111011111100111110110111P1010112122220222121020212101221200111111
22012122220211202001110122212221222110121021111221112122022002110111011111011111111111111111101011011111101110110101110P1012101021220221220210011211122111100111
babaabaaaabbbbaaaaaabaaabbaabbabbbaaabbbaababbabbaababaababaa1111101101111111101101111111011111111011111011011110111010P1011022012110112101101110200221210111011
220222221122111201001000112110112211212211211201120211221100a0111111111011111101111001111011111010110111111101010110011P1112111020111021120111211121212112111111
111211221202221102212121112111112010110212120222202222010122b0110111110011111111111010111111111001111110110111111010111P1100222110101211112220112211111100111101
212101111100112101221121222101122211210122201220021200022022b2100111111111111111111011111011011110101011011000110101111P1102210122111110102022101110220112111101
121110022201212222011011022011110211010121202020212222011121a0011111111101111111101111110111111101111111111111111111111P1101112220211002120202222111121211000111
021212122111200122211200221221202210001122011121012110112222b2111111011111111111111101111111111111110110110100101011010P0111212000110101201222120110210222111110
022121021122111221121112201112210210211222022121211010012112b2111111111011101110111011110110111110110011111111111111011P1112101110211210201121211211100121111111
122022110212021002221211120112112110111102120202210210101111b1111111111011010111111011111111111111111111111110101100101P1110111011111111111010110111011101111111
220202222100001211222120022122122010211011121121020210211212b1011111110011111110111010101010111110111100110111101011111P1111011111111011001101111100111111110011
000010222221210122110121201212110022210221212111111221021122a2111101101111111111011111111111111011111011101111110111101P1111111111111111111111111111111011110101
120111202121122120202211202011202220021100220212022122220112a2111111111111111110010111111011111111111001111110101111000P1111111111111111011010110111101110101011
112222201011111122012212111212111111011111111111110001011011a1110101111111111110111101111111101111110111111110111111001P1111101011110011111011111101101001111111
221211202111111121221121222122201111011111011011101100011101a1111010001111111110111111110110111111101110111011011111011P0101011011111110011011111111111111111101
022211111112221122011110221201111010111111011011111111011011a1111111111111110110111101110100101111101111111011111111111P1111111111111111011111111011011111100111
221121021001122122221121122112011111111111010101111111011111a1110111111111111101111111110100111111111111111111111001011P1101011111101100011111100111111111111110
121121001101011121221012212111211111111001110111101011111110a1111010111111111111110101101110011111011111110111111111011P1111111011111111111111111111101111111101
110120111110212102102001222111011111111011111101010111110111a1111111111100101111111110001111111010110010110101101100111P1111111100011011011111111101110111011111
121221022122022012001012121111101111111111110111110111111111a1101111111111111111111111111110111011011111001111011111101P1101011110111101110011010011101111111111
102222221111220121112122211121201111111111111111111111111011a1111111111011111011111001111011111111111111111111011111111P1011111111110111110111101010111101111010
012212111121121222212011112112001110111000111110110111111111a1111111011111111100110011101111101111111111111111111110111P1011011110101111111111111111101101111011
aaaaaaaaaaaaaaaaaaaaaaaaaaaaaaaaaaaaaaaaa1011101101001111101a1110011110111100111010111011011111111111101111111111111111P1111111011101100110111111101111111111001
1110111111111111111010011111111111111111a1111100111110111001a1101101111000111110110110111111100011011111111111110101101P0111111111111011101110110111111111101101
1111001101111110111111101111011101111111a1010011111111111101a1111110011101010111111011111111111011111101101111110111010P1111111111111001111110011111111111111111
0101001011111111011110111101011011111111a1111111111011111110a0110011110011011111111111111111011111111111111011110011011P1111101111001111001111111101001111111111
1011111110111111111111111001111011001101a1111100111111111100a0111011111101011100011111110110111111101111111101111101111P1111111111111110111101101111011110011101
1011111101111111100111011010110111111111a1101100001011101110a1010110111111111111100111110100101111111101101111101111010P1111101111111110010101111111111111111111
1110001010011111111001110110111111101011a0110110011111111111a1011111111101111010111111110111000111111111110111101111010P0111111111111101111000111101011111111101
1111101111101101011101111100111010111011a1111011111111111111a1011010111101110110110101111111111111111111111111001011100P0100101111111111010111111111110011111111
1110111111111110011011111110011101011111a1111111111100101110a1111111101111011110110111111100111101110111111001101111111P1111101111111010111111111111110111001011
1110110011101111111011111111111101111111a1111111110100011101a1101011101111101111111111111111111111011111111101101101101P1101011111011111101111101110111111110111
1111111111101111111111111110111101101101a1111111011011111111a1111111111011111111111111011011111101111111111111011110111P1111110111111111111111111111111110101010
1111101111010111111101110011011111111101a0111111111111011111a1111011111111101111100110000101111110110111111111001111111P0111111110100111010111111111111111111101
1110111111011111111111111111111011111110a1111110111011110011a0110011011101101111111111110101011110010111111011111011111P1011100011111111111111111111111111101111
1111111111110010110011111011111101101101a0001111110111111110a0110110111011111101101111111111110101111111101111011111111P1100111111111010100111100111111110111111
1010111111011111111110010111011111111101a0110111111111101011a1011110111011001010111110110111001011001111111111111110111P1011111101111111011111001111111101110111
1111011101010110110111010111111111111111a0111111101111011001a1111101110111100111011111111010111111111110111111010011111P1111011001011111111101111111111101111111
1111111111111101110111101001101111111111a0111111110101111111a0111101100111111111010101011111110111011111111110111111101P1111111111110101101100110111100010011111
1110111111010111111111011101111111110111a1110110111111111101a0111111101111111111111111010111111110111111111111110111101P1111001111100100111111111111111111001111
1011110101001101111010001000111111111011a0111110111100010111a1111111111101001100111010001111111111011101011101111111101P0111111110111100111111010111010111111001
1111111111101110111101111011101111111110a1111011111100110111a1101111011111111011010011111111101111110101101111111101011P0111111011011111111011011111111111101111
1111101001110011110011111110101010010111aaaaaaaaaaaaaaaaaaaaa0010111011011111101010111111100101111111101110111110111111P1101111111110111111111101111111111111111
10011011101111011110001111111100111110000111111110110111111111101111100110110111111111111110111101111101111110011111011P1110111011111110111001111110111011011111
11011111111111101111011010010110111010001110111011111111111101101111111101111111110111111011111101111111111101111110111P1111101111111011111111111111111110101111
11011111110111001001110101101111011110111111111111110001011111110110011001111011111101101111110111101101111111111111111P1011011101110110111111111000110111111111
10110110111101111111111111110110110101101111101101101111111101101101111110011111101000111010110101111010011111111111110P1111101110111111111111101101111111111111
11111111101111010021011220222212001102022122100011111111111011010001111110111111111111111101001011110111111101011101111P1111111011101101101011111111111101111101
11111101110110112201110122021221001022221001212111111010110111011111101111100111100100110011111111111100111101011101111P1111111111111011111010011110111100111111
11111101111101111121121122100211020022111221101111111100111010111111111111111111110111110111110111110111011111110111100P1111110111111111111111111111101111111010
11011111111111112122120200200122111200111220121101111001101101011110111111101100110101111011111111111110111110111111110P1001111111111101111111010111110101011110
11101111011011112122222101222112111120102100211111111110111111001110111111111111111110111111100111101110011110111111111P0010111111111110111101101111011101111101
11110101101111012012012222111112212122121221212111100011101111101111101011111111111110111101111011011001111111110001011P1111110111111010100111111111011111111111
11110110110001001111010010222221211002021201112110111111111111100011010101111111110011111111111111111111011111010111010P1111001111001111101101111011111111110011
11111111111110001121122221100212102220121202022111001111111011110101011111101111111111101110101111010111110111100111111P1011111111111011111111111111100110011101
10011111011111112222101211021122202112220012210111101001111111011111111010110111111111101111111011011111001111101111100Paaaaaaaaaaaaaaaaaaaaaaaaaaaaaaaaaaaaaaaa
1111111101101110221211210101122210212102201121111111111111111011111011111111001111111011101110111110101111110111111001P11110011111011111111110111111111110011111
1101111101101111221220112101111011122111212211111111111111100111010101111111110110000110101011111111aPPPPPPPPPPPPPPPPPaaaaaaaaaaaaaaaaaaaaaaaaaaaaaaaaaaaaaaaaaa
1111111011111011011210211012121101210212201211010111111110111101111111110011101110110111110111111111P01111111111011101110110111001101111101111101111110011111111
1111110111111100210101121212021102211121010210011111111111110111111101111010111101110001111111111010P11111100110211011122011221120012111211201001010111111011111
1101111111111011101210112220211222212012011210011111101011111010111111111111110110011111111111110010P11111101120222220210211202220121110201221111011011111111111
1111011111111111111112212211122120121022122211111111110110110011111111111100101110101111101101111111P10111101111202112021221121210111121012111011110111011010111
0101111111111001112111012200001211121101112111210111111111110111111111111111011111111111011110111011P11111111121021101012012121110121200020001111111110111111011
1111111111111111101112221211021111111101002122101111110100111101101011111111111111111111111010011111P11111111100012121212221110212202122111221111011111111111100
1101111111111111112211102221112221121212222210011111101110011111001111111111111111111100011011100111P11111011110221112001101200012110222211021011101111111100111
1111111111010101101222222110022212212020202122211011011111111110111111010101111111111111110111111011P01111010121212211211112110202100102222200111111111011111101
1111110111101011210201202211021211022110212011211110111011111111111111111101111110110101111111101111P01111111112120021210122012010211221121220101111111111111111
1111110010111011211111202011221122110201222120111111011111011110111111111011001111111111111111101111P11101000021212211122111220200102122122121011110111101111110
1111110010111011021111212202012211120012021101111111110101111011100111111101111101111111101111111101P01111111111000111101102221121222112111121111011110110010111
1000110111101111112212121112122120202222211110201011010111111011111111111111101111100111111111101011P11111001121222221221011102201010012121221101111110111101111
1101001101111111120012211211211110110111102221111111111111110111101001111101111111011101111110101011P10111111012122010221122202111012111212221011011111111011110
11111111111P0111000200120121121221102022221011200110111111111111111010111110111111111111110110101011P11111111020221210101211000111122221101211111111110011111111
1111110111P00101100210221202121121021022210011111111011111110100101111010100110111111011001100111111P11101111120021221222111220122121212102201110111100111111110
1111011111P11010112202221221121212211122112212011110111101111111111101011111111100111111111011111111P11101111122202221011111221211122221221120111111111011011101
1111111111P11101101102111022212011212201001012210111111111110111101100111110110110101111101110111111P01111101012111100222011102110001001020000111111111011111111
1111010011P11010112210121212212212220201211121211111111111100110110111111101111111111011111111111101P11111010101012112222111201221221102201011111110110111011111
0110111101P11101011211120111212211001102120211011111111111110111111111010111111111100101111111101111P10111111120101211112001010221122211210021111110111111111110
aaaaaaaaaaaPPPPPPPPPPPPPPPPPPPPPPPPPPPPPPPPPPPPPPPPPPPPPPPPPPPPPPPPPPPPPPPPPPPPPPPPPPPPPPPPPPPPPPPPPa11101101111111212221221120221202222102111101110101111111111
0111111111101110111001111111101111111111110111101111111101111111111011111010111101111011111111111101111010111100111101122201212110001221122211111111111111111111
