131 112
126 19
22 23
138 34
46 38
18 4
125 115
31 103
80 5
1 47

10120222210b0111b21120122201000210111111001111111111101111011111112011112122121002220010210000121111111111111111100101111001110111111111111111111111100111110111
11121212212b2122b10021222212021120111111011011111110111111101111121121212221101121212022111112221101111110111111001110011011111111011111011111111101101111111101
11122212221a1202a21112011021202210111111011111111111111001111011110022002211022110111001211201211011111111101111110110011111111111111111101101111110011111110111
01121212122a1011a12011110222111211111011111101111101111111111111022021210011110120122122201211111111110011111111011011111111101110101111100111110111111111111111
11121121111a2211b10221211020221122111111111111110101110011111110111122221220121201020212211221201101111110111101100111011111111111101111111110111111110111111111
00121112021b2110b21212202111112112101110110101011111110111011111122221111020121011221220111212210101101111111111011110111110101111111111111111111111111111111110
11121210121b2011b12210221112201222110101111111111110000110011101122222222222222111211110010121221101111100111101100111011111111111011101101101111100110101111101
11122200001a1221a22211202012121221101101111011110001111111111110111102021222021212210210221120221011011011110111010111111111100011011111111111111111111111111011
01120211212a1221b22222222022222021002211110101011111111111101111100120001222210212111201220211001011110100011101000100011101101111111111111101101110101111111111
11120220122a0212a02010221012000222202000111100110100111101111111121012211212111121101021210121101111111100101111011111111101111101101111110111111111111111011111
10012222202b1222b21222222222212021010001111111010101011011110111022121102102102122211221220102101100110110111110001011111111111111111101011111111110011101111111
00010112122b0222b21220020222022022020010011111111111110111111111122211201112121012222221221111021111111011111100011100111001111110011111110111111111101110111111
11022122220b1211a22221210201201021112210110110100111011101111101120222221111011211122211220202111101111111011111100111111111110111101111101111001111101101000111
11020022122b2012a00112222012011021111111001110101100011111111111021202020102012211212111121221211110111111111110110111011111101001111011111111110111011111111111
11122102111b0202a20222221222222222121211110111110111111011011111101221122211011210001111221222011011101111000111111101111011111001111011111011111101111110111111
10112111210b0211b22021222200220202222111110110101101110010101111102112212211122201022221102100110010011111101111111011011111011111011111111011110011011111111011
11101212222b2201a12102222122012001122101111110111111111101111010101111212120211122120211102211211111110111110111101110101101101100010011111111110111111110111011
00011102212b2020b22222222102002121021111011110111111111111111111101111111122222111112120022201120111101111111001111110111111111011111100111111111011111111011101
01111012112b2120b22222220220222112220011111101111011111111111110121121121111122012121121022111121111110111001111010111111111111111111101111111111111101111110101
11122110120b2112b12122222221102122122211011011111111011111011111aaabbbbaababbabaaaaaaaababaaabaaaaaaaaaaaaaaaaaaaaaaaaaaaaPPPPPaababbabbbbbababbbabbaababaaaaaaa
01112122222b0201b11222202002211212122100101111111111001011011111a11112121221220201122011011201211111110111101111111111110P11112112120210022122222222120112101111
11111110222b2210b10201221202121002000211111111111010111110111111a02201121202102111220011101121101111111111011111101111001P10202020212112221201222110121102110111
11122221222b0121a12221221212220221021201101111111111001111001011a21122020210102021210220100221201111111001111111111111011P01201121121211002221212021112200110011
11112122202b2221b22202220222022222122122121220221120211121212111a122011102222121001011102221202211111111111111111111101101P2011120111122010122122221121120111011
11111122220b1202b22122221212222202222212112110000221012201012011a222221210111222012112001212212211111111111001111011001101P1011102211122221212112011121011111011
11011100222b0211b22221222212222022220012220112112221212121121211a211212212011111221112222222110211001111111111111100111100P1012022222112011111112112220202111011
11100122202a2212b22220121122221202212222122212121120211121102011a21001012111122221202211211122201111011011101111110101110P12120211212211212112212222200112111111
11001221222b2221b12112212212012222221220112101211221021221221111a00220121012122112222112111101111111111111111101111111111P01222212010022201011110122022212101110
11121220221b2222b22022221120221220202222122021112110220212222111a211220112211211012210111221111101100111111111110111011111P2120021111011220002202211211201111111
11121211221a2212b02211202022222202220211112212012221211012012011a210000221022211120122012022022011111101010011110110101111P2212212111012222011001010101122111100
10102202202b0110b20222122122212220222222011201022212201111112211a201121201120112111202212220102201111111101111101011110111P0201102011002100111212200111102111101
11010111111b1110a11221221110000112212022120122211120101121210211a011111101111111111111011111111110111011110010111011111011P0102110212221221111102120102012101111
22201022022b2221a20222012212220221022021102221110220102012011101a111010111101011111010101111110011010111011111111011111111P0200120012212210021212211222112111111
22121121102b2112b22222202121221122000111222201222221011102121111a111111101111111110101110111111011111111110111001101111001P2122220112110111012222111011202111110
11012122212b1220b00210202222222220222101021221112221221212210211a111011111110110001111101011110111101100011110111110110111P1222102221200112112111222201122011011
12122111122b2121a22110220222222222120021111212112002110021102111a010111111111110011101011111111110010101111110101111111111P0122211012001221120100111221102101111
10010022222b2220a02122202102202222122111211022111211110122222011a110111010111011111111110111111111111010011110111111110011P1212210211201012222000112201120011011
01022200021b2022a00121100122221222220201222011210221102121222111a111100111110110011111111011111111110111111111111011111110P2221112112200211012112022222010111101
11212012200a2220b12002022102212220222220211222210220111022021211a11111111111111101111101110111111111101101111111111111111P12210101102211010212212201210101111111
21211221100a1211b22021221212120211010120212011021121112222212111a11011101111111101111101111011111111110100111111100101110P11020102211011210210221022112221101101
22111210112b1112b02122212120111201001112212112222112011220202010a01111010111111111111101110011100111111111011111111111101P10022110110101210221211111201221111011
20011011220a2012b22211212011022111011102212022121212220222121101a11011011111111111111111110111011111100110111111011111011P12201121002101111221112021212121111101
21121021010b0122a12112021222111211021020102111110212122122012010a11011101101111101111111011111111101101101111110101111101P10201121102122121211211221212012011110
11011012011b2102b11221122211111211122101222022111122201121102211a11111111110110100011010011111111010101111111111111101010P12122022102211202111210100022212111011
02222110020b1020a21110221220221122202012112110211221112122122211a11111111111100101111111010101101110110100101110001010111P11101220112201211221021112122121001100
22112210100a1122a10102210221221112112122111010212012121122012100a11011111101101111110011101101111111111011111011111101011P01212222120111121222221221212112111111
20122111210a2122b11202110021111220022221001012120121212001022110a11111110111110101111111011111111111101111110111111100110P02211012022222211221000111101212110111
22120212220b1201b11020111221211201122212111011121022122222101211a11111111100111110111111111110011111111110100011101001010P11210022210021002221111101121202111111
21201210111b0102b11122201021122212121200112202111201222012221211a01111110111111110111110101111011111111110111101101111111P11212121210212021000201010211220111101
22201111122a0121a01021222101101202120111122121020021221211222211a10111011111111111111011111101111111111101111111111011011P12001201112221211222022122112201111011
00102211221a2102a11211100212212221122111100212201022122022211111a01101111101111010111111111111101101111000111111111101111P11111100111111110100110110111110001111
11222111002b0211a11211020022212121001202111011212202101101211211a11111111101011111100011101110101101100111111000101011111P10111101110011111111111111110111101111
21122211122a2222a01101112022201222221210212101001011122010112210a01101111010101111111001111111111111111111011111111111111P00110011011010111111000111111111110111
21012022221a2121b22222212122220222012112010222011100122001111211a101111111011011111111111111111111111101111010111011111aPaaaaaaaaaaaaaaaaaaaaaaaaaaaaaaaaaaaaaaa
21101122012a1111a11012212122222111101101111111111111111101101101a111111111011111111110110111111111111111011011111011111P1100111011011111010111011010011110101101
21112110221a2120b22102001001221110111000111011111111011000011011a010101111011101101110100110111111111111101010111101110P0111111111111111111111111111111110111111
11121010000b2020b21120221111022111011111010111010111110111100111a101111101111110101111011111111110101111111111101111100P1110111111111010111111101110111111111111
12222222102b2211a10222012202122111111011111110111111111111111111a001011010101010001110111001111111111101111011111101111P1111011111111101101111101010100111111111
12221222112b2222b21021201222122101011111101011101010110111110111a111101111111011111011111111111111111011111001001111110P1101111111111101111110101011011010011111
20221121122a2111a01112211121222111011111011111111111101111101001a111110110111111111111111100101111011111111111111111011P1111011111101111110111111111101111111101
21111221111a1122a21222211111122011111101111101110111111110111111a101111111111011111111111111111111111001111111101111011P1111110110111111111101111110101110111011
12011122021b2221b20221121122001111110011101011101110111101111111a111101011101111111110111110111111111011111111111111111P1111111101110111111111111111111111110011
01020000210a2202a21001121112201110011111110111101111001101111110a110101011100110111011111111011101111101111111111100111P1110110110111111111010011111100111111101
11111111001a0111a11111111011111101011111011101101111111010111101a111101011011101101111001111111111111111011011111101111P1111111111111111111101111010101111011111
11010111111a1011a11111011111111011111111011111111111011111110101a101111111101111111111111110100111111110110111011010010P1111111110101110111001001111111111101111
11101111101a1111a11110011010111010010110011001111011111111110111a111011110111101110011011110011111111111110001011011111P0101111110111011110111101000110101110111
10101111111a1111a11101111111110111111110111101111101110111111100a110111111111111111011111110011111111111111110111111001P1011011111111101110111111111111101101111
11110111111a1101a10101110011111111111111111110111111110101111101a111011110111100011111111110010101111111111111100111111P1011101111110111111111100111111011111111
11111111011a1111a10011111111111111111111111111111110111011101001a111110011100111111101101111111101001111110111110100010P1111111111111111101110111111110111011101
11111111111a1111a11101011111111111111011111111011111101111111111a111111011110100011001011111111111111111110011111111110P1101000111011111111111111011011111111111
11111111011a1111a10111110111110110111101111010101101111000011101a100101011010111111101110111100011110111101111011101111P1111111111101110110111111110111101010111
11111111110a1111a11110101110011110011111111111011111111111011010a111111111101111001100111111111111111011101011111111011P1111001111011101101111111111001111100011
11111101101a1101a11111111111111110100111111010111111111100101101a111110111011111111111110011011011111111111101011111111P0110111100111111111101101111011101111111
01111111111a1011a10111111110111111010111111111011111111001110110a101001101010100111111011111101111111011111111110101011aPPPPPPPPPPPPPPPPPPPa11111111111111111110
01110111111a1111a01101111111110111111101101001111011110011011001a11111101110110111011101111101101111111111111011101101011110111111111110011P11100111111111010110
11011111000a1111a11111111111011111111011111111111011101000111111a11111110101101111010111111111111011111001111111111011111111110011111110100P01111111111111111111
11111110110a1100a10101111101111111111001101111111110111111101111a10111111110110111111111110111111100111111111011110111111100101011011111101P11110011110111011111
11110111010a1101a11101111111111101111011111111110110110101100011a11111101111111111111110101101111111110111110111101110110111111011111110111P01111101101111111111
01111101111a1110a11111111101011111111101101101101011111111001101a01011111111110111001111111011101111111110111111111111111111111111110111111P11111101001111110111
11111111111a0111a11111111010111101111001111111111111111111110111a10111110011111101111110111111111111101010111011111111101111001111111110111P10101111100101111111
11111111111a1111a11100111011100001101111101101111011111111011111a11110111011111111110111110011111111111111111111111011110111011111101111011P11100111111001001111
11111111011a1111a11111000100100010110111011010111111111111111111a11111111011111111111111111110111111111111101110110101100011111011111001111P11111110111111111011
11110111111a0001a01011100101011111111110111111111101111110111111a11011101111100101111001011110011010111111011011101111001100111111011111010P11111001111111111110
11111110111a0101a11111111110111101111101110011100111111001111011a11111111011110010011100011110111101011110111110111110111110111111111110111P11111111100110110101
11111111111a1101a10101110111101011111111111111111101011111111111a11110101111111100010111111110011101111111011111111111110111000111011011111P11111110010111110111
11111011111a1101a10111010101010111111111010111111111100110111110a11101111111011100111111111111110111011011111111110111111010111110100111101P10100011111111111111
11101111111a1111a01101110101111111011111111101111101101110111101a00010111110111011110111111111101111111011011111111111010111101011101111111P10111110100110111011
11111111101a1111a11011111100110111111111111111111011110111111101a01111110111011011100111000011111111011111111010101101111100010111111111101P11110111111111011010
11011111111a1111a12012211001222122211021212212210110111110111011a01111011001011111111110111111110111111111110111111011111111101010111101011P10111111111111111111
01111101111a1111b20202212121221021212201102212111110111111111111a01111111101111110110111111011111111111111111111011101111111001011011011111P10101111011011111111
11111111001a1111b21211121111212021022122212111101110111111100011a11101111110111110111011101011111111111100111111110111111101001110111111111P10111101011100111111
11111111101a1111a22001121220101111122221212111210111011101110101a11111111111110111000110010111110111111101011111111111111111001101101111101P11111111110111110111
11111111111a1111b11001101121221222121212120121211101001111001101a00111111111111110011111111111101101111110111111011110110110111111111111111P10111111101101111111
10101111011a0111a12110211111010101011221111110101111011111110101a10010111111111111011011111111111110101110101101111111110111011111010101110aPaaaaaaaaaaaaaaaaaaa
01101110111a1011a12101101121210021011210121210101110101111111111a001101111010111011111011111011111111110111111111110011111101111000111101111P0101101111101011010
11110100110a1110a20222211220120110210012102221211101111110011011a101011101011011110111111111111101110111011111111011011111111101111001111110P1011110111111111001
11101110110a1011a02111122211120202111101212111211111111100111111a11111111111111111101101101111111011111111111011101010011111111111011111110P00010101111000110101
11011111111a1111a00111212110202110222221102011010111110111111011a0111001110111101111111111111111101111111110110111111111110111110011101111P111111111111111110101
11111101111a1010b21111121221111022122222221012100011111111111011a0111111110101111111111111111111011011011111111101111111101111111111000110P111111001111111101111
11110110111a0111b11121112022220012211102112011101101111111111011a111110111011011111100111111111011101111110011010110011111111101011111110P0111010011111111111111
10111101111a1111b10212112110122112221012211222111111111111011111a111001110011111111111111110111011110111101101211111211211021111211202202P2211111011111110100110
11111111101a1111a00112211021021102202112111101111011110111101110a110110111011111010110011001111000111011111011211211210122202111101212202P1111111011111010111011
11110011111a1111b02202222120120211122211211220110111110011011010a11111001111111111011101111111011110111111111112221221211022221111120121P20100111111111111110111
01111110011a0111a02221211221002101012122011110110111111110110111a01111011111111011101001011111111111111111111120201011222022121120210222P21021111010010101110111
01110111111a1101a10022210220111120110022111212011100111111111111a1111111110111111111111011110111011111111101011112110122212110212121120P222021111111101111111111
11111111111a1011b02012222211200222111121220111111111011101111111a111011111111111111101111010110011111111111011120112211022102112122222P0101100101111011110111011
01111111110a1110b10212112122122122102102112121111111111110011110a111111111111111111111111111111111111110111110211202021102022010011202P2212211111111101110111111
11111011111a1011b11002102022120010112200201110211111010001111011a110001011011111011011101111111100111111111111112110221221212112001122P2121211101110111111101111
10101111010a1111b11112221111002222212112222011111111101111011011a111101111111111111111111111101011111111111111201101211201202120120210P2121211101101111101011100
10111101111a0111a11120011211111010122220200011201111001001111111a10001111011101101111111101101111111111101111110122222120112212122102P21002111111111111111111111
10111111101a1111b01102211122220012201112021201111111011100101101a1010101011110110111111111110111111111100101110222222121211222212222P101221011111100001001100101
11111110111a1111a12102112121211211011210211222011111001100010111a011101111111111100101101101011110111101111111112121110002112011212P0222121111011111110101111111
11011111111a1011a11221110212100010101202121100101111101110111010a111110101101111111011001111011111111111111111111000121102102220102P0100120201111111011010111111
01111111111a1111a02002200211112200121221211221101111111111011110a11111110010111011101111111101111111011110111110121121112202211021201120222210111111111011111111
10111011111a1111a22202212112111211120110010121111010111001111110a11111111111111011111011110110111111110111111121222211221210210122022011201111110111011011111111
01100111001a1011b20022211110222021212020221112111111111111111110a11011110111101111111111100110111111111110111102121010121220220210120122221211011111101111111011
01110100111a1111a10022101122202122111021221212211110100101111111a11111111110101011111011100110101101011011101120012202122012121221110102221221111111111110011111
00110101101a1110b02011001101221112112002010220001110101101110111a11110111111110111111101100111111110101111111112112201100111200212021222110110111110101001111111
00111111110a1111b20201001211021021021222101111111111111011111111a11011111011111111111111111111111111001111111110111111101201112112121021110101111110011110110011
01111111111a1101a11111011111111011001101111110111111110101111110a00110110111011010111111101111111110110101111112021122211001212122011222100121011111111001011111
