143 49
8 116
22 23
138 34
46 38
18 4
125 115
31 103
80 5
1 47

1112101121022222201120011112111210011111a01111101111011101111111111222112122220211122211102221200101111111111110110111111011101111111111110111011111111111111111
0110221222212112210002010101212121111101a10001111110101111111111012202121201102212211010222210201111111111111011110111010111011111111010101111111101011110101111
1112122211221112222202110211221210111011aaaaaaaaaaaaaaaaaaaaa111122122120101221122122201221012110101111011111100101001011110100111111111101111111111011110111111
111221020211222211212022021222101111111011010010111011111111a101002121212221112111111101122122121111011111111111111111111111110111011111011111011010101101111111
001101011212221012211021212012111010111111110101110111111001a111122121101112222111221211121221001101111111101001100101110011111111011111111110101111111111111011
111212211202012211120121112110102111110110101101111111011001a111121120111112121111221121100202011011111011100100110111111110011111101111111110101111111111111111
100211212112101121120220101122122101111001111011111111010111a111101222101202201222211112021121100111111111111001101101110101110111111111111110111110101011111111
101020111121202222212212112210122211111111111111111101111011a011001121212010112012122222122120211111111110000111101110111111111011110011111101111111101111111111
111102112202122022222220022202022222210011011111111111010101a110102102022121012112111201120121221101011111110111011101100111110101100011101110111111111111111111
110121002012222201122222122222022220011101110111011111111111a111100210121022101222211112200212221111011011111111011111111111111111111101101110010111110111101111
111111222220222122222222102212221112011111111101111111110111a101112122122112112001121221110221110101110011111101011111111111110101111111011111001110111011111111
011222022220012220222022202222220110121110011111100110111101a110102201212222202112021212112222021101100011111111111110011111111110101111111101111111111111101111
011222222222202212202212222022222222021111111111110011001111a011102222201110212111002012210212201111101111011011011111110111111101110111110101101111100111111101
110122120221222012220122220022012210221111111001110111011111a111012011221211021101212121001110111011111101111111100111111111111110111100111111111111110011111111
110002111212212102121121211110022122220111110100011010110011a111101111122112210111110111122011201110101111010111101111111111110010110101101110111011101111110111
111112022110022202020220210201022022120111111111000110111110a101111102221221102111220111101110010111011111111111111111101111100110110111010101110101111111111111
111211112021022122020022022122222121110111101011111111011111a111102100112121121212211102012121210011111111011101111111110111111101111110011111001111110011111111
100211101202220011222021022022022222221110100011111111111111a111010211001220222212002100222211121101111111101111111111111111111101111111111111111110111101111111
111121111222222212010222221212222122111110111111101111110001a111120112222202222212111121222121110101011110011111111111010111111111010111111101111111111111111101
111121202121220121201222221120222112021100001011111110111110a111011101211201110201220121222100101101110110111101110001100112000112110221211221201112112210100111
100112120012022022202010102212110202211111001111111111110111a100001111112201111101201211221022120111111101110100111110110102221112200121211112010000122221111101
111101120212220121211222222222222111211100111111111111111111a111100110122021222110002022001110120111110110111111111111111111102222110120222012221222212202110110
aaabababbaabbbabababbbabbbbbbbaabaababaaaaaaaaaaaaaaaaaaaaaaa101111111122121112212212100111220111111111110110110101101111111021211120122010010012200122202010111
1111221121221222001100202221111222101221211201212100001122122201111011210212211221211112121112111100110111101111110111001011221011112220122120210022121212001111
0112221200221221120221202202212222222202202211022220201112121001022200221212111010222122011112221111101111110011110111100111221211010211121220111202102012011111
0100211112210102222221222102202222222220101211021211102111111111120022201211120221111222212120121111111100111010101111111012211022011121111110101212102212011111
1002010220220120202212002222122212222012101220221111101220202111120011002112222011211121110122210111000011111110011111111111022121212220022121011222111202111111
1101112020001212220222112211221122120222222202222112010121212211122112010102221222200221211200120011111111111110111000111101012202011111202012212121221011010110
1002211222102102211210222002221220212222122210112220122112012011011202212021110202121210011111200011111011111111111111111002021121111211220100011111221011111111
1111221201202022222012102002102222122022120112112122210012210011112121210210201210201222112102011011111111011111111111111100020202212112112221211111122101011110
1100102022011222222222222210102220001210201122121111121122212111122221200121101101212110111212001111100001011111011111111101010222121011112101101122021101111111
0100111110101102122020221212000122122201212121001101221220210211110111001110011111011111111101111011111111011111111011111012021111111122221220222012222012111111
2201222121222202002202120022202220120022111222222022012220102111101110011111111101101101001111001111111111101010111100111111101012211212120022002120020012101111
0210011222222221222222222222201211222011110112111112122111222011111101111111011111101111011101111111111110111111110110111102112120212121102110211121111211011111
aaaaababaabbabbbabbbbbbbbbbbabbbbbbbbbaaaaaaaaaabbabaabbabbaabaaaaaaaaaaaaaaaaaaaaaaaaaaaaaaaaaaaaaaaaaaaaaaaaaaaaaaaaaaaaaaaabaaaaaaabbbabbbbbabbabbbbbabaaaaaa
1102111222222220200220102222222222222202122221211222122002111110011101100101111111111111011001011011111111111110110110011111112121022112122111220222121012101111
1021120212212012111112212012222022122211221201110212200001211111111101111100111001100011101111111111111111101110111111101101211212222211202212002222002020111111
1111010210221222102022222122222102022210222111221102211101210111010111110111111111111110111101111110111111010111101111011111121221201202121221211220211122101111
1121201021201202222202122022012202102122202211122122122122122111111101111110111010101111111111111111111100101100111011111112111101111210021110112111201121111110
1222212102102201021212202220121220222211221121102121221202212011111111010110101110110111111111111111110111111110111111111110222012111121102220120222111122011101
1211101210212022221110221012110011121022001212121102122201102201111010101011111110011011110101110111101110101111111110111112121020201120002111022222222122011111
0210111122112222220221111110221210221210110220102022112121021111111111111101110111011010100111011101011111111110101110111011222121111122210222001022111120101110
212202122212211221121220211020221202221102111021011222122012101111111011110110001011111110110011001aaaaaaaaaaaaaaaaaaaaaaaabbbbabbbbbaaaaababaaaabaabbbaaaaaaaaa
120222002202201221201110002101110222011112122122121221200121211100111111110110101011011111100100111a111111010111001111101111011112112122100111012210111021001111
121011121211211000122002211011222202111101121222222021122021020101111111100111110110110111111101111a110111111111111111101011100120221222112121211111010021011111
011122220110120210222121011002212111000220111201211211122110201111101110111111111111111101111111111a111011101111011001011110121022121222211011100201002112111110
221220021201000110121211110122012220122120220120212011122112011011111011111111111011111111110111110a010111011111110111110111101001010201221111111121010020111111
221102111221011211212011211020112212212111221212101112110220101111011111101111111011011111111111001a110111101011101111111112201111200020201120211102122012110011
221212111202112222211121012220021021112022221011121212222222121100101011011011111011101001111111111a100111111011111011111112111102111112211202111212120002111111
201122212212211212112122211102012221210121112200200121221210021111000111110111110011101111111110110a110011110000111111110012001120210221211021121112222111010111
102220012221102122222201222102110120221201000222220210021002011111001111110101111111011111111101011a101111011111010111111100111111111101110111111011111111111111
222021211212110212211112022211111022121212221220101212012212021111111111111111111111110111111111101a111101010111111101101011110110011011101110111110110111111111
112111110022021122212112202112121212121212021221220120011122121011111111111111011101011110111111101a111111111111111111001111100111111111110111101111111111111111
222221201112101111210222220221111102011110101120022211011111010111111110111011111011111111110111111a111101111111111001111101100000110011101111111101111111011010
222102101221222121112212212222001111101011011111111101111111111111111011100111111001111111011111111a111011111111111111111101100011101111011111111111111111101011
220211210211122201201001222211111011111110111111111101110111011111101110101111111111011111110111101a111101100011111111101111101001110110011111001111110101101100
212200112102211222011211122211211011111011110101110111110101101110111011101111110111010111111101110a011111110110011110111111111101111111101011100111111111111111
221221220221011221212022221202111111101111111111111111100111100001010111111111101101101111111111111a101111110111111011111111111111001111101111111001111111101011
210110121012221210212211211200211111111011111110101111111101010011111111111111110111111011101011111a000101010111110111111111111101100110111110011110101111011111
112211020112010211020220121212110101111111011111111111110111111111111010011111011101111111110111111a111111111111111101111110111111111111011111111101111111101111
200120221221100121212211212112201111111111101011111111111111010111111110111010101111101111111111111a101100100111111010110100111111110110111101101101111111010110
022121100022202222012001201201111111111101111111011111111111111110111110101111110111111111101111111a111110111001111110111101011111111110001110101111111111111101
102212201121121211211122121101011111111111111010111110001111100111111010110001110011011101101110110a111101100110111101111110111011111111111111101110101001111111
111110011101111000111111011100110111100111111111111111111101011101111101111011111111011101111111111a001001111011111011111111111111011111100111011001110111111110
110101111111100111100101111111111101111111101111011111111011011111111110111010011010010111011111100a111111111101101010101111110101111111110111100111111110111110
111011110111111111111100101111111111011101111101111101101111110111111110111011101110111010110100111a111111011111111111111111111111111110011111101110101101111111
111011111111111110011111111111010111110010111111111100101111111110110111111111111111111011101001010a111111111111111111101110111011101011101110011111100111101110
011110111110011111110111111100010111011111101111111011111110001111111111111101111001011111010111111a011111111111111011111111111010111111111111111111111011111101
111111110111111011111011111110101111111011000011110011101101101101100111111111111111111111111111101a101011111111111100111011110101111101101111111111111011101111
111111111100011111111100111011110111111110111111111111111111101001111111010111111101110101011111111a101001111011101111111100001111111101111110111110110111111011
111111111011110011111010110111101110001111111111111011011111011111111101101110110111011111111111111a011011100111010111101011111111111110111111111110010111111101
101111111111101111111011110001111111101111011011111100110110111111111111011100011010101110111011011a111100111111111110101111100111111111011011111110101110101010
111010011111110101100111101011111111011110111111111111111111111110111110110101111111101111111111011a101011111111111111110010111111111111111111111111000111011110
011101110111110101011111111011111101010110111011011111110110101011111111111100101111111111101111110a111110111111101101101111011111111101101111101111111111101111
111111011111101111101011011111110111101111110111011110011111111111101000010111110111111110010111101a111101011111100011111110111111010111110001111111111011101111
011101101111000011111101111111111111111101011110111000110101111111101111111101111111111001011011101a111111110111111110111111111111101111111101111101111111011010
011111111111010010111111101111111111111011111111111110111111111011111010111111111011011111100110101a111111111110111111110011111111101011111111111111111101011110
111111110101111111011111110110111111011111111111110111111111111111111111011101000111111111111101101a100011111111111111011111111111101101011111110111011101101111
111011010101111111011011110111111111011111111111111111111110101110111101111111001110011111101111111a110110011101111111111111111101111110111111111111111111111101
100011111111aaaaaaaaaaaaaaaaaaaaaaaaaaaaaaaaaaaaaaaaaaaaaaaaaaaaaaaaaaaaaaaaaaaaaaaaaaaaaaaaa110101a110101111111111011111111111101111010111111100111111011111101
111111111111a1111111111110111111111111111101111111011010111111110001111101110111111111101001a111001a000111001111011111111111111111011111101111101011101110011111
111011111010a1011100110111110101010101011100111111110111111001111111101111110111110110111110a110011a111110101010111110100111101001111111111011110111001011001110
111111111001a0111110111111111001101110111110101111111110111011111111111110101110111011001110a011111aaaaaaaaaaaaaaaaaaaaaaaaaaaaaaaaaaaaaaaaaaaaaaaaaaaaaaaaaaaaa
111011011111a1011101011111101111101111101111111011110101111101111011101101001111111111011110a1111010110111111110111111111111111111111011110110111101111101011100
111111111100a1111111111111100111110111110110111001111101110010111111110111111111011111101011a1101011111110100101111111010111110110011011111111011111111011011101
111011110110a1101111011111111111101011011110111100111111111111111111111111101111111011111111a1101111101011111111011111011011011110111111111111111001111111110110
101111111111a1111111110111111110001111101111111011111111111110110111111011011111110111111011a1111110111111010111111111111111101011101110110101111111111111111111
110110110111a1110111111111001011100111111111111101111111101111101110111101011110111111111111a1101011111001001111110110111111111111111111111111111111111011111111
111111111111a1110120210211011222102220210120210101100111111111111111111111110111101011111111a1111011101110111011011101111111111111101111101110111111001111111011
010111111110a1111111011112111212202202200122101110110101111011111010001111101011110001111101a1111111110111001111111101111101111011010111111111010110110110111011
011111110011a1111210120011122112220022220201212111111111111111101110111101111110110111110111a0111110111110111101111110101110111110111110001111111111111101111101
110111101111a1112111002212212210211112210111010111001110011101011101001110111110111111111001a1111110110011111111111111111110101110111011111110111001111111001110
110111111101a1112212111010212211221211221210001110111111111111011011111111000111111111110110a1111011110111111110001110111011111111100111101111110101111101111011
101011111110a0111022101222221221122222220211102101010100111101101111111101011100111111100101a1011001111101111111111111001111111111111111111011111111011101011101
011111101111a0111212211221222101222221012220211111111101111111011111101111111111100111101110a1011111111011101111111101111101011110111111111110001011111011101011
011111110101a1100121121220222021111112111120110111111011111001101101010110111101110101101111a1010101110010101111011111111011100111011011110111111111111111011101
001110111111a1110221212012011112121110112221112111111111111010111111111001110011111100111101a1101111111111111101111111010111111110101111111100111111110101101010
111101111111a1110211221021212202100111222002221000001111110111111111111011111111110001011101a1101111111111101111110101111111111111101111111100111111111111111111
111111111011a1112220011211121121021211012212122110111111101111111111010111111100101111110111a1001110001100110111111111011000011111110101110101011111110111111101
101111011101aaaababbbbaaaabaabbab12021200211221111001111111011110111111110011110110111111110aaaaaaaaaaaaaaaaaaaaa11111101111111111110111111111111011101110110011
01110111110111112022101112120111a2222221111222011111111110111111011010111111011101110101111111011111110110011112a10112121101211111021010110210111101111111110111
11110111111100010111111122102112b2211201112022111100010011111011110110101111111000111110111010111111111111111101a11222211212011101122221211011100111011111111101
11111110111011002121200101110101b2101221112212111111111111011001010111111011111111111111111101101101110101111101a11021122012021122212022202121101010111111001111
11111111011111100221202212100112b2112222211112211111111001101111111111111111111101100111100111110111111111111111a11122212220121221211212012211111111111111111011
11111110111011110012112000212111b1112211211211111011101110111110111111111100111111111101111110111111011010101101b11010212011111211122012111210101111111111101111
11111111101010111022011211011221b2111222211220010111111011011111110111111101111011100111111011111111111110111110b12110211022221211112122221201011110111100010111
11111011111101012112112221220021b2102202211122111111011110111101011101111110011101111011101111101110111101101112a11112202112222022022211222011111101011111111110
11111111111101112122121200221221a2221102110221011111111111101011111110110111111111111011001111110110011111111010b02222000122012221102012121021110101111111111111
11101110111001112120111101112212a2110110202211011111111111111101111110111111011011111010111101111111011111111111a22122020121021001221102221221111111010111111110
10111111111111112220021121111011a1121122101222011111111110111010101110001110111110101011111111101111111000111022a21121100220121120221120001121110100111111111101
11111111111011112120222122121020a1002221222122101111110111111110101111111101101101111111110011111111110111110022a10221200222222122111202112221011110001111110111
11111110111101112221100102212111a1121120202212010110111111001111101111111101111101111011111111111111111100111112b11122202101120212210021020101011101111111111111
11110111011111111221112111111221a1201120112211111110111111110110011111101111110111101111111110111110111011111000a10212221222122221221021222210111111111011100101
01011111111011112200221210200101b2201221200012210111111011111101111111100101111101110111111011111100111111011122b12210210201202011222120211111111100111110101110
11111111111111112100212102101202a2111222212222101101111000111110111111111111111111111001111111111101110111111110a11211111012222011102001202101010110000110111111
10111111011111102121121221201111b1012212001211211111011111111111111100011111110111101101011111111100100111111120a00012222201122201212111101121011100111110111011
11110101111111111122211200100201a1112110221021010111111111111101111011011111111111111111110111111111111111110021a12102112211112001012012121021111111111010111011
11110011111111111110210011212111a0220212212111211111111111111110111101011110111111100100011111101111011111111001a22010220010010120021112010210111111110101111111
01110111111111111122012220021221a2212022020211101110111111111111111111110111111111111111110011110111001001111112a02222202210111201221111102201111110111111111011
11111111111101011111011110111110a1111011111111101001111111101011110000111111010110111111110111111111111111110112a21012002101112122011112112201111111110111111011
