9 3
85 113
22 23
138 34
46 38
18 4
125 115
31 103
80 5
1 47

01111121121112b221120111220111112201111111111111001111a111111110002120102102201200110111212122211101011111111111110011101111010011101111a11011001111111010111111
01102101012PPPb112112222121220011211111110110011111010a111011111102201201221021022110112220111211011111110111010011110110000111110111111a00110011111111111111101
1010111121P010P011002022111002011210110111111101011111a111111111021222212122011112222022210220121110111111111011111011001111011011111111a11110110011110111111011
111221211P1020P122000112110021201011111111111111111101a011111101112220221122121022112200002201021110111110111111111111111111111011101111a11111110110111010111111
11022212202010P112011201222001220110111111101111111111a111101011102111120020002112120212211220110111101011101101011111111001101101111111a11111111111111111110111
01111212102102P111112100112022211211110111011111111111a110111111102212212220112121121122020122021101101111110011111111010111110101111111a00111111110111111111111
11021222011101P011222220212020011101111111111111101111a111011011112211101112021021201202221222121111110110011111100111111111111111111111a11111111101101111111111
01102011121111P221110212211011211111101111111110011010a101010111112210111210212110112220211101121111111100111111111111101111100111111111a11111110110110011101011
11122200202222P122211220222202222222120111111111100111a111110011111111222221222221212122121011101110011110110111110111111111011110110111a10100111101111110111011
11101120021222P022211202222122012211121110111111110110a111101111022222101212212112011221210101121010101110011101110111110010111111111100a11011111111110111100111
10012120001122P222222222210222112010000011111001111111a111111001012221120221012211112211222221201101110100111110111011111111111111010111a11011101111111010101111
11021220202211P210022012202001222001001111111100011001a111111111122120112121121122111210022100110111011011111011011010001111110011111110a11111101111111111111111
11011222122122P222221021222212121220101111111111011011a011111111122121212122201012222120000112200111110110111111011111011111000101111101a11011011001111111111011
11121112021020P221220210020200222022221111110101111111a010111111120110102020121121110222121221011011101111111011111110111111111111111111a01111111001101111111011
10111022122222P222020221120210122120001111111111101111a110111111010020002122121111221112111010211011111011100111111111011010111111111111a11111101111011111110101
11122222122220P202222222222212010110011111011111111101a101011111112101112221001100221111222201111110011100111111110111111111111111111111a11111110111111101101111
11121212212221P222202212202122122122021111111111111111a111101101122112012222111112211122111201220111111111111110101110110111101111111111a11110111111111111111001
11110202221210P000212221212222200011011001111111111111a110011110111112120211122112212222210122121111111101011101111111101011111111101111a01110011001111111111010
11122122022001P220222122212022222002221111111011111111a101010001000022001202121211112101211122200000101001110111111111111111111101101011a11111011011111101111011
11122102222212P221212101102102222112201101111111110110a111111111102220201112202120122122120110021111111110111111111001111010111211111222b21222112202121100111011
11111222222201P220202211210202222002221100111111011111a111111101020202021102221222001211210212010101111111111110101011111112100112021101a12201201001011212111111
11101222110102P210202222222022122220000101111110111011a101000010122211101211212211220202101112121111001111111101111111111112101101112011b01212221021110222111111
11101022222022P222022121222022212221111110111101101111a110111111122212211101111122122222112110111111011111111101111111111112220111211100b00011112122012120111110
01102222222202P212220102212022222202212220211201111112b211122011122120121221222122111101102222201001111111011101000111111112101121201222a21120202022211111111101
11022111202222P222222201222221020200021211011011202100a212221111110201100121011001112221201222121111111110011110010101101111221012221212a21121122012001122111111
11012122102122P222220022012121122022221201200212221022b111201011012222220222022212210102101201001111111011101101111111111112222111102112b11212122102221102111111
11112220002122P010120000222122200222202111002000121210a121210101012222221202112212100111111201211011111111111111011111101112221101122201a11202212110111012011111
11112010111220P222220012222212222122221222202112212000a011012101011110020101101211002021222111021011111101111001111111101101021212202212b01122111222002221111111
00121112202122P222122002022011222222221212101010210121b212200111121211221222221211121110201220101111111011101111111111101110112212211112b12012200111000100110011
11100002022222P020221121202222221021221111201111011012a021202211101222222112120112112012112001021111111111111010111111011112120011222121a12220120000102221110111
11112220220222P220022212212202122220221212021121221220b122022001112212020121221212111112112112211110111011110101011111111111121222202222b22120211102011001111110
11101112022110P212111221122101121102022110001111111121a020101111110011111000111111111000011111100101111111111011111110101111001101212211a11121111102201022111111
12211201212210P122121222022222222001002012020122102111a100221210111111110111111111111010111111111111011111111111010110111111212111021101b21021202121112222111111
22221100001202P202112222100112202220120220211211121121a120210211100111111111111111111111001111110111111110101110111111111111100221000210b22222202010002221101111
12122121222022P122012222220220211221120112110222111200a222201211111111111101111111111011111111111111011101111110111111111112100121202221b20011220111211201111111
21112212002020P202122222022021222222212201201101221010a212110001111110111101111111111011110010011011101011101011111111111011212001112121b02220011121212120111101
21102012222122P122210211222111210212221021212222221221a120011010111111111101001111101111110011011011111111010111100110111010112111012020b10120112112201121111110
21210122212022P220121222210222200221121122220102221111a001222201101010111111101000101110011011111011111110011011111101101102211212211112a22102011112222222111111
01222122121021P221202222021122211122121222201121222221b011211211111111001011101111111111110011101111111111110110011101111111212122021201a21011002111102110010111
12220212202220P112221100110120012211101212121011121122a211221111011111101100111010101111111110011101111111111101101111111110022121112212a12111012101211010111111
22121120121011bPPPPPPPPPPPPPPPPPPPPPPPPPPPPPPPPPPPPPPPa121022211011101011110000111111011101111101111011011101111110110110111112112210111b21002122111001211111110
010201020122121121011211221212122012212201201211012101P212212010100100110111101100101111100111111111101111111111101110111112022022012212b01221112110111212101101
112020012100211210212102112220121111110121111121211221P222021211011111110111011111101101111111011111111010111011111111110112101211211222a22121112201111111101011
2200201002111021110210211221111211122011001111201122021PP2101011111111011010111111111011111111011110110111111011111110111112011222120021a11211021101122121011101
211011121201122211122122111112220122211201112211222102101P211111111110011010010111110111110111111111110101111011111011011102121201011122b11211111110121210110111
1202212001101112122201110200221012121110221200211221000222P00101111110101111111011101111111111111111101111111111111111111001000022122122b12111022100210001111110
2222122202221201221102001200202121010200211100221111212200P02010111111111111010110111110111101111111101101111111111101110102111211222202b22220122221202122111111
12022022212011210122111110122112022112120121202211211200112P1101111111111111111111111111111101111110111011101111110111101111100121121012a12220100022221221111101
02122101010202221112212102121001202122221221021120120222221P2111011110000111111011101001111101101111111110111111111111111111012100221010b02221010111212001111111
22122221021120101222220111210222020102212122110210210201121P0201110100111101111111111101111101111001111011111111011001111011211220212000b02000102222221122111101
101222112101021120022211102200220012212220202101221222201120P210010101100111111101111111111111011110101111111110110111111111101111111111a11101111100111111111001
100212212221101020210121120022221120212221011120022120112010P111011110101111111110111011011111111111101101111111111110111110110100110010a11011011111111101110011
2002221011200001222020201220011122011022222221101112212221211P01011110101101101011111111101111111111111010111101111111111111011101111101a11101101011111101111101
11112101220122112020222212211121211212111101221102110121101122P1111111101111101101111110111101110101001111111111110011111011111100111011a11101111111110101111111
1122112111121110221221100111122111111111101111111011111111111P01101111111111111001010011011111001111111011111111111101101111111100111111a11111110110011111111011
11221202010202112111011121111221100111111101111001111111111110P0111101111111111011111111101111111011111110111111010111111110111100101110a11111111101111101110111
12120212121121000221112221110221001001100111110011101011101111P0001110100111011011100110101110111111110111111111011011011111101111011011a11110110111111111111101
222101112012120201122121111202111000100111111111111111101100111P110011101111110111111011110010111111011101110111110111111111111111110001a11111100111111110111111
1220210211120011220111201101110100111011111011101110101110010100P01011101010111000111111111111111111111110111010101111000101011001101111a11100011111111001011101
122020101121112222102122112020201110111111111111101111011111011aPaaaaaaaaaaaaaaaaaaaaaaaaaaaaaaaaaaaaaaaaaaaaaaaaaaaaaaaaaaa111111111101a01111110111111111111010
121022112121112102011021112020111111111011111111101111110111111P11101111111101111100101110111111101101111100111011000111101a101101111111a11111011101011111010111
110100211112220011120222112022001101111111111111111110111011111P11111011111101011110011100101111111111110101111111011111111a111011111111a00101110011111011101111
222202212122102020202220222120210111101111101111111111111111101P01111111111101101101110111111011011111111111111111111101111a101111011101a11111111110011101111111
101101111111101010111010111011111111111011001011101111110111111P11011111111111111111111111110111111111101111111111011110111a010111101000a01100111111011111111110
111111111110111111010111111111011111111011111111111101101111111P11111111111111111111110111111111011011111111111111011110111a111111111111a01111111101111111110111
101111111111111010111111100110011111011100111111110110010011111P00111011111111111111101111111111111110011111111011110101111a110111111111a01111101010111111111111
aaaaaaaaaaaaaaaaaaaaaaaaaaaaaaaaaaaaaaaaa1111001111100111111111P10011011111100111010011110101110111111011011111111111001111a111011111011a11110111111011111111110
1111111111111101111011110010111101110110a1111110111111001101110P11111111111111111111111101011101111110110111111111111111111a111111101011a01101101101111111011111
1111110011011010111101011011100001101111a0111101111101111110111P11011011011111110111001111111111111111100111111111111111111a011111111101a11110111101110111111101
1111011111111111110111111111111111101100a1111011111111111100111P11111111111111100011110111111111110110111111011101111101101a111110100111a11111011110101101101011
1111111111011111011011111111110111111111a1100110111011100111111P11101111111101010111111111101111101111111101111111101111111a101111111110a11111101110101111111101
1100111111111111111111101110001111111110a1010011111110110100101P11101111111101110101111111111111111101111101111110101111011a111111011101a11111101111111011111111
1100101011111110100011111111001111110111a1111111111101101111111P11101101111111111111001101111010111111111001111111111111111a011101111111a11111111111111111111101
1110101110001111111011111111111101111111a1110111110111111110101P11111111001010001110111101111111111111111101111111011111111a111111010110a00011011111011111111110
0111011100111110111111101001111100110111a1111111111010101110111P00101011111110011000111111011111101111111101111110110001101a111111111111a11111101110111110101111
1010111110111111011100111111011111111110a1111111111011101111111P11011111111110101110101111100101101111111111110010111111111a111111111111a11011111111001111011101
1111111111111111010011011110011111011111a0011111010111110111111P11111111110111110110111011110100111110011111110111110111111a011101110011a11111111111111011111111
1111011101110110011010010011101111111111a0011101111111111111011P11111101101111000111110011111110111011111111100011111101111a101111011110a11111011111100111101111
1111111011101100010111111111111111111111a1111111111110011110111P10010011111111111100111111111111111110110111101111111111111a011111110011a11100111001010111111100
1011111111110111111111111111101000111111a0111011110101111011111P01101111111101111011001111101101101111111110101001001100111a101111111110a11110111011101001111111
0111111111111111011111011111011001110111a1011011001111111101110P11111111111111111011100111111111111111001100111011111111111a110101101111aaaaaaaaaaaaaaaaaaaaaaaa
1111101111011001111111111111011111110101a0111111111111100000111P10111101110111011101111011111111111011111110111111111011101a111111111111111111101111111111110111
1101111011111011010110110110101111101111a1110001011111010111111P11101101110110111111111111110011011110111011001111111111101a111110110111110100101111111111101111
0101111111111011101111001111111101111111a1111111111110111011110P11111101011111111011111111111111111111110111111101011010111a111000011111111111110011111111101110
1111111011101101111111110111111110111111a0111110101111111101011P10111101111111011100111011111111111111111111111111111111101a111101101111111110111011001111111111
1111101111110101010111111110111110011111a1111111101110011011111P11111110111111011111111101011110111110111111111111111111111a101111111111111110111110111110100111
1111111110110111111010111110110011101111a1111111010110001111011P11111110111111110011111111011111100111111110110101111101101a111111100111111111011100001111111111
1101111111111111111111011110111111111011a1101111111111111110101P11011111111111111011111111101111101101111011111000111011111a111110111101011110111110111110111111
1101111111111111101211201021111120212220b0111221101001111110111P01001110111101111111000111111001111111111010001011111111110a011011111111111010111111111110111111
1111110111111101222211121212211112110211b1012111111111111111111P11111111101111110111111011111111111101101111111111101111011a011101001111101111111111111011110111
1111111111111111201210112221111022121201a2111121110001011111111P00110111001111101111111111011100101111110101111101111111011a111111111111111110111101111111111111
1101111111001110101221022112102220222022b2221020111010010111101P11111111111011110111111111111111111011011101001111111011101a010111101001001111111111111011111110
1010111110001111211001012121111102200110b0112220111111111111011P01111111011111010111100111101010011111111111111110111110111a101101110010111111111010101111111111
1111111110111111112012111200211220122202a2021021111111111111101P11010111011111101110111111101111111010011110110111001011111a111011111001111011011101111010111011
1111111111011111122210221100210122212021b1112101111111111111111P11011100000111111101011111000011101111110101111111110111111a111001111111111111011111111011111011
0011011100111110021212110100102111221110a2210221110101111101101P11111111011111011111111101011111110111111110111111111011110a111111111111111011101101101111111110
1011111111110111222010101121111102212111a0212110111001111111111P11111111111111111111111110011010101000111111111101010111100a001110111111110101111111111111111111
1110101111111111221122220011121110101211b2212111011111010111110P11111111001111101111111011101111111111110111101101111101111a111110111111111000110000111111111111
1101111111111111201110101101122221122022a1111211100111011111111P01111101111111001111101111111101110110111111111101111111001a111111111010111101010111011101011011
1101111111101111021012121120100122112222a1121211111101100111111P11111111101111111110011101100111011111111111110101011111111a101111101111111110111111111101111111
1011111111111110012211112222210022221122b1121121110111111101111P11110111101110101111001110010111111101110101112211111112220b111221112122001221110111111111111110
1001011111111111201111122120012020101112a1121111111111110111110P11111111110111111111111101111010110011001111111120121111202a202212021022200021011111010111111111
1111110111101001212002222221110210021212a2112021111101111111111P10111111111110111111111111101111110111111110012011122211221a211111122120222210101011101111111101
1111111100111111211212222011112222212212a0112211110011011111101P11011111101111111111000111111011111001111011111201212220110a122121121112011211111111011011111111
0100100110111111111222222200110200101112a2222211111111011111111P11111110010011001111111011111111111111110111111122202001110a100111101122212210111011111111111000
1111111111111010120111221111222212110222b2210120101111101111110P11111011111111011110101111101111111111000111112211211210221a111121212122222120111110111100111101
aaaaaaaaaaaaaaaabaabaabaabaabbabaaabaabab0121221111110101100111P01111101110110111010111101101011101111011111112222221022111b222122221201011110111100111111101001
111101111110011121201112212212002211202202222011111111111111011P10111111101101111111110111111111111111011110112110002111111a200112222201122211101111011011111111
111110111010110020111222221002202120121112222201111111101111101aPPPPPPPPPPPPPPP11111111101111111111101110111011201222122121a121112122211212201101011111100101111
111111110110000012212021121012020101210121111221111111101011110a111011111011111P1011111111111111101111110111112221122222021a111101222102220221010010011111101011
111111111000100112011122012212202210222222210000111111011111111a0101111111111110P111101111111111111111111111110211220212221b222010110121002221010111110110111011
111000011111010111211120212201211022122002222221111110110101001a11111111111110001P00111110011111111101001011101211211220012b210221002101012221111110101100111111
111110111111110121212020222020211110002210122221011111011111000a111100111110111011PPP01011101111101000010011112022111012112b202210212222111021011011111111100111
111111111111111121021110021122202022100201121210001111011111111a101111111111111110111P1110101110011111011111112021111220022b122111120222200201000111111111110110
101111101011111112020010011011111220211111110121111110010110111a11101111100101110101001111111101011111101110002021111022101b022110221101212221011111010111101111
110110111011111111020121122010121111101011122111111101111011111a11110111011111100010011111101111101110111111012201202121222b222111101222112221111111111111111101
111110111001101122111210211121212110000111001101111110101111101a11111111111111110111111011111111011111001111112221211212202a212112222111011120011111011111010111
110111111111011020220212220211012112011211120211111001111111110a11101001110111111101111101110110111111110101102220122111112a121121221202221211111111111110111111
110001111111111101211121100110102211120012211121111111111111110a11111101111111110011101110111110101110111111101220220122121b221222222122122221101111100011011111
111111101010011101111110010111110111100111111011111111111111111a10011110110011101111101111111100111111011011111201121201211a221121112002202021101001111101110011
