9 3
85 113
22 23
138 34
46 38
18 4
125 115
31 103
80 5
1 47

1102111122122110200112212012112120100101110101111111101111011111101112211101220011112101111211121111a1111011a111111011111111110101111111110111111110a11100010111
0100111020212102202221121021222211100111111111111101111011111111121202122022101120211210210121121111a0110011a111111111101111100111110111011011100011a10110011101
1112101012200102211110112120212122011111111111110101111111111111101101021011211222111222211212111010a1010011a010011111111111111110001111111011111011a11101110101
1111120110122221101212211122221201111101011111111111111111101111122102210102102211121122221210221111a1111011a101110111111101110111110101111111111110a11110111001
1012012111111221120021012111121101110111111110111111111111111011120211001221120000121120212121121111a1111110a110011111011101111111111110101011111101a11110101110
1112222002212221210111222211101122110101110011111101111111110111112102112011120111201210022110021101a1100111a011101111111101111111111111111111111111a11111101111
1101102012112111202101202120211012101111111101111011111011101111112221121120211122102221121112101011a1111100a111011111111011011111111011111111111011a10111110111
1011001222102112100222020122111100101111111110111111111111011111121122111102112101112112221210010111a0110111a111001110101011111011011111111111111111a11111111111
1110102222022222122222221022202021212211110011010111111011011111122212100212111201211222112211021111a0110111a111011110001111111111111111010110111101a01110101111
1111112222222100122120221010122022202111111111111111011111111111112211122121212112121220121111001111a1101111a010111011110111111111111111111101110101a11111011011
1112111222002202102110222201110210101011010001111111111110111111122220121212122212222221121200121111a1011011a101011110111111110010111101111100101111a01110111111
1112101011221222220221222122222222212211111111111111011100111001112212212120202120101101102012221111a1110111a101001101011111111011111111001101111100a11111110111
0102002211122101221122222121222202201011011111011111101111110011121211212111121110121210112111010111a1100111a111011011110111110111111110111001111011a10111110111
1102102122122100102221221211222222020211101011011011100111001111102120211010101112122002010212101111a1101111a111101111111111111111110111111111101111a11111111011
0011022000222022220222212220022112221111010011011011011001110111111222021120222222122120221102120111a1101111a111110101101111011110111111011011111110a11110011100
1112100222221022002220202222222211121111011101110111010011110110101212222221011012111120012121120111a1111111a110111111001001110111111111111011111011a11111101111
1112120202212101102221222202202221012210101010111111111111111111020210211122122221012111121111121111a1111111a110011111111101001111111111010011111101a01000111010
1112110222212122012121112022222100102111111110011111111110111111101101222111100011211220210221221101a1111101a111111111110111111111111101111111111011a11111110111
1111212102012102122220222222022221122111111111101111111111111110110122201212202222212202112011121101a1111111a111110110111111111111101111111100111101a01110101111
1101210220211222222102222220111122202001100101011111011111011101121222012210201221221222212000120111a0111110a101111111101111101210121220011222200212a02122011000
aaabbaaabbbbbbbbbbbaaabbabbbbbbaabbbbbaaaaaaaaaaaaaaaaaaaaaaaaaaaabbbbaaabaabbbbabbbbaaaababbbaaaaaaa0111101a111111110101112111202100202120012122011b11210100110
111101000202221122222220021220112222101111011111111011111111111112110122222001121211212010212121111101111010a101111101110101011102012121222101111221b21020111110
111121102102221202122121221122122220011111011010111111111011111111111122022122112002220122000202110111111111a101110111110010121121221121210212110212a22221111011
111111122022222222122020222220022120211111121212012111110002110010221002122122200112102121011210110110111011a110110010001112100022211222112021101102a22212111100
111022220220211212101222011212012220022102010022221220110110101011121122011101022122102010210221111111101011a101111100111111202122211212121220210111b01212110111
011121122202022022002102202212222212212122100220102120001102021100201112002120101012012222111212101001111100a111110111111112112212210101122220120221b21122111111
011122222212221002222122012121212221221212220100110011221201011112111010112111111121012010021122101111110111a111111111011111112012101101010112122122a10221011111
111022022222222122211220202222222222122102112111110221102212211111212221111112021122222222101021111100011111a111111010111102121202201122211212211211b21022111111
111112222212012212022212022020220222121102022222122122221111201101012122111102212110211211212122111111011011a011110111111110201000211100111211222211a22200101110
111101212202220221010222122222222222200112200110202201112221021111120121212220201222002210210022100111011011a111001111111111121001221011122221111201a22122101110
101211022212022212022211222220122221022012222200201120102102211112122022102110221122022112112012011110111111a101111111111011001211111210021111222210b20111111011
101111111022212121201022022012022120221212122002021020112111211011110111111111111011101111101111110111111001a111100111011002121220110112021022102101b10222111110
110200102220221222221112222221110221211111212201222020120210111011111111010111011111111111111111111111110110a111101111011111122011102102222212211221b21020100111
102211102122122022022200220202122122020101210212121202212112021111111111111111100111111110111111110101111111a101110110111102110120201102001001221001b21121110110
110222122220120122122201210112222211222102212121012022211012121101110111111110001111111111111111111111111111a110111111110011120221121010222021211201b20011111101
021211121222122221222221021222122020211212220211212122122221221111111101111111101011110111111100111010111011a000011011111112122111110111201112221221a21201111011
011220222121112220201222201222012212220120111022211121111122111111110100111000111111110101111111101101111101a110001111111012021112102111111000122102b02211010110
111211221212022222120222221111222200202220200212111021100212211111011111011111111101110111111110101110011111a111111111111100221121121222002011202111b01102111111
220112222021110202222220000021222220020220001100122212220020211111010111111111011111111111100111111011111111a111111111100112211211021121221111212221a00011101110
201101211111222011220202121001021202110100201120221112101221120101011111011111011111011101111111111111101111a111011111111112111210212111112201222222a11011011111
112221021012210202121220211201211212121100102212121122210102211111100111111101111011011111011101110101111111a010111111110111221122111122110012101212a12111011100
121222220101100121122212210212122212222121211101220112210002211101101111111111111111111101111101111111011110a011111111011111112212221000011122221001b22212101111
122101111020110102112012221212121100120122211112221220201111221111111111101110110111111111111011011111111111a111111011111012211112120112210201022100a22210100110
122212101222111210220111211222102201201202121121121211221100221111111111101011111101110111110001111111111010a101111111110111122122121211221212221101b22022110111
212202211111122222212112210201201202211201111010212222122002111101110110111011111110111101011111011111011010a111101101111112221221221011200022221022b10112111110
110111121222221101122101212210211220112211111102121221112011011111100111101111101111101111110101111111111011a101110110101101221022212201110011022202a21002111110
212221120010121111120202022210111120021202111212200221202122101110001101111111110011111111111110111111011011a110110011111112202111120011111101022210a21022111110
120210202112221020022220000002102102011202212111121022002111110111011111111111111101110111111111101111100101a011111111111112121202211020120221121222a01101110100
122021210220121221222122020122122221212111020022001212111022211111110111011111111111101111111111111111010111a111111111110112101202212122200211011111a12001111101
102020212211211122212210212200212212220112112101222101110101121111111111111011111100010111111110011111111110a011110111111111212212121112112211221111a12201111011
122122212222201212120020102011111212212121122010112112002102001110111111111111110100111111010101111101011111a111111111111010110110111100011100111111a01011100110
011122221111211120210220122211210022222102122122121211011100211111101101111101111110111110111011111111010110a111111111111101111010110111111111110011a10011111111
212202012221102212012110211211221001221210222222202111212022111111111001111111111111010101111111111011110011a111100111111101111111111111101110111101a11111010011
122002200112211121111012122010200000221120101000012001112110201010101101010101111111111011111111001111011011a111110111110111111000111111110110110110a10111101111
212122111010220122221220101122111101011001101111111101010111101100101111111101011111111111111011111101001011a110111110011101111111111111101110111101a10110011111
222121221210021201211101120021211110100111001011011011100100110110110011111110111011001111111111111101111011a111111111101011011110111111111110111110a11111111111
202202011221102111002101021212200111101101011111110101011011011110110110111111111111111111110101111111111010a101110111111111111111111011111111011000a11111111111
211010222021210221102122212021211010111111110110111111001111101111111011110110101011111111111100111110110111a011101111111101110001111111111111111111a11111010101
212112110221201201220112110122210110110111111011011111100000111110111111111001100010101110011111111111110101a111101111110111111101111111111111101111a11111101111
bbbbabbaabaaaababbbbaabbbabbbbbaaaaaaaaaaaaaaaaaaaaaaaaaaaaaaaaa11101101011011111110110111111011111101111011a111101011111111001111011011111111011110a11000111110
211012111012101110111122221021211111011110111100010101111110111a11100111101011111001011111011011100100111111a110110010111101110111010101111010010010a01111111110
212111112100012221111000121222210111111111111111111111111111101a01111111111111111001111000111110111111111111a111111011111100110110111110110111111101a11110011111
001122122212221012011222012201111011111111111111001111011001101a11110111100111111101111101110010111111111111a111111111010111111111111110111101111100a11111111111
101011110111100111101100010111111111111111110001111111100101111a11111111111111111101111111111111101111110111a111100111111111101111110111111011100111a10111111010
111110101101100111111111011001101111111110111101011111111111111a10101101110110111101111011110111111111011111a010111011011110111101111111110111110010a11111111110
111111111101111101101111111111011111111111100111101110111101111a11111111111111111111111111011101110011111110a111111111111111111111111011011111011111a11111111111
111111111011011111101101101111111111110110011011111111111101111a01011111111110110111111011111111110111011110a111111101111101011111011111101110111101a10111111110
101100111011101101111111101111111011001111111101111111111111111a00111111101111101110101111111010011011111101a111111111110111110010001111111110111111a10111111001
110111101111011111011011111110111110101111110011111111111011000a11110111111111111101010111111110111110101110a111011110110110101110111011111111000001a01111110011
111101111111011111111101111111111111111111111010010011111011111a01111000001111001111001101111111110111011011a101101110111011111100111011101111111000a11011111111
110011011111010110111110110011111111111111111111011110111111111a01111111101111011011111111110111111010111111a101111111111110111111111111001111111010a11111111111
110111101100110111111011111011111111111111111001011111111111111a10110001011011111111101110100110011101111111a011101111011111110111111110101111111111a11101111011
111001111111111111111001101101110011111111111110111111010111111a10101111111011111111001111011111011111100111a111101111111111111110111101111111101111a10101110111
111101010111011110110110111011111110111111001111110011111011110a11111011110110100011110111110111001111011101a111010111001111111111111111011111101111a11010111111
111110011111111111110111011111101111111011111111001111010111110a11111101111111111111111111011100011101111111a110011111111011111101111111111111111111a11111110111
111111110111111111111101101101100011111110101110111111111100111a11111011111011001110111100110110011011111111a111111000111111111111111111111111110011a11111110111
111010111111101111110111111001111110101010111110100111111111111a01011111011010111111101111101110111011111111a111001101111001110101111111111111111011a11001101111
101110110111111100100010111001011110011111110111111111101111110a11011111011111101101100010111111011111111101a111111111111111111111111000101101111011a00011011111
110111111001101110110100111011101111111111100111111111011101011a11101010110111111111111001101100111111100111a111011111111111110101001101011101110101a11101011111
011111101010111111101011111101001111101111111001101101111101111a11111111111111111111111111111111101101111101a111111011111111111110111111111011111111a11101111011
111010111111110111111011100111111000011111111111111111101111111a10101111111110110101101101111111111011111111aaaaaaaaaaaaaaaaaaaaaaaaaaaaaaaaaaaaaaaaa11111001111
101100110111110110111011111110011111110110011111111111001111100a100011101011110111111010111111111111111111111111110111111111001111110111111111011101111111111111
110111111111111111111111111111111110110101000100111111111110111a111111111101101011111100111110111011111111101111110111111110111101101010101111111111011110101111
111101011110111111111111110011111110111101111101011011101111111a110110111011111111111011111111111110111111101111111111011111110111111000111111111111101110110010
111001011110111101100000011011010011111001101111100101011111111a110011111111110101111110100110111111111110111111111111111110111111111111111111111011011101111111
101111111111111111111011111110111100111110001111101111111011111a011101100111010111101011111110110111101011110010111111111111010010111111111111111110111101110111
111111011111000111001111111011101100110111101111011111111111111a111011111011101101001101011001011111011111111111011101111111011111111111011001101011111011111110
110101101111111011110111111111111111101110111111111111111111111a111111101111111110011111111101101110011111111110011011110101100111111001011111111111111111111101
111111111101001111222121012011211222102111021210111111111110111a000101111111110001110110111111111100111111101111111111111111110111101011110101101111001111110111
111111111111111111212000012222101111110221112021101111111111101a111101111001010111110001101101111011101111111101111011111111111110111111111101101110111111110110
101011011100101100221021121122121011101112121221011111111111111a111111111111101011111011111001011111111111111111000111111111010111111110101111111111011111101101
110110111111111121211201011111220021111212120220101110011011111a111011111111011111111111011101101110111011111111111111011011111111111011011011111111111011110111
100011011111001121201211120011211201112112112211011011111011111a101111111011101101110111010111111110110101111011111111010111111111011111111111111011101111111111
111011111111111120111120222121012020111200112220111111111001111a110111111111111111111101111110111111101111111000111111111111111010111111101111111101110011011111
111111111110111121212110121211120120212212222221011110111111111a110111101011111111111011111111111011111111100011000111111111101111111111111111011101011111010111
010110110011111100212011201112022111012200021121101101111011111a111111111011101011011111111111111111111111111001011110111111111111111010011111111110111101111111
100011011111101111211112022001112122202101211111111111110011111a111110101110111111111011011101111111110110111111111011110011111101101101111111101110111111111111
111111111111101102222222221111210222222121222221111110101111111a011111111101111111110010111111011110111111110111111111110101111111111010111111010110110111111110
101111010101101110210100202201112012110202222021101101111101111a011111111111100111011111111111111110111111111110111011100101111101111110111101111110111101111110
110010111001111122101011101211222102222112022121011111011111011a11101aaaaaaaaaaaaaaaaaaaaaaaaaaaaaaaaaaaaaaaaaaaaaaaaaaaaaaaaaaaaaaaaaaaaaaaaaaaaaaaaaaaaaaaaaaa
101111111101111120112022111202121021122222201001011111111111111a11001a101010111111111110111001111101111111111121122112201102122212222202222210111111111011111011
011110111001101112110011010210010001021111120221111100111111111a11110a111110011110111110111100111111111011110121111112111201121121211222210221001111111110010011
101110111111111122220221210121012012212121222111110111111111101a10111a111110001111011110111111111001111111111011221122122121202021012122110111101111011111111000
001111111110011111111212122202221000122211210011011011101111111a10110a110111111110101111111111111111001111111111022201221011221011211212111121111001111111110111
111011011011111120201120220122202122212222120111110111111111111a11111a011011111111101111011110011111111111101011122222012112120021112112222110100111110011111111
111111111111111122211122020220011121110201020121111111111111111a11101a111110011101011111101110111111111110011120200212102210212210122222111121101001111011111111
110111111101110111221101221111220210201201210111110101010111111a01111a011110111111001011110011011110011101111102102222122222211112211212100201111100111111011011
110111010011011111002202102012211211111022212210111011110111111a01111a010111111011101011111011111111110111111102102110121111112120112221212111110011110111011101
110011111101111112220100112211210111001201211220101011011101101a10011a111011110111101111111111111011111110110021201101111202001111122020102221111111011111110011
111111101000110112211020212120222012111110112020111110111111111a11101a111100011101111001111101111011110110111122111220121221121101110122022221111101011010011011
101111111001101101101011112011101122202222010211111011011111111a11101a111011101101101111011010111111111101101111020221222121111112212202212201101111111111111111
111110011111101011112021122122122111022221212210110010111110111a11111a111101011111111111100111110011111011111122102001111102222112220211202211101111111101111101
111011101111111001222101121121222122221101222011110101111110111a11111a111111111111111111011111111011111110110101122120101020221000111221212111011100111111110111
110111101111111121201112101201111212112222211211110110001111101a11111a111111101011111001111110111111111111111010020111221122211221121210111221111111011101111110
111111011111101111202101201022021112121222121221111111111111101a10011a111111011011111110111111111111101110110101212210212101102211011020122121111111111111101100
111011101111111121201212122122101222211111120111100101111111111a11110a101011111111101111110111110101111111111102110201012211010211112112102121111110111111011110
111101111111101112210201211002211111011111122121111111111111111a11111a101111110101111101101110101101101111111101222102202211120222212211221111011011101110111111
111101100110111112201211222210211112102211022001101111101111111a11101a111101111101110111111111101100011111001120211221110212122212111222102211111011111101111101
111011011111110022112222221011221211211121122211110110011110111a11011a111111011111101110111101011111101111111110110102111122201011222120011121111011101101110101
111110011111101111111111111101111111111101111101011111111100111a11011a111111011110111110111011111111110111110120212221121122211110012210111201111111111111111001
