54 17
98 106
22 23
138 34
46 38
18 4
125 115
31 103
80 5
1 47

11100101221122121222102221210210011101a10111011110110100111101110010201b0021112122022222a2111222111a111111111111111110010011111011011100111010111111111111111111
11121121202111122112112012122112011111a11011101111101110111111110221221b2112112111211120a0002211110a110111111111111111011111110111111101110110111111110111001111
10122012102212112112212110210210021111a11011111011110111111111111212102a0020200212112211b2112220111a111011111111111111111011111111011101111111111111100110101111
11121120111222202110112201122221220101a10111011111111011111111111211220a2121000121022120b1121221101a011011111111111110111111111111111111101110111111101111111110
10100011101020111120010122012002201011a11111110110111101010011111200121b1111012122120220b1012202111a111111111101111111111111111111101111111111110111110101011111
11101112221202220210020112201120120010a10111001011111111111111110212221a1212202222110220a0210220011a110111111011111110101111101011111011111011101111011111111111
11011121210021120111201111201102221111a01111110111111111010110010022101b1112212100121111a1012111111a101011111111111110011111011111111111111011111111101111111110
01021112120002122121220210111021101110a00101111111111111111111110212201b0012221021222122b0202110111a111111110101111111101111111111111111001110110101110101111011
10021122222202202102202121102222121121a11110111101011101110111011012112a0011122211222012a2220021111a111011110111111101111111011111111111011010111101111111110111
01102210222221122221202222220220220222a11110111111111111110111111101010a0222211212112101b2011012101a010111111111100111111110110101001010011111111101111111111111
11102222221202022020000120222221211102a11010111111101101111011101020202a2202221101111111a2210202000a111011111101111111111111110111111111110110111111111101110011
11111112012220022002222222202222201010a11011111111110110111110100222021a1201111121211002a2221120001a111011111111111111111111101110111111101111111011101111101111
11111111222222112210000222222222221121a11111111101110011111111111000111b2222211110001210a0111020111a011111011011110101011111110111111011111110111111011101001110
10121011211112121212022211122220110022a11111101111111011110111111110210b2001212121012111b2222222111a100110111111101111011111011101111111111100011111011111011111
10021122212221211221211221021222121210a11011011111010111111111111222121b2220022112122021a1120012110a111011111111011011111110111001111101110110111100111110111111
11022002012222102022122001220022021221a10111001011111110101111111210112a0121222012211101b1121012001a111110111101111101111110111010101101101110111111111101010111
10121211222220122022122221212222011101a01111111111101111111011001012221a1222212212212201a1202221001a001111001011111100011111101111111110111111111111111111111010
11121222012221220001221222010220111001a11110111111110111111110111201122b2122002212121100a1201222101a111011111111111111111111011111110101101111011101110111111101
11000212222222122022220222222222022222a11111111000111111111110101102200a1101101202112122a0102212101a111111111011111111110111011111011111111111101111111110101100
10021012220221202022022222122022022110a11111111001111011111111111111120b0211100022210211a1121101010a110111101111111101010112210121211121121120121202020111111111
11111221221212122022212212021012022011a10111111111111111111111111110022b2221101210011111b1200120111a111111111111011111011111222111111112122211121210010021111011
11121210222220201002201122000100220211a11110110111011011110111111112112a0121121020121011b2100201110a011111111111111011010101010111212112211122011022202120111110
01111012112220200120022220002022212122a11011101111111111011111110211110b1122210212122112b0022112111a111111110001111100111112212012221120112201222120220220011110
10112212121202222222221201212220222222a22112222011012021120222111111110a1211001020111222a0010112011a101111101001110101111111121011220122122221122221112121110111
11121111212212220220021022200122201222a22222021100000211221012111100021a1221111112221221b2201111011a110110011111011111111012211012202202102020220122201122111011
11122222202212111222111102222100222022b02202220002012202122101111120222b2121111210201212b1122120111a111111111101010100101112210121221100021010202111221210101101
11012112210220021002222120022022222210a20022210122220020101112111221011b0222212111221001a1110112110a111110111111110111111110111111222012120122112112121202111111
10102002022212221122001222222122202012b12102220220221112011120111202010a1210220022121100b2121112110a101111110101011011111000022111122101212120212221122211111110
11022211221202222120122200122122220000a11100201121011211212220111201112b0120201211221222a1101111110a010111111110110111111102210122100011210100011112102121111100
11110000022121120222211222212002220220a02112111111202112121122110211200b1111122121010111a2120112111a111110111111110101111112200021021121222001002202212212011111
11111112202002220212120222202202222222a21122002221122121212221110110221b2221112121211112a1001221111a001101111011011111101101122111202102111022021000111222010011
10011112110221112111022020102211222222a10212222021120212122221101111111a1001111111111101a1100011110a011111111011101110000112212020222020011021112201121120001101
21012012020212222212221122111210021222a12211121110022221121200111111101a1001101111011111a1011111110a011010111110100111111111210010112222202011111210201101101101
11201020222222022222212202222212221202a02122022101112201212122111110111a1110111111111110a1111111111a111111111101011111111111011022222222122222222121012120111011
00102120201002220200120102102221222222b21201222022111021101220011110111a1111111110111010a1111111001a111111111110111111111112221122011120210021220121121221101111
11121210022222202102210100202202222012b11102011210122211211201111101111a1111111011101100a1111111111a011011111101101111011111001222222101122012210211112121111011
01221212012200222212020222112222211221b21220112021112221210110001111111a1011101111011011a1111111011a111110101111011111011111221101112221110020120121001002110110
00011002222212000221222202221012102222a20111222111210000112212101001101a0110101100011110a1111111111a111011111101100111111112222221210111212112111112021120101011
10101222220220222201202222222222222212b22200102011212121211110010011111a1111111101111111a1110111111a100110110011001101111100112111121201120210011022201200101011
11121201020111112101012100111112202022b01111221110212112220212111111011a1111111111111110a0111101110aaaaaaaaaaaaaaaaaaaaa0010202212222111212012112011201222111111
11122111212221112120201111110111212011a02012212102102222111112010111110a0101111110110111a111110110111111111111111111101a1111222110221120202210021211222121101101
01112221111211012120111121100121022020a11202220111012212220211110011111a1001110111001111a111110101111111001101111110111a1110112121111010121001112200111202110101
22222112212122211111121011122121221100b21222211002011111222122111111101a1111111111111111a101111110111111111100011011101a1110022122211011201012111121121122011011
01021221220122202100120212221211212122b10022221212111121222121111110111a1111111100101111a101111101111101110111111101110a0112121120101120020121020100221121111111
01101112100102102210121211020011101211b11010121221121000222022111111011a1111011110111011a111110010111110111011111000111a1112112010102111111201222220222022111111
22000100121102110211201121210002221101a22012110210222222112012010011111a1111111111111110a111110101000111111010101111110a1111111222111001212210122101100012110110
21202221022020221122102010121212121110b22211110120220011112111011111110a1011111011101111a111111011011111111111010101011a1012111100122221110120101221122100111110
21210112012221011211001212121022202212a21122020200021212112112011101111a1111011011111111a011111101101110111100101111111a1112222211121111212120210111210022111110
21211210011101120110002102122211121201b12021122011112120012122001111111a1111110000001111a011111110101011111101010111111a1112112121011212101221222200212212111111
22220121011101110212221120202211020221a12221212221110111021021111111101a1111111111110111a111111110110111111111111011000a1011210111121211001210221110212221111011
00012112121120221022121102221121121112a22201122222111112222222111110001a0111011110011111a111011110011111011111111111010a1111011101110011111111101100011011111111
22120200002122212120112101111121202201a11210111021200121122210101011111a1101111111011111a011111111101111110111111110111a1011011110111011111111111111111011111011
01112221111100222002220022201111111010a20112111220211110111120111111010a0111110111011111a111011111101111111111111111101a1110110101101111110110100011111010111111
21110111021210012202122200202221212212a21221210220222212000022110111111a1111101001111011a111111111111111110101110111101a1001111101101111011110111011111111111110
22010221112212100112121100111121111010a11110000111111110111110010011111a0101010101111111a111111110110101111110010111111a0011111110001111111111110111110111101101
21202221201120122212112121121111101111a11011111111010100111111011110011a1101111111101110a011111111111111110111110000111a0101010111111111111110011110111111110111
02022100012011001211101220222110010111a11110111111111111110110111111100a1100110111111111a111111011111111011110101111111a1011111111110111111110110111110110011101
11102212112120011100021021122011111111a11111101111001111111011111111110a1101001011111111a011111111111011110011111111111a1011111111111111101111110111011111011110
11011222211201022112211120111001111101a11111111011110111101011111111111a1111111111110100a011111111101110111110111111110a1111110111111111111111111111001111111111
00212122221022212212211110111221111011a11101111010111101111111110111010a1010111101111111a111111110101100111011111111100a1111111011111100101111101111111111111111
21121202122012112200120012121211111111aaaaaaaaaaaaaaaaaaaaa111111111111a1010011111111011a111011010110111111110111011111a1110111011111111111111110111111011011110
1201011210202010021221101111110101111111111010111111111111a001011111101a1111111101111111a111111111011111101110111110111a1110111111011111110110100111111111101110
2211022120220211021112012121212111111111111110110011111111a101111111111a0011111011111111a111111110101111111111110111011a1111111111111111111011011011001010111110
1111111111101111111011111111111111111111111111111011111111a111111111011a1111111111111011a111111110111101111101111111111a1111110111111111101110111111101111110011
1111111111111010101111111111111110111111111111111011111111a111111111111a1111111000111111a111111101011111011110111111111a0110111111110110011111111100110111101111
1111111111011011111110110111110111110110101101111111100101a111111111110a1111111101111011a100001011111111011011111111011a1111101111111111001011011000011101010111
1011111111011011101011010111101001111111111000111110101111a111110110011a1111111111011101a111110111110111111001110011111a1101111101111111111111111100111111111111
1101111111111101111111111111101111111110111011110111001111a011111111111a1111111101111110a111101101111011111111111111111a1111100111111111101111111111111010111111
1011111111110110111111011111001011101111011011111111011101a101111110011a1010100111101101a011101111011111101111110111101a1111111100111111011111101111111110101100
0011111011001111110110100011111011111111011110111111110111a111101111111a1111011111110100a111111100100011111101111101110a1111111111110111011111111111111111111111
0101111111111111011111111111011101111111111111111011111111a011010111111a0111111111101011a111111011011111101111111111111a1110111000110110110110111001011111100110
1111110110011011101011110110111101111101111101111111111111a111101101111a1110111101001111a011100111111111001111111111101a1010110101111111111110110111111111111111
1111111111001110111110111111101011111111111110110111011111a111011110111a1111110101111010a110111111100111110111110111011a0111110101111001011111010111101111001111
1110111101110111011111111111111111101110111011111110111111a011001111110a0111011010011011a011111110111110001111111100111a0111111111111111101111111111010111111111
1111111111011110111011111011101111101111111111111110111111a101111011111a1001111111011110a011111110111111111100010010110a1111011011101101111101011111111111111111
1111111111110011111111110111111111111111000111101111110110a011101111101a1111111011110111a101111111111111111111111111111a1010111111111111010111111100110111101110
0111111101111111111111111011111011101110111111011111101101a111111011111a1110111111011101a111111101111111111101111101111a1111010011011011111101111011011011111100
1101111011110011011111111111110111111011111011111111100001a111111111111a1111111111111101a011101110111111111111110101111a1011111111110001110111111111111110000011
1011111101111111111010111101111111110111111111101111111100a111111011110a1110011110011111a111111110111111110111111111001a0111101111101111111111001010111111111100
1011101011111111111111101101111111111111111111111000111110a111011111111a1111111111111011a111101101010011111111111111111a1101111101111111111111110111110101111011
1111110111111111111111111111110101011111101110111111011111a111111111101a1111110111110111a110111101110101110110010111101a1011001101011111100110111110111110101111
1110111111111011101111110001110111011111111001111111111111a101111111111a1011111111111101a101111101111100101110111011101a1111111011110110111110111111110111011110
1111111111111111111101011011111111110111110011111111100111a111001010010a1111101101111101a011111111111111100111111011111a1011101111111111111111111111111111110111
1110111111011111111111111101111011011011110111101111001101a111010001111a1111011111111111a101111001111011111111101110111a1111111111110101011011111111110011111111
1011111111011111111111011011111111111110001111111111111111a111000110001a1111011111001101a111101110111110111111111111111a1011111011001111111011111111111111111010
1111011111110111011111111111111110011111001100111101111111a111111011111a1111111110111111a111011110111111101111110011111a0011111110101100111101011111101111011101
1011111101001110111011111111111111111111111011100111100101a011111111001a0100011111111110a011111111101100111111111101111a1111111001111111011111111110111110111110
1110111111110111111111111110011101111111101111011100011111a111111111010a1111011111111111a111111000111110111110110101111a0110111111111111111111111101110000111111
1111101111111111102221211122121211122012112212211111111111a111101111111a0111100111101111a100100111011111011111111111111a1111101101111111111111111101111111100111
1011111011110111211112212122210012022122211220001011101111a111100111111a1101111111111111a111011111111011010111101110111a1010111110110111110111101111111110111110
1101111111111111110121212112102120020212122212211010111101a111110001111a1111111111011111a111110111011110011111111111101a1110111001110111111111111101111101100111
1011111110111101022111211100211211102212211211111111011111a111111101100a1111101110111101a011111110011111111111011101011a1101111011001111111100111111101101111010
1111011110001111212201101112211221122021112222101111010110a111111101101a1011111111111110a011101010110100010101111101111a1110101111010101101110101111111111101101
1011111111111110100120011022012120220202201202111011110111a111111111111a1101101111111110a011111101100111111101011111111a1101111111111111111111111010111111111011
1111111011010011120001112211221222112201101220111111110101a101011111101a1011011111000111a101111110111111001111101000110a1111111111111011111111101010000011111011
0110111100111111122221122101222122211220201011211010110111a011111011001a0011101111111111a111111110111111111110111111111a1101101111111111111111111111110110011000
0001111101111111222220002122202201210211221221100111011101a001101111101a1111101111111111a111111111111111111110111111111a0011111010111111111011111101111110111111
0100011111111111210211222012221010012121211222111111111010a101111110011a1011100111011111a111111110001111111111111101011a1111111010110111111111001111101111111111
1110101111111101111212110022210121222221111012200001110110a011011011111a1011011011101111a111111111101111011011111101111a0110100111110111111100011111111001110111
0111111110111111110000221211222110212002210210200011101010a110111000110a1101111101111101a110011110110011111110011111101a1101011111111110111111011111101111111111
110101111111001122abbbaababbabbabaaabbabababbbaaaaaaaaaaaaa111011011111a1111010111111110a111101111111111101111112121211b0012222210212221022211111111101111111111
100110111111111111b1122212010021012012000000220111110111111111101111100a1101111111111111a111111111111110101001110112111b1201120110200221221001110111111101100111
111101111111101102b0021012022211101222021211212101111101111011110110110a1011110101111111a111011111111011111111210200122b0121101212121221110101111110011111011100
111100111111111122a2002011211010212121221211122111111101110111111111111a1110111011010011a111111101011111111011220220221a1021101211202112112020011111111110111101
101111110101111110a2021112210111120222111020222111111111011110111011111a1111110000011011a100101111011101110111022022222a2012212012012220222021111111111011111110
111011111111111101a1221210211021012111121211120111110101111111111101101a1111010111111111a111110011111001111111120122100a2021122102100202112201011111111011111101
111111111001111122a2222112011221011221021102122111110111001111111111111a0111100111011111a111110111111011111001220112122a1222222221021220022211111011111001101111
101001110111111120b2210111211212110001021221222100111111111111111111001a1111110111101111a011011111111110101110112110221a1220211201012222122211111011111111011111
111111010111111102a2201121222211020021011220011111111111011111111110111a0111111111111010a111110110111111110111212022211b1110111212212101112121111111110111111111
111111110111110111b0122100011020121120102120111011111111001101111000110a0010011010110001a101111111111111101111112012022a0210211211021021100011111101111011111111
111111011011111121b2201010222211021221011220111101010110101111111110111a1000110110010111a111111011111110101101201211212b2122220022011212111201111111111111101111
010111111111110110b2002122212220211102120022121111111111101110111110011a1111101111110001a011111011001011111111220010120b1121022222222011210021011110011011011111
111110111101111121a2100221012012220121212121200111111101111110111111101a1101101111111011a111001010111111110111120211121a2110121222121201111221111111111111010111
111111111111011111b1110112211212001121110121002111101111110111111111111a1111010110101101a001101110111111111111222001221a2201201100212211101220111111111111111110
111111111111111121a1211122122022222111201211020111111111010011111111110a1100111011111110a111011110101111111011102012220b2100120220222002122001101111111111111001
110011101111111102a0112011112212101121012011210101011101010111101111011a1011111111110101a011110111110101101011121121121b1210111212011121200121111111110011111111
111111011111101122b2020210112222012222012201221111011111111111010111111a0100100011111101a111111101110111101111111201222b1210112222110212212221101101111111111011
110111111101111020b0111122201111122222111001220011111111001111111111101a1111111111111011a111111100011011111011102122102a1022210010111102212221101100101110011111
111111111111111120a0011222101111111211110202122100111111110011111111101a1111111110100011a111101110111101111111121111220a1211202012102222022121111111111111101111
111111011011111111a0111011011100101110011111101111111111010011101110101a1101101111111011a011101101111111111111222112221a1111210222202121012210110001111111111111
