11 112
157 33
22 23
138 34
46 38
18 4
125 115
31 103
80 5
1 47

110020101222212121021110211122022201011111011011011111111110a1a0112011121011121122211202112102200011111111111a111110a1111011011111111111010110101111011010111111
011211010112122110010210111111121110101101111101111111111110a1a1101211111122211102022012220210201101111111111a111110a1110101011111111010110100110100110101111111
011201121021222012201210102112112110111111111111111101110111a0a1110110222212112102111222220022100111111111111a101111a0110111111011101111011001111001111101111111
111221222121220101100222022221102011111111011111111111111011a0a1110112011221202212112122220121111111101111000a111111a1111111011011101111111110111101010101111111
110110221122111110202202212011102210111111110111111110111111a1a1112111111121122210212111112102121111011111101a110111a1111100110100101010101101111111111111111101
110111110111012110012201121101112110110111011101100110111111a1a1122211122010122220121220122022121111101111111a111110a1011110001111100111110110011110111100101110
111121112120222202202210120222002211111111011111010111111111a1a0022011110102212212222120112112211110111011011a111111a1100101101001111111110001111111111111011111
010121102222221212202210212122020111111001111101111111101111a1a1001222111211101221102112011121211001111111111a101010a1111111110111111110111101111111001111011101
111101222221002102102102222210001022001110101111111110111111a1a1121110211000020221111021122112011111011110111a111111a1111111011111111111011101110111111111111111
011022221202222121220200021111222210211111111111111101111001a0a1020212221120022220112002111021211111110111111a111111a1101101111111111111001111011111111110110110
000100222222220222211212121222220102211101011110110011111110a1a0122221000212221211210222211101201111111111110a010111a1100101011101110101011111111001011111111111
100221202221001221210201222202202220010011111011110101010111a1a1110002011201202220212212011111110111011100011a111011a1111111111110001111111101111011110111111011
111211101222022222221222222202121021121101111101111011011111a1a0112210211122112222221111110221021101111111111a111010a1111111011100111101101110011111110101110010
001220220100222222222022202201102222101111111011011111111011a1a1000011101122221022112122122020211111110110111a111111a1111111101111110101011111111111111111111111
111000022011221112012202202212202220120111111001111001100111a1a1121011101102201212120122122011221011101101011a111111a1110001001110111011101101110111101110011101
110212122202222221121220001202212222011110101111111111110111a1a1112220222222012210221001122121021111000010111a101111a1110101111011001111011111111111111011111101
111101220221222122011120220202212222120111011001100111101111a1a1121200101101011222211022011102210111101111111a001100a1110101111111101101111111111001111101011111
101112220200122021222102222201220212011111010111111101111111a1a1112222001222122210221221212222121001111110111a001111a1111001010011011011111111101111110110101111
111211112020021101212221222212020212221111111010111111010010a0a0120211111221121022012022212211210101110111111a111011a1111111101111010111011111110010111111111111
111122021221120221001122222022222202211111111111011111110011a1a1122101222000212222211211011202120101111101110a111101a1111112011221200012201010221212121112111011
111110121200211200110120211202111211100101111110111111110101a0a1021111022211120100212121221112021111011101111a111000a1011110011111121011122202021120221111011111
101121122200212122012210212222202211100110011111111101101010a1a1101012102102012110201111210112121111101100111a100111a1111112020102111120212202101211102212111110
111000111220022211222221112102222112101110111101111111111101a1a1122221112020212201212201111121021011111011111a000011a1011112201211101220221111111122121110110101
110111122120222112120112121222202221222221021212100221202101a0a1112011110222222122122122021120120111111000111a011111a1111111102211101120211210202212112212111111
111221121202202202122022021222122210122221100122211221220210a2a1122222212112011112121121110221221111101011011a101101a0011111111112121111110012110021012202111011
111122120222222011210102022210221220211122220212221121111111a0a1112112222221020110210010021001121001111100111a011101a1111111202122121120211110221011222120111111
aaaabbabbbbabbabbbbbbaabbaaabbbbbbbabbbab1220221111112022121b1a0100222211021210200120021011202211111011101101a111111a0111012212200211122211111211210211212111000
1111202202102211110102222210212222221101b1222201111220111022a1a1120222222221202021221212201102011100111110111a011010a1011101222211012212120012200121222011111111
0102201221222020120222122222022022121121b2201222101111212221a2a1120122122122211111201220102200011101011011111a111111a1111111112211212000211111101122012220101110
1111011222002212012202212121202202221021b1110212111111012110a1a0110121112221202012001111012121121101111111111a111110a1110111111110222112211120121011201210010111
1112021222221122221222201020222212212102b2101122201210100122a1a0102122001021212122001211101002121111111011111a111101a1111111100222020212222222101212122002111101
1111101121111102222021112112111022012021a1011111102221212111b0a1110111101111111011011111111111001111101111011a101111a1110111102211210211222012112222011112111110
2121201022221121212120022201020222222211a1120002111202201212a1a1111101110111111101110111101011000111111110111a111011a1111010212211222021112210222221201212111111
1221211011121022222120222201222222200211b0111211121211110202b2a0101111010111101111111111101111111111011111111a111111a1111112012212212101101202112111022001111111
1012020222012122021222220012011221110200a2020220000122122222b1a1110111110111111100110101111110011111111010110a110111a0110012020122111211022001211212201122101111
2201012120222022220020102111222221220211b1221212110012101022b2a1111101111111111111110111111111111111100111111a110001a1110112221011121112122010111110211011101001
1110112022112202222222202221212211220211b2000201001222011101a2a0111100111111111110110111111101101111100111110a011100a1111011102102211220221111121122202101101110
2222111222022102222112221201222101002011b1121112111221211012b1a1111101111111111111111101101110110011111111110a101110a0111110212020212121110212110021220212100111
1212102210022221222222220220022222222222b2001221102221102111b2a1011111111101111111111111111111111111111000111a101111a1011101121111201222000121102020121122110110
2001102111011111212120202120011221101102b1102101111221122222a0a1110011011001111111101111111011110111111000111a111101a1111101222122211211122222201212111220001111
21baababaaaabaabbbabaaa11121221010211222b2220211101111121100a2a1111101101011111110100101111011110111111111011a011111aaaaaaaaaaaaaaabbbaaaabaaabbaaaaabaabbaaa111
12a1011201212002211002b10121100212012221a1212022210222022221b1a1001011110111111010011111111111111101101100111a1110111111100112120102111112222220102112011110a111
10b1111121201212222112b22110222011221122a2211101011211102122a1a1011111011111101111110111101111111111111101101a1111101111111202022211111112121211221112000211a111
21a2101121212112211210b10120020122222111b2122011021122121001b1a1111101111111111101111111011111111111010110111a1101111111111212122210112122200222211222122201a111
10b2102122212111112211b11110212121112012a1210201111111102011a2a1101111110111001111111111110111101111111101111a0111111111111222220011112221112211210220112101a111
21a1201101000112121012b01111122211211120b1022221201121210121a2a1011101111101111010101011111101100111101111111a1111110110111212221212001210211102011200222010a111
21b2102221121011012102a02221222212022220bbbabbbaaabaaaabbbbaa0a1111111111101111110111110111111001011100111111a1110111111011212122211120212112002212221200110a111
20b1122212212020111010a212122202110101221120121120212112122120a1111111111111110111011100111111011001111111101a0111111110111221112221020120111111122022202101a101
02b1112202101120020121b211112010222211222212210011112102210111a1001101111111110110011101111100011001011110111a0011111101101220221121121011121102111212011211a111
10a1112011212221211021a222121201222220122111111211221222100202a1111111111111110011101011111110101011111101111a1111100111101102022221211222110211000112122211a111
11b1222121221112212222a220122211202211122022012221012011221221a1111111111111001110111111101101110111111111110a1101011111101111111111111111111110111101111111a111
12a2022212012220211211a211222122222222122011211220102221012221a0111111111011011111111011111101111101111011111a0000101111011111011100111111110111111011111111a011
21b1021112121022221110a022112021212211111022210122120212110221a1111110101111111101111111000111010110101111110a1111101111010110101101111111111111101111101111a111
22b1022221122221212012a121111110011110212110221012221202201111a1111011111111111111110101110111110111111111111a0111111111111111111101111101111111111111111101a111
01b1120222112222022121b100111121001101111111111111111111111011a1011111111011111011101111001101101111111111111a1011111001110111101110110110111110110111001011a111
12a2222022101221220211b121112111111011011011001111111111111000a1111111111010111111111111111100111111101111111a1111010110111010111101111111010111111110111101a111
20a0012100001121112121b120222101101001011111110101111011010011a1111111111101111111000101111111111111110111111a1111111111100111110011111111011111111110110111a111
21b2212011110220102122a222122101111110110111110110111111011011a1111110101111111110111100111110111101001011111a1110111110101111111011011011101111111111001011a100
22a1111212212020111012b120121210111111110110110010111101111111a1101111111101101111011110110110010111001101011a1011111111101111100111011111011101111110111111a101
21b2010211021221211112a001110221111111111101111111011110111011a0111111101001111111111110101111011111011110101a1011100111111010111110110111001011111111010111a111
22a2122122212122022111bbbaabbaaaaaaaaaaaaaaaaaaaaaaaaaaaaaaaaaa1111011111111111111110111111111110111101110110a1111111111111111111111111101111111111111110111a111
11a0210121110012202201010111000111111110111011111111011011111001101111010110101111111011111111111010111111111a1111111111111011011111111111101111111111111111a101
22b0022111222021212121222201011110111011111011100111100101110011111100111011001111001101011111011111111011111a1110011011111101101101111011101011111111111111a001
00a1111101110111111100011110111111011111111110101110111101110111000111101111111110101111111011110111111111111a1111111111111111111110111101111101111111011111a101
01a1110110110101111111111111111111111111101111101110101111110111110111010110111111011101111111101111111001101a1111011111001001011110111101111111011111110111a111
11a1111101111111011001111111111110111111111011011111011111110111101111111011101111010111111111011111110111111a1111111111011111111111111111111111111100111111a110
01a1111111111111110111101101011010111111110011011111111110101111111011101111111111111111111111111111111110111a1111011011110011111111111111111110110111011011a011
10a1101011111111111111101111001111110110111101101011111111111101111111111110110111111111111111010111111111111a1111110111111111111110011011111111111111110111a100
10a0111011111011111110111111111011001111110001111110110111111111110111110111110111110011110111111111110111111a1111001011100101111111110110101111101111100111a011
10a1111101110010101001111111110011111011111111110111111101110111111111111110111111011101011110001111111111010a1111011001111110111011111101111100111110111111a011
11a1111111111111101111101111111010110111111111101111010101111100011101100011011110111111101111101111111111010a0111110111110111101111111111010111011110111101a101
10a1111111111111111101111111101011111111111011111110111111111111111011110111111111100011100011111111111111011a1110011111111110011110111111111111011101111111a111
11a1111111101011111111101101110111001101011111101111101111111111001111111011100001111101010101111111101111111a1111111111111110111111101110111111111111101111a101
11a0010011111111111000011111111100111101011111111111111111111111110111101011101101110111100111111111111111111a1111111111100111110001011010111110011111111110a101
11a1111111101101111111110111111011111111101110101111111111011111011011101111111101111111100011010101111111111a1101011101111111111111100111101110101111111000a110
11a1011111111111111110111111111011001111111100011100011111111011011111101111011101111110011110110001010101011a1111111011111111011111110111111100111011111011a111
11a1111110110011011111101101111101101111111101111111011111111111011110101111111011111110011101111111111111111a1111110110011111111111011111110111111001111011a111
10a0111111101011111110100110010111101011111011111011111111101111101010100101111011011111111111101111111111010a1111011111110110110001111111000111011111101111a110
11a1110111111111111011110111110111111100111110110111110111101111111011110011111111111111011011101101111111111a1111011111111111111111011110111101111101111100a111
11a1111110111001101010111111101101111011111011100111111111111111111110111111111111101111111110011111101101111a1111111111111111110111111111001111111111011011a111
11a1111111111010111111011111110111111101010111111111100111101010011111111111111111111010110111011111111101101a1111110010111111111011101111101111111111111111aaaa
01a1011110011101111111101011101111111111111110101011110100110111110011111110111111111111110111011101011111101a10111111110111111000101111111100100101111111111111
11a1110111110101111111110111011111001011010111111100111111111011110111111111111110011111011111111111011111001a11111111111011011111111111111011111011110110110101
11a1111001010111111011111101111111111110111011001111111001111101111010111011101101111111111111111111011111101a11010011111111111011110110110111100110110101111111
10a1011111111011111100101110111111011101110111101110011011111111111111111111011111010111111011111111111110111a01111110111111111111111010011111111111111111111111
11a1111100111011111111111110111111111101110111111111100111111011110110011111100111111101101111110111010111111a11101010110111011111111110111101111111111111011111
11a1111111011111110110111111011010110111111101111111111010111011111111001111101111111101110111101101111011010a11110111110101111101111101111110111111111111110111
11a1111001111000110101111111111101111011111111011111011111111111111101101111100110111010101110111110110111111a10011111111110110111111011111001001110111011111110
11a1111011111111122212120110022211111221002202111111111110101101111111011111110111000011001101111111111101111a11111111111111101011110111111111110101111110001011
11a1100111111111011112012222221012111221210020011011111001111111110101011110111101101111111111101111101011111a10111111111111011111111001110111111111011011101111
11a0110111110111110010011221021010211110222111011111011111111111111111011111111101111111111111011011111111111a11111001111111011110111111111111011110011111101111
11a1111111110011112200211210121112001222012111110011111111110111101001111111101111111111111111111111111111111a00010111111111110101011111111011110111111111101100
11a1111111111010002022022122112020201021021120210101111100111110110110011001111111111110111011111111111111100a11111111111111101101111111110000111110110111111110
11a1110100111010010111012100011012121121101201110111111111011110111001110101111111111010110001101011110111111a11111111111011111101111111011100101111101110111111
10a1101111110011121210102210110212122212121222210111110011011111111111101011110011011111111011111110111011111a11111101111111100111110111101111111110111101111011
00a0111111111010101102122221121110121122121112011111100111111111010001110111110111111111111111011111011001101a01001110010111110110101001011011010110111111011100
11a1101111011111011211102102212101112101221222011111010011111111111111111011011111111101111111111010101011111a11110111111111111111111110100111111110110110111111
00a1111111101110201112012110212211222102222011211111111100010111111001111011011111011111011101111111111111111a11101110110111101111111011110111011101011011111111
01a1111111101111102001022111221222112212212201110111111101111111010101111111011000111111111111111110111110111a11111111111110111111010011111011111111111111011111
10a1111111111111122201012202211211110210222110211111110111111011111101111110101111111101110111111011101111111a11110100110111111101011111111001110111111011111111
11a1110111001111022212201120222112100102201212110111111101111111110011110111101111111101111111101100011111111a21201212121002210112121011122220111011101111110111
11a1011111111100021102110211201110110112210120111011111011111111010111111110111101110111101001110110110111111a01112212222122202120011021122211011111011100101100
11a1111110111111222200222102212212211102121120211111111111111010011011111011001111101111110101011110111111111a12120222211102100121022102221021111111110111001111
11a1111101111111121122221212220222201222220112211101111111111101111111111011101001101111111001111111111110111a11211021212002211022012121202121111010101110111110
11a1111110111011222222222120120100102112112212111001111011001110100101110101110101011111111110111111011111111a11222112122121222202222210021121111111111110011101
11a1111111111111111011222022122022001212110201111110111111111111111111111111111111111011111101011101111101101a11210111211112122221012112111120111111111111111011
11a1111111111111210122121111112221211211212121211011111101011110111111101111111111111111100001011110111111111a02101012122122202121020210212211111011011111000111
11a1011111000111210122222112222121111212220211111111110111011101101111101111111010101010011111111101101111101a22121211122020122210120212200111111111111111101011
11a1001111111101211122211220212022222001212222211010101011110110101011111110111111111011011101111111111111110a10122020111021222222111000021221110111101011011101
11a0101111111011122222111122021202122011212222211110101011101100111111101110111111111101111110111010011101011a12122221021202222011122012010111110101010101110111
11a1111111011111212102122121121210121122221112210111111111111111101101111111111111111111100101111111111111111a21111222111211002121121201002111111111111111111111
11a0111101111101102102101202212112222111212222211110110101110011111001011111111010011101001101110110111111111a21122221211221212001211001120001111111111101110100
11a0111011110011010022101212222110022122112122000111111011011100110100111111011111101110011011111101010011110a22121102122000121121021222111121111111111111111111
10a1111111101111120110202220122121112102200001110101111110111111011110110100011111010011111101111101111011101a10121000201111222222220122121111110111111111101111
11a1100111011111122222122221212022111221212212111011111111111101111101101001000111111111011011111101111111111a11101020212211112221211111210221111110111111011101
11a1110010111111202222201011212212221221111122000111011101110111111100111111110001111111111111111110111111101a12221110111021121022011200211221101011111111111111
11a1101111010111011211021011211202222222111012211011110111110101011111011111111111011111111111110111111011101a21121221211021010022121112002221010111011111011111
11a0111111111111210212202221102112121200211222210111111111110111011111111111111111111111110111111010111111111a22212011112212000221001100222221101111010100011111
11a1101110011001122220102122220120111020112222211101011110111111110110110111111111110110111110101010111111011a21221212221011100100112022222101111101101111111011
11a1101111011101111111000100110111111100111111011101001110111101111011111011111011111011111111111111101110111a21222110101212100211221111101100101011110111101111
