151 47
19 109
22 23
138 34
46 38
18 4
125 115
31 103
80 5
1 47

11121011010121220221a121111022222111101101111111111111111111111011201101202220011122111111111021111111111111110111111111aa110111111111111111011011111101111111a1
11121122211212120201b021200022020211101110111011111100101110100102210021221112222102120111221122111111111111111111111111aa111111111111111011111011011111111111a1
01111120111112202121a210211201002211111101111111010010111101111112012201020121001111101122101102111100001111011101110111aa101111101110111111111111111001111111a1
11111221202122002112b021210122102011011111100011111011111111110112212121101122022121101120212121111011111101111111111111aa111100111111110111111111101111110010a0
11002222100112210001a122112220122200111111110001111110100111111111211111201211111111221222121221011011011101101111101111aa001111111110111101111111111111111111a1
11121111021211221121b122112012112211101101110111111011011101111112121121201112102000220202112220110111111111111111111111aa111011011110111110101110101011011110a1
11121221111212121122b122100120000211101110111111011101111101111112122000020022212201201020120212110111110111111011111011aa111111111101111111111111111101111110a1
11101211220202111121a222120110222011111111100101111101110001100112221122200121101111201121112210111111111101011111100001aa111110111011100111011110111111111111a1
11122212122212212012b012110222222121111111111111111111111111100010211121121211220021221021021100111101111111011111111110aa111101100111111111101111111100111111a1
10122120222221222102b022120022221221211111110111010111110101101102021111211011212021101011222210111101100110111101111111aa111111100111111111111111101111100000a0
11100220222100220102b002212222222211211111101100011110011011111112222201111212200102212210112110111011111111100100011111aa111111011110111111011111101101111111a1
01020112222212102212a011112021222000211101011111111100111110011111220221112122001100112112211111001111111111111011111111aa111111111111100111111011111100111111a1
01112212022222122122b222010221122122101011011111101111111001111102212221121102221200022111222202011010001110101000011110aa111111110111101111011110101110111111a1
11102102122020202202b221222220222212201101101011011100101110111012112122121210112211212121222110001111011010101111111111aa101111011111110111011111001111101010a1
11121121221122211102b222122222122212111111111100101101111111111112121202222121021022120011022101101111110110111101111111aa111001101111111011111001111100111111a1
11100020221122222222a212012222220211120101111011011011110111111012112200101102121011112121011201110111111111100000111111aa101111110101011111111111101111011110a1
11101111222202212222b202210202212010221010111101011010010100111012100110121211101101011222210210111101110111111111111111aa001111011111111111011101101011110111a1
11120112212221122212a222222002222222221111010111111110111010111111102100012200211121221220011112111011111111111011011111aa111011111111101011111111111111111111a0
01022212220022222222a022222220022100211111111011110111111101111012011112221012000221222022022212100111001111011110111010aa111111010001011111111100010111111111a1
00021222022222220222a222202220122201210111011011110111111111111012120110221201102111212022221222011101111111101111110101aa121120100202102202121112112200201111a1
11112222211212212221b1202122222022112211111101101111111011111111022122212110221120222111211212101111aaaaaaaaaaaaaaaaaaaaaa101210001212120010221111122102221101a1
11121221221021202202a0222121222122120211111111111111101111111111122121121202121021110101211122101111a11111111111111101011a111122112221221101220220220102211111a1
11111211222212002212b2101222022222102211110111011111111101101101102211100010211112112212221112211100a11111111011000111111a100110211222211122211211110211111011a1
10111200222212200020b2102112212122201121210212110222101012121111100221100110122012221022222201211111a11111111011111110001a102220222101202011112010012120110111a1
11110212221122222022b1022012000002022222100111220121021122121211122000211210122011220102212201111111a10111011111111011101a122222112221111112211022211112011011a1
11101122222202212202b1222212222222221210111221221100212211222111111212112201122012001212101222221111a11111111011111111011a122110221022111121212201222211221101a1
01122010212211201001b0222222222222222012221121222202210101121211011202200220111212021221211011210001a10011110110101111011a022212111022212112212212002111201111a1
11100122222220222222b2211212202222201221101221221012112011012211122121101212011011122002120112211101a11001011111101101111a011212222001022221120000111012211110a1
11020210001222222222a2102201002222212211102201211120012221221211022000222002211101112221222110111111a11111111010111111111a112211222111121220001021022112121111a1
11012102112212202221a0022212222222222012111122112011121102122210111121112100211210211122212002111101a01011111111011011111a121121220111221021220212122112221111a1
11001010111222022000a2122222222222222221122111101111121110111011011111112220221112200211111101011111a01111111111111111111a010021101011222220112001221222201011a1
10110112102122202221b2111222112202221210112122112122122010112111100110111011110111001011111010111111a11111011101111111011a111211221212202100211022211112221111a1
22010222210221222120a2221120222200121221201111012121112211012211111111111110110101111110100111111101a11111111111110111101a122100111111102102202222201201200111a1
01101112222122220021a0100222011021220220212111102200011121021201111011111101101111111011101111011011a11111101111111101111a101100222022010002122210122112121110a1
11220212220202120102b2220022202221202022210221121212111122222011001111011111111101011011111000101011a11111011111111111111a101122220102121111211122111112221110a1
01221222200222021210b2101122201101222211220211112101021222112111101111100110111111101111111110111100a00111111011111111111a122020010021111221012212212222121111a1
10221210202222222202b2022001112220102210100121200222102211021010111111111111011011010100111111111111a11101111100111011110a121010202211200100201221121211211111a1
11202100122222012202a2222020222022012022122020100011222121211211111111111100111101100110011111010110a10100101111001111111a100221112122010121122222122210001101a1
12201112000202002122b0221222200012022201212120122222122122211101111101101111111110010111111010111101a11100110111101111010a122102110100220102101212111121211010a1
20201022021110201001a1221222010221021002211211210220201101120101111111101111011110111100111111111101a11111111111101110110a122121102122021210010112121110011111a1
11121012122110202122baaaabbababababbabbabbbbbaaabaaabbababbbbbaaaaaaaaaaaaaaaaaaaaaaaaaaaaaaaaaaaaaaa10111101111111111111a112011201211201212121112221102211001a0
1122122220221220200111021112122012201111122121111110212110211110111111111110011101111111110110010110111011101111110110111a122012222202022102022222221210201011a0
0121012202212222222200120012122101000210212111221221210120001111111001111100111100101111111111111011101001111111111111011a122110220021111221010222122001121111a1
1212101121222111121220201120002102100210212222212110111022212111011111111111101111111111101110111101110111101110111111101a100221022102112222221121210112211110a1
0112222221112211020022210011221111122211112221102212122111001111111111101110111011101001111111111111111110111111111101101a110122112011220112122102222020101111a1
2221121012202111112212110201121211120201211202222212110001111111111111111111011111101110111111110011011111100101101111101a122201121112211221222002021122221110a1
1202120212021111121222211112111221211101020100220121111010021211101011111111111111111101111101111110100101111111111111110a111201020212121211221122102102201111a1
1120122122222101001211211112001220112111111221202012210212112111011011010111111111111111011111011111100111111111111101111a11112220110101222011121101111P201101a1
2221111101202102111200112121211222212211020201212012010211111201111101110111111111111111110110111111101111111111110111110a110212221222012021202211020110P21101a0
1110220110211211020011112222202201201112112210120102011122221211110011111111111111111111001111111111011111111111111111110a1121201220122102012121211211011PPP00a1
2120121010022211122022220210202021020112121122120011200101101211111101111100111101111011000111111101111011111111001111011a1001111111101111110111100011100111P0a1
1201101112202102201122121122021211221021210210212200112012200211110111011111011110111111111111110110111101111011111111111a11111111111111111111010111101111011Pa1
0101222122201120011102122111111220212122221111220211110020100211111111111011111001111111111110111111111111111111111111111a010001111011111111111111111111111111P0
2112011121212122212122100021011100111111222201121222211111110211111110111111111111011010001110111000111101111101111111111a111111111101111111011111101001100110P1
2111112211110122012222110011222111111111111111010110111011101111110111001110100111111110111110111111111011111011111101101a111101011111111110100111111011111011P1
1112121221222122011201200212022111111110101101111111111111111111110100111011111101100000111111111111101011111110111111111a100111111001111011011011111100101011P1
2212112022211112211022111110211110111111111111111111101111111011001101101011111110111111111111111011111111110011111110001a111101111011011111101111111100111111P1
2010111201121201012112111011210111110111110101111110101111111111110111111111111111000011110111110011111101111101111101011a111111110111101111001111110101011110P1
1110010212101112011001212221220111010111111111000101101111010111111101101001111111111101110111111110111011111111111110101a111111001101111111111111101111111101P1
1102111000121111112201011111121111101110100110011011111011111011111111110111111111101111110111111111000111011111111111111a111111111111111101100110011111111011P1
2211221220102102220102112211121101011111110101111101111110110111001111111101111111011111010111101111111111111111011100110a1111111101110011aPPPPPPPPPPPPPPPPPPPa1
2021121121211202201211121022012111111111101111111100111101111111111111111111111000111011111010111011111111110100100011111a1011111111111101P111111011111110111111
2112221212022202120202011211122111111011010111100110111111111111011111101101101011111111011111011111110111111111011110111a0100111111110111P011011010111011111111
0111010111111111101000110111101101111111001111011110111111111011101011110111110111111101111011111101111101110011110111011a1011111111011111P101110110111100111111
0110111111011111111101111001111111101111110111111111111101111110111111011111111101001011110111111111011111111010011101110a1110101111011110P011111111110011111111
1011011110111001111111101111110111111110110010001111111111100111111011111011111110011110110101111111111111011111110101111a1111111010110110P111111111111111110111
1111111111011111011111111111111101111111111111110111110111111111010111111101111111011111001010111111111011100011110111011a1101111111111111P111111101111011111101
1101111111110001111101111111011110001110111101000111110101011011111011110110111111011111011111111111101111110111011111111a1111111101111111P111011111101101111011
1100110010111111011011011101111111111001001010101111011101111110111111001111111111010111111111111001001111111010111111110a1011110111100111P111011101111111111111
1001111111111011111111101101111111001101111111001111110011111111111011111111011101110111111010111011110101001111101111011a1111011111011011P101011111111111111111
1011111111111011101111011111111111111110111110111111011111111100111111111110101110111111111011111110110111111101110111111a1101111111111111P111110101110110110111
1111010111100110011111110001111111101111101011111111011100101101010111111111111010011111111111111101101111011001011111111a1101101101011111P011111111111111111111
1111101111011110111011101100011111101011101010111110101001111111111111111111111110111111111111111111111111101111111111111a0001001110011111P111110111001111111101
1110011111101111010111111111100111111100010111111111101001111111111101111111111110101010011011111111111101101011011101110a0110111111111111P101001111111111110111
1101101111111111111111111111111111011111101110110111111110101110110111111111111111111101111101101011111111101011101111010a1111110111110111P111111111101101110111
1010111001111101111101100111111111011111101101111011010111101010011111101111110111011111101111110001111111101011111110111a0101101111011111P110101011111110111111
1111110101111010001111110010111011110111101111001111111110111111111111111111011011111111110111101011111101010111111011111a1111111110111011P101011101011011111111
1101110111110101101000111111111010111011111111010110111101010111111111111001111101101011111111101111111111111011111111111a1011111111110110P100111111111111111101
1111111111110111111111101111101111101111111111111110101111111111111111111110111101111011111010011111001010011111111110011a0111111110111111P101111110111101111100
1101111010011011111101111111111111011111110111101110111101111111111011111110110011111111111111110111110011101111011111111a0010111111111111P111111111111111101110
1111101010010011111111111011101110111111111110101110101001011111011111011111111011111111111111111111111111111011110111111aPPPPPPPPPPPPPPPPaaaaaaaaaaaaaaaaaaaaaa
1111011111001111111111011111110111111100101011111111011111111111101111111110111111010101110011000111111111011011011111111P01111111111111111111101111111101111111
1111111011111111001011110111101111110111101111001101111111000111111111011111111111111111111100111110010111111110111111111P11011101111111111111111111000011111011
0111111111111011011111111111111011101111111111111101110111111111110111111011010011010111111011111001101011111111110110011P11011101111011000101111101111011101101
1111111011111101110101111100111111101111111111111001111101111101100110011111111111011111101101111110101111111010110111111P10101111111100101111111111010011111111
1111111111111011110011111111111011011111101111111111111111111111101100111111111111111110011111101111111011111111111010111P10011111111111101001110111101111011111
1101110111101101111010111111101101111011111111111111011111111101111111011110011011111111011111101111111111101111011111111P01111100010111111011111111111111110111
1111110011111110011110111011111101111111111101111110111111110101110101111101111111011111001111111111111111111111011111111P11111011111011010101110111111111111111
0111111110110111122200222201112121101102111122210111111111101110111010111111100111110111111111011111110111111011111111111P11111111001110111101111111010110111111
1111111111111011122221201121111201102021220011110111111001111110110111111111011111111101111111111011101111111101110111111P11011110011010111101101111101111011111
1110100111111111020211221222220122011220122111011111101011111101101011111111111101111111101011111111111111011001111111110P11111111101111110111111111111111111111
1110111111101101122210222010212221101221211110201111101111101101001101011111111111011100110001111001111110111111111111111P11111111011111010011110111011101101010
1111111110111011100011122010010011122012212221211110111111111101101111011011111111001111111111001101111101111101011011110P10111101110110111011111110111011101011
1111111111110101112212102012112111121211101110211110110110111110101111101100101101011111110111111011011101111101111011011P11111111011111111011111111111101111010
1011111110111110021100212022102211011121220121201100011111110111011110111111111101101110100101111111111111101110111111101P11111110101101110111110111011001111011
1111101111101110220100121211000112101212101121011111111111111111111101111101111101111111101111111011111111111011110PPPPPPa11111111001111101011110111010101101111
10111111111111101122012122021012210100012122201110011011110001111111011101011111111111111111110100PPPPPPPPPPPPPPPPP111110a11111100111111111110111111111111111011
1110111111100111021121121021012101220222202102101111111111101111111111001101011011111101101010PPPP11010111101111111111111a11000011111111111111111111101111110111
110111111111101111100021221211202202212212222121111111110111111111111111111111101111111111110P111111111111101111111111110a01110110110011111011011010111101101011
aaaaaaaaaaaaaaaabababbbPPPPPPPPPPPPPPPPPPPPPPPPPPPPPPPPPPPPPPPPPPPPPPPPPPPPPPPPPPPPPPPPPPPPPP0110111111111111111111111111a10111111101011110110101100111011111010
0111111111101111221022P211202202202022122211122101111111111111111011010111100111101111111011a1110101111111111022211121101a21122201222212120101101001111111101111
1101111011011001012210P120221120221212221110221101101010111111101111111111101110111011111111a1111111100101111112111011211b12121211122210220111011111111111101111
111010111110111021112P1222202002111111212021211111100101111111110111101111111111110111111111a1111111111110111111100202001b22211021101212111121111111110111101111
011111110111100021202P2102221210202021221021100111111011111101101001111111011111101101110101a1111111111111000112101102211a02111222221112212011111111110111111101
11111011111011012111P20011220112112111122001111110111111111110111111111111101101011011011010a1111010101111111112222020210b22002122011200210120111111111101100011
11101011111001110210P21011112000021201010211020101110011111111111111111011111111111111111111a1111111001111011111211112210a21121222020111210111111111011111111111
10111101101111110022P01110210121201022222111210111010111111111111111111101000111111011111111a0101111111111100102121122121a02210121222121222101111011001111010100
1010101100111110200P220220202121212220002212221011111111100110101111111111111101111111101101a0111111111110111111220110102b21020112211202111120111001111111111110
0110111010111111010P021021202111210211121112120100111011100111100101101111111110111111111111a1111110111111111111111101200b12101122211012212001111111110011111111
0001000111111100121P112221212221210211111001221111111111111111110111011111111111111100101111a1011111110100111002111121121b20121222121111022220111110111011111111
11111001101111012222120112221122221012120212102111111111011110111101111111111111011011001011a1101111110101011002001200121a22121212110011112021111111111111011011
11111111111111101111022012102010121222210101110011111101111111111111101110111011111101111110a1001111111110111122221102201b21111110101112201221010011111111011111
10010110111111112220011121110121021011221011121111111101111111111101111011101011111100101111a1111001111111111120112220222a02021020110001011211111001111110110110
11111111101110101121122220111222011212011122211111111111101111110111111111111110101011011011a1111111011010101112011021211a12112011220212122211101111111111110111
10100111011111111002200102012100021012122011021011101111111101011111111110010111111111001110a1011101111010111121122220021a20022221201110001111101111111010111111
01100101111111111222220201112201120011220002200111001111111011101111110100100011001101101101a1111111110011111100221110211a01012201220022120211111111111111110011
01110111101101111112222211010012221200121012122101110101111101111111111110101101111111111111a1111111011111001111010211221b21122112211222201110111111111111111101
11110011111011012020202012211220000121101101011011101111111111111010111111111110011111111111a1011110110001011011122112112b02201122220210211121101101111111111101
11101111101111112202222121210202222221201021122111111111011111111110011101111111110110010111a1111101101111011102201102122b21111211221222022111001111111111110110
11011111111111101111111111111111001111111101111111101111111111110111001111011101101111001111a1111110111111101112221020112b11222111121111121111100111011111111011
