17 86
145 4
22 23
138 34
46 38
18 4
125 115
31 103
80 5
1 47

11102100121201121012121211222112011111100a11111111011011110111111210111022222122111111001021211101111a1111110100111a11101101111111111111011111a01111111111111110
11112021111212121222122222101110221111111a11110011110010010111111222120222121201120112112112112111111a1110101111110a10101111011011101111111111a11011110111101111
10012021022102011111221112011221111111011a11011111111101011101101021221211101221001221202022011101100a1111111010110a01111111111111110000100111a11101110100110101
10111220221001221211122221122221111111011a11111111111011011111101101022121020122222110212202212011111a1011011101111a11111111101011101111101111a11110101101100110
01122120010022102111201101022222211111111a11111111011101101111111012021121111002100011110112110110110a1101101110111a11001101011111111111111111aPPP10110001101111
11112222122010121000122002101102011111110a01111110111111101111110220211222122202110212211211222211011a1111011011011a11101111111110100111111011P11100111111011111
11121222112011210122200221001110221101101a11111000111011101111111110220222211220022222221122001011111a1100111111111a11111111010101111101111111P11100111101011111
01021202110112001002122211102211120111101a01111011011001110110010121100000112020212121011101221111111a1111111111011a11111010111111111101111001P11111111110111111
11012022222212221122221022120202120111111a11110011111110111111110121111111210112110020102122211011111a1111011101111a11011011111110010111111010P11101011111111111
11120112221200220221202022022201222111111a11110111101111111101100211002112122222211101112122111001011a1111011001111a01011101111011111111011110P11111111100111111
11112112202222222222222221220222220012111a11011011111101101111111122122121111121021222022022112211100a1010111111101a11011010111101111011111111P11011110010111111
11112112222222120221222102220221001121010a11101011110111011111110220002111212111211121100012221210111a1111111101011a11101111101101111001111011P11111111111111111
11022212221222102002022012222222220110011a11111011011101001110011222211111211201122212112110112111011a1111111011111a11101111011111PPPPPPPPPPPPa11111111111100111
10110222222012222121202221220222221111111a10011110111001111111011220011222011112200222201210121111111a1100111111111aPPPPPPPPPPPPPP011111011111a11110110111111111
11102120222122201222222020222221122202111a11110110110011111111111121121211111100212120202120102010111a0101111111101P11110111101111111101111101a01011011111111001
01101110102211221121021122222212011101111a10100111111110011111011121012102212101102220120211200111111a0101110101111P11101001101111111111110011a11111001101011101
10110201202221121120210222221222002001111a10110111111001011110111212202112222021001122222220202110111a1111111111111P11111111111011101100111111a11101101110100111
10112021222220202222210222202122022222011a11111111111111001111001212022021100212122121022210222111110a0111111111111P11111111011010101101011111a10110111101111101
11112020111211221122101122212002221120011a10111101111011110111111220112211211222021021112221121210111a1101111110110P11111011111011110110011111a11110110111111111
11100202222222201222021012222212122200111a11110111001111111111101022210011222202022211020211222111110a1111111111011P11010111122222221210211111a21201120012111100
10002212012222011111020200011122201110111a11111111111111110110001102222221012112121022122122021200111a1101111111111P11111101111222102120221221a12010212211110110
10101002201220120021212221222022221012001a11111111111111111110111200221111112211112200112111222211110a1111101111001P10111112221212111012101012a21100022122111111
11111121020122102021022212221222220210111a11011100111111111111111120200112220212112202212122112211111a0001001111110P11111012210212222021220012b12202212212111110
11121001220222221201220220222212222011122b10222122111011011112011211222212112121211112121212102011111a1011111111110P11001112012211212001101222a11202220021111101
11110110222002222220100121110222222201120a02121022102101211120111212222002202221210010222011101111111a1111110111011P11100002101210220020022212a02112200111111111
00102011222012220201222222222112202221122b01112210211211220011111111121012200111120220011111221211111a1001111001111P01100111122212121211120111b22022211120101111
10120122202222121022222122210202102122111b20120112121112012021111222102120121212222210011012111110011a0111011101110P11111112012012022012021221b02221211021111111
11102012222102201112111222020000221001101a21110020112111211101111121101120012121121220022022100101101a1111111101101P11110101102111111011221222b21221012122111111
11102112221202202220101222022220220122210b20001101122121022122110120222111101110121112121001221001101a0101111111101P11110110120100220122022222b11201112201111111
10102222222202222021201222221022212202111a11100010102021101021000020212002221012101112122111222011011a1110110110101P10100111222221121101222202b22221220111011111
11120122212202202222202012121222220022220b22222211022202111122111220111102110122112211000211120211001a1011111110111P11111110110220101221002112b12122011011111110
00010112221121211120121222211102212220110b01222011212011222210011111111111111111011001111011111111101a1111101101110P01100100122020210212022121a11121122222111111
12210010211100222122002222222202222021201b21012122212112021122011101011111111110011111111111101111101a1111111010111P01110111102111222111201112b12111221202111011
10212012022101121220022002012102202100111a20012120111022021212110101101111101111011111110111110110111a1111011011110P11011111210102212102120211a21221111121111111
21122100000221221220120201222222200222111a20222221111122110121101111111111111100101110011101111111101a1111011101111P11111111211220212110012210a11120101222111111
21122010122022122220211202222212222222222a20200121101010022111111111111110010011010111101111111111100a1111111010111P11101101212100102112121222a22112222100111111
22112222221210220220212101011211221022120b21211222102001202011111101111111111111111110111111110001011a1111111001111P01111112121012001111002112b20101012221011111
12100112202210100211101222222111212222211b00122211110201111111111111111001110011010101110111101011111a1111111011111P01101110122112112111201122a20010001101111111
22212111222122222022002022220022222222211b22212121202010121101101111111111010111111111011111111101100a1011111001111P11111012120101222102110102a11202100200111011
11121210222210020212121210212221222021010b20211012211111121112110011110111111011111111111111111111011a1110101110111P11111010022111112111002002b02110121222110001
20120022201122212201102112012212212120001aaaaaaaaababbaaababaaaaaaaaaaaaaaaaaaaaaaaaaaaaaaaaaaaaaaaaaa1111111101100P11101111212012010210221122b12112111221111110
2202111210211121211122120211212121122212012120211210121111112101111111011111101010110111111111101101011111011111011P11111112010221222220012121a11221211120111111
2202012202112221022112201122112111020012211112211221212121220210110111101111011111111111111111100111111101111011111P11111012212021212122100222a22221002121011111
2112221020111201121101212222222221020111120011211222202222110200101101111101110111111101111110011110111011011011111P11011111122212221210112111b20101122111111111
2222220220100121112001012102100101212022210001211211011112111111101111111011101101111111011111111101101111110011111P01111110221111211222100012a11020110112111011
1221210120211011111221221022211120101112011120021221112212222211111101111110011111111111001111111101110101010011111P11111100002111211122221201b12120220120101111
1111221210011112201110220212212011112002201212121221111112111211111111101101111111111010111111111110101100111111111P11110110120222022102222012a21122212222101111
2222122212022221021212110011110221111212111121121022021221120111110111101111101111111110100111111111111011111111111P11010101122222012202222000a11111222122100111
1121121222112212201011210212210212201120222022011022111112211211111011111111111111111110101101111111101111111000010P10111111012122022011112211b11021222221111111
2222110221011012112220111012221100111221122222122021011201212011111111111011111111111111000111111011111111101110011P00111111021211011221111212b21112000201111010
2020201000021112010121011021221201220120201212121210010221121211111111110111111111011111111110011101111111001111111P11100001111111111111011111a11111111111001111
1112222211001112212121111101210112221220220212121220210221221211011111100011101111100111111011110101111011101001111P11110101011111100101010111a10111111011101001
1022212221111102221221221111012001021201201110022200101121221001111011010011101111101001111110111111111111110111111P11101101111111111110011111a00011110111101110
1200021211212122210110022001111020022002200121221122112221210201000111111111011101101111111111101110110001111110110P11111110101110011111111111a11111110111101111
1021221212111211001222210110201111110011111111111111111111111111101011111011110111011011111001111111101011111110111P11111011011111111111111111a01100111010111111
2022200202221221110112022102122111110111101101111111111111111101111101111111111111111111111111011110111111111111111P11111110110101111101111111a10111111111111111
1210121222102121222212220012210011101111111111111101111111101110111111101111111101101111111010011110110111111111101P11111011110111110111111010a10111111110101110
2112220201221111111122222120210111001111111110111111111111010111111110001111001011010111101101111110111111111111111P11011111001111011110111111a11111110010111111
2111011111010222212122111222022111111101111111110111110011011111111111111111111110101111111011101111111000111111011P11011111111111011111011011a11011111001111101
0121212121111210122221022011211111110111111111111101101111110111111111101111111101111111111101111011111111100111101P11011111110111111111110011a10011011111010111
2012202101111202202211221021220011111110111101111111111001111101111111111111111111101101101111111111111111111011110P11111111110001111111111111a11100111011110101
0202212212211111222121120211202111011111111111110110101110111101111111111111111011011011110111111111111101111011111P01001111111110101111101101a11110111111111111
1101111010021202202200220210112111111001110010111111111110011011111111111111101110010111101111011111111111111100101P10111111111111111101111111a11111011111111110
0111110110111111111111101011011100111110111111011111100111111111111111101111111010111111011111111111111011111010111P01011111111111111111110111a11111101111111110
0110111111010110010111111111011110111111000110111110101101101111101010111111011110111011111011111111101001110011111P10111111101001111111011110a10111111110111111
1111111110111111111111011101110111111101110111111111111111111100011111111111111110110011111011110111111111101110101P11111111111101100111010111a11111101111101111
1011111111011111110001111111010101111111111110111111111111111101110101110111111111101111101011111111011111111111111P10111111011101111111110110a11111110110101111
1110111101101101111111011111110111001010110101111111111111110001111111111110011111101111110111111111110111111100111P01011110111111111111111111a11011110111001011
1111011111111111101111111100110111111110111011111111111100001111111001011111111111111111010111111111101011100011111P10101111111111101111111101a11111111001111111
1111111111110001011101101101110101101101111001101101011111111101011111111111110111110101111111101110111111101111010P01111101111011110111000100a11101111110111110
0101001011111111011111011010111010011010111110111101111000111111111011011111110101111011011110011011111111011111111P11111111101111111100111111a11111011100100111
1111111100011011111100111111111111111000110101011111011111101111111100111111110111111111011111111111111111011111110P11111110111101110110011101a01111101111011110
1000111101111111101111111100111100011101111110001111010111101110111110111111100101110000011111110111101111101110111P11111111111111111011011111a11111111001111111
1111101111010101101110111111101000011111111110101111111111111111101111111101111111111110111011110111111010111101111P01111111101101110111111111a11001111111111011
1111111111101011110011111111111111101100111101111111110111111111011101110111001111111111010111011101101111111111111P11110011111111111001110110a11001111111001111
1110111101011110111111111111011101101011111101111111011011111011111111111111111111101111101101111110110111101111101P01110111110111111111001110a11111111110111111
0001111111101011101101101011111011111011111101110111111110111111011111111111111110111111111111111110111101111111011P11001011011111111111111111a11101111100111111
1111101111111011110101110111011101101110111110111000101111111110111111111011111010111110110011101101001111111110011P11111100011011111111101111a11011110001011001
1101111111111010101101111111111111111111001111111011001111110111111010111111111111111100111011110111111101111111011P01110010101101010111111111a01011111111101111
111111011110101111111110011101111100011111111011111111101001110aPPPPPPPPPPPPPPPPPPPPPPPPPPPPPPPPPPPPPPPPPPPPPP00101P11111111111101111010111111a10011011111110011
011101111111100111001110111111111101111111111011101111111010111P101111010011100111111111110111111111111a110110PPPPPa11111110111101111111100011a10111011011111110
111110111111111111110011011111010110011111111111110111110111011P110111011001111101111111111011011110110a11110001011a11110111001111110111000111a10111111110011111
11111101111111111111111111PPPPPPP011001111111101111111111001010P101101111101111111111011111011111011111a11010111111a11111111101111111101011111a10111111011111111
10111100111111111011101PPP0101101PPP01111111111PPPPPPPPPPPPPPPPa111111111101011011010111111111111111101a11111110101a11111111110101010110011111a11111111011111001
1111111110111101111110P1011011001111PPPPPPPPPPP0011011111111111a011101010101110110111101100100110111111a01111101111a11111111111111111111111111a11111111111100111
001111111110100111PPPP01101111110111111011111111111100111110111a110011101111111111111101010110111111111a11111101011a11011111111110111111111010a11110110101111011
11101111100101111P011110000011111011111110111111111010111011100a111111110111110110101111010011101110011a11111110111a10011110100110111101111110a01110111111111111
111100111110101111111111111010111110111111111111111111111101111a110111111101011111111111101111110111001a11011111111a11111101111111011010111101a11110001111101111
110111110101011111112212222022211212212221211121111110111111110a111111111110111111111111111101111110101a11111111011a11111111111110010111101011a01101100111111111
011111101011111122112120112211202221211022110211110011111110111a111110011110011111110011111111111111101a10101111111a11110011011111001111111111a11101111011111011
111111010011101111120122201211201102112221111101101111111011101a111111111111010111111101111111111001110a11111111110a11110111010101111011101111a11011110111111111
101111110011111122101211002211012011122202222211001111111011011a110111101111111001110111111011101111111a10011111111a10111110111111111111011010a10111100111110011
011111111111111121122101011122012011121121111101111111111111111a111010111111011111111111111011110111101a11110010111a00110101111111011011110111a11010111110110111
111111111011000101201110211122111221211112120211001111011101111a111111101101001111101111111101110111011a11111001111a11111110100111111111111011a10011100011111111
101011111110110111102002211121122011210202221011111101101111111a111000011101111110111011100111101111111a10111111111a11101111011101101111011111a11110011111111010
001111111111110001101210212121201120221212221221111111101111110a101111101011111111111111110101111110011a10101110100a01111101110011111101111011a11111101111111110
111110011111100102212121102122221210220211110211111111111001110a110110111111101111101101011111101010100a01011111111a01111111111111110101111111a00111110111110110
111111001111101112201010111111110122211212201011111111101110101a011111111111011111101011101111111110101a10111010011a10100111110111000111110111a01110111100001110
111100111011111010111010122011210222221201020121110111101011111a101111101111111101111011110111111110111a11111100110a11111111111111111111110111a11110011011100110
111111101011111100021111011001222010112222102221110010100101101a011111011000101110011111110111111110001a11111101010a11111110111111010111101111a01101011110100111
111110101011111121211222212101211112120221121210111111110111111a101111111111111111001111110111111011110a10101112222a22221111222200211110111110a01010110101110111
010011100011101111212211011212112112201012202111111101111011111a111111110101011111110011110011111111111a01011122012a21212111210212110112121211a11111010001101111
111111111111101121102002220212121121211112102221111111101101101a111110100111101101111110010111111111111a11011022111b01200021122100112212222211a11111101101111111
111111110111111011220221101121211212221022122121111101111111110a110111011010111111111110111001001111111a11111112212a11112210211122111212222111a10111111101100110
110110010110111110021010220001012021001211021111111111110111111a111111111110111111111111101010111111101a11001122222b22211011011211211120220221a01111111110111110
111001110111110112201220211211201001211120200101111011111111101a111011110111111111110111111111101111011a01011112111b11221202211222210220121201a11101010101110110
101111110111011121102112112202121221111212211211110111010111101a111010111111111111101111100101111111010a11100121122b22221101211201002101022221a11111010110101101
111111111111111002221122011021201122121221011220111101110111101a111111101111111010101111101101010111111a11110110222b02111010211221222212222221a11111010101001111
111101111111111101122121011211122222111102211111111111101111111a101111010111111010110111101111111011110a11101022022b12212212120021221220202121a11111011101111101
111111111011011112100112201211021100111102212121111101011111111a111110110011110111111111111111110110101a11111111122b22202021022121111110210211a11010111111111101
011111111111111120021201212210202211210221101221111111011110111a111111111111111101101011011011011101111a11111112111b11112111201222112012111211a11111111011110110
111111111111011121221211212211121121021012122211111111111111110a111111011111101110111111111100110111001a01110121121a22102022222122212122202201a11111111101111101
111011111111100122200222012102211002210100022211010111110110110a111011101101111111111111111101010111111a10111112121b22111121021012202211001011a01011111010111111
111101011111111111221122120212112200221021221121110011111111111a110111111111111001110111110111111111011a11111122102a21121212111121122202211211a11110111101111111
011100001111111122202200122111211221021121002211110111001101111a111111111111011111111111111101111111111a11111110111b01122110102102110212212101a01111110111111001
101101111101110112222122122211120112220102220201110011101111111a111011111001111111011111111111111011011a10011121122a21212202221121112212221110a11111010101101110
111110110110111122111112221210102222111120012211111011101111111a111011011011101011100111010111000111110a01111112212b11112221221212112212021001a11111101111110111
011111101101111111220212211110012010121122120210111111111111110a111111110101011111111111100011001111011a11111121021a01120211101110012022210111a10110101111101100
010011111011111111220222011111201002221112112121111011111111111a011110110111110101111111101111110111111a01011111211b22211110021121122111112121a11010101101011111
111100111111111111111111101111101100111111111011111110111111011a101111110111111110001111111111101110011a11001102011a22102112212212122122111120a01101001111100101
