17 86
145 4
22 23
138 34
46 38
18 4
125 115
31 103
80 5
1 47

1012112122101210020a21121112220222111001101111110111101111111111110120021121222212012220001101211101011110110111111111111111111111111111011111111011110111111111
0102211111212221210b10111221100202000110101110101011101111100111112110010202112112122101111002111111011011111111010111111110011111111011010111111111111111110111
1110112110211021011b22221212121222011111111110111111001110101000112112212212222101221121102002221101111111110011111111010010111111100111110100111111111111011111
1111112112011221112b01211210121020111010110111001001100011111001120202012222112202210210122021001111111111111011111111011111100111110111011110101111111111101111
1111211112001202120b10221121110120101111111111011001110011111101120111102012201210101220112110201111111101011111011111011101110010111111111101110111111111110111
0112211111222210201b22211111122211110111101100110100110111110111111122212022110202112111101111211110011111111111111111001101101111011111111110111111101111101011
1101221122101221121a21222221111112110110011111011011111111111111022112211121212211211211110001111111011101011111101101011011110111111001111111101111111011111111
1112011211212002011b12102222220121110010110111110111111111010100112111102210022121102112221001210101111111111111111101101111111111111111111101111010111010111111
1112210222222212201b01120222210222122200111111110101011111011111011221102201220201111001211222201111011111111101110101101111111011110111101101111110111011111101
1111221221222222202b12210220222222102211110111010111110011100111021102212001222111211201101222221111101111111111111111110111110101111111110111110011111010111111
1110002012212022222b22021122222211110111111110111011111110111110120112112122122122022011121211221111111111011111111111111111111111111111101111011111100100111110
1012211222221120220b20212222202012121101111111001111101111111011111101100121021202202222211120011110101011001100110111101111110110111011101011001111011111111111
0111112122100221202a12221212220002212011111111011110111101111111111121012111202201122001221202211010111111000111011111011011111111101111111111111100110011011111
0011212212212222220b02102122022021211011111111100111110111111111101211100022012222112012111210220111101111110001111111111111111110101111111111111111111111010111
1112002220212222222b12102011221022121110111011110011111110101101111222200111112100011111110211121111011111110111110011111101011101111010001101101011101011011111
1111021211022020221b20200002022222202111011101111011111111110111022112011110220210011201100111011111111101011111111111101111001100001111111111111111111011011101
1111102212022012022b20222222122121111211111111110001111010111111121012102210021121220220101122121111111001011111101111011111101111101110111110111111011111111111
1110112222221220201a22211021122122022101011101110101100001111111121020220212212221021210010122121001101111111111001111111111111111011111110111011110100111110111
1111211222221222222b22020202221020201011011100110011101001111101111122022112120110222011220112111111110011101111111111110110111111111111101111110111111010111111
1112212202212222012b22111220202111012110111101110111111111111111021121111221212101011222201011021110111101111110001110111111121211221110022011001201212211111111
1111202222122202221b22012222222212220010010011111111111110111010121211000120012212122111122121120010010111111111111111111112122211220120021211021021202112111111
0111122022222121112b22121010200202110111001111111111111111111110110112220211010220002021212121221111111011111111110111111111120101211222222212220122102212111111
1110200222212022011b22222122021012111100111111011011111011110010112112111122201120211101110221020101101111111111111001111110112022122121110021222022021212111110
1110112220222112222b02220211120220021222102222210200121212222211111101111211110010002011211201100110111011110010111110101101112201211012221202011021222021001111
0101121222020020222b00201222021020222111211102122222110222012010121011120111102021222222220222211111111111110001111111110112121101122121012121211212121221011011
1110012020211112022bbbbbaabbbabbbbbbbbabbaabbbbbaaaabaabaabbbaaaabbbabaaabababaaabbabbaaaaaababaaaaaaaaaaaaaaaaaaaaaaaaaaaababbabbbabaaaaabbbabaabbaabbbabaaaaaa
1112211202022212012222222122122220021100211221112212221222111011110211111100222222100220102222101100110111101111111111111012102110221222120222220112220211111110
1111121222221212222222212122101222222011120120212120112111112011112010220211111121121110011010111111111111101111110111101111111121101221010200212120101201111100
1111202221012101022202221220022200220211222212100212121120002211021121211212212212122001100122111101000110111110011011011011222111212212020120102021102111110111
1110022221222221220021222202220222021221202210121221121221222211121112101121101010212210010212121111110100110110111111111112110202022102122112122120201021011110
1112012222202212222220022101222220112022102012010112020202212211011111221101201222112012202121100111111111111011001111111112210112102221211210121012220120101111
1110101212101202222102201222112122220202202201122221020211122210111111110111101100101111111110011110001010111011101011111012000210121120211222210122121112111111
1122111222200221020122220020211221220211111122211122012120220211111111111111111011111111011011111111110111111111111111111011102222111011111201221021120022111101
1220122020202002222222210221221120221022222211112001100012211211101111111011101111111111110111111111011011110111011011111110222111222020121211210012212221111111
0022221222222202111222122202212022222002221022120202222002022010111001110101110011111111011110111011110111111001111110111100110102021122021011222121222201111001
1102102201020002012221201002222122200202011012222121212011220201111111011011011011110111101111111111111011111110111111101112212121121220110212120212100222111110
0001222210222021211222210220222211200112220121121122212010221111111111111111111111101111111111111111111101111111111111111111112102220220112001110222000220101111
1222122022222222222220212220022121020211222002121211221112112111111111111110111111111011111111111011111100011111110111111112121201122112120002220022212212111111
0121020222011222222222022112222122221221222122211102102110201211100111111111101110110111111111111011111101111111111111001112210222120112220111210220001201111100
20222222122122212012122111112111111221222111212121221221122120111110111101111011011100111011011110111111111011111111aaaaaaaaabbabaaabaaababbbaabaabbbbabbaaaaaaa
21122211120022022222102122221222112210222120212212012021211211110110111111101111111010101111111111111110011110111101a1110111112220200221221222211122210000101111
11220221211112102121221111121011212101220012220121111012221100110100111111101111111111100111111011111011101110101110a1010102111222222022121212211112221201110110
11020212221201220211211212020102222220221122110012221211211110010111111111011111111111101110101110111111010110111101a0111112112110201211011210222211201201111100
12202121211201122021121112101211001122121110021021010011120212101111111111110111001111100111111011111101100111111101a1111102021211212002010101202220202202111011
12020210210121121222102102201112122211222211201220111222222212111001111011110111111101111101110110111111111110111111a1101112022111201222021011121122002012110110
12212112112022121212202101211120222221222010221221110220111201101111110111111111111101001001111011011011011011110111a1111102111111121011221102102120121100111111
22211002211021221111101212010122110201111201001002012111111112110111011111100111101101101111111111111111110111101011a0001102210221122221011101211112022211111101
22120112221202210120011022200122020211120010212211022210121020111011101111111111111111111111111110101101010111011111a1111102021111220211221110121111212121111111
bbabaabbababaabbaabbbabaaaabaaaabbaabaababaaabbbbbaababaaabba0111001111111111111011011111111101111111011111111111111a0111112202222112211111110102121212222101111
020211122222120112221121121010121212120220101211112011012221b0010111111101111111111110011111010000110111000110110111a1111111211112221121221012212220212002111110
020212112121012220201202122102011211002211111111111101222122a2111110111111111111001110100110101111101111111101111111a1011111111111101011011011111111101111111110
201210122021210112111201012002212211202011222120211112221221a1111101101110111111100111111101111111111101111111111100a1110111111011100101111111111101111011111111
011221110212011112212010011220202221211120111220121211222011a0111111101111111011011111001111111110111101111111111111a1101111111110011011111111111101110101111110
221222112211102022111112121111111021201212122121210011220112a1111101111110110111111111110101111011100111110100110101a1111101110010111011010110110111111111111111
222111221120220101122022010222211110111111000110001011101000a1111111111111111011011101110101111101111110111101111111a1111111011111111111111110101110101010111111
120121200112122111122112201022211101010110101011010111110101a1101101111101011011110100111111011110110011111011011011a1111111011111011101011101011110111111101110
222212001210101222121020211122011111111111111111101001111010a1111010110011011111111111101101101111101100111011111111a0110100111111101011111011111101101111111011
212121122211121120112122122122211111101101111111011101111111a1111111111111111111011110101111101111011010110111111111a0111111011101101111000111111110110111100111
121221202111020021221122222202211111111001011110111110011111a1111101111101110011110111111111111110110111001111101110a1111011100011111111111111001111111111111010
22201212021111211200020021121021111aaaaaaaaaaaaaaaaaaaaa1111a1111111111101111101111101111110110111011111111101111111a0101100111111101011111110111110011110111111
11221010100222002000221212102211111a1111111111111101110a1111a0101111111011000111111110101111110100111111111011111111a1111111111111101110101111111101111111111110
02212121122011011012022122111021010a1111111111111110010a1111a1110111110111011111111101110111111111111111111101110011a1111110111111111010111011110111111111011111
11222021112021212021211220221111100a1101011110111111111a1100a1011111010000111111111001111111101110110111110111110111a1101101001111111111011111011111011111111111
01111101110011010001111101111111101a1111111110111011111a1100a1111101100101101111100111111111110111111111111110101011a0111001111001111111010101111111011111101010
11101011101111111111111111111011110a1111111101111111101a1000a1011000110111111011110111111111110101101011100111101101a1011111101101111100111111001101110101011111
11110101111101010011001101110000111a1111110111010110101a1011a1110110111111111101010111111100111000111101111110011111a1111111111001110000101111111111101111111010
10111111111111110011110111111111110a1111111111101101010a1110a1111111110111111011111111111001111111111111011111111111a1110010111111111110101110101111101011111111
11111011111101111111111111010111101a1011111011011010011a1110a1111111111111111110111101111011111111110111111101111111a1111100111111111111111111111110111011111111
01110111111110111111111100111111011a0111101111011111011a1111a0111100101111111101111011100010111101101110111001101111a1111111111111111110111101111111100111101011
11111111011111101011100011010111100a1101010011101110111a1111a1111111110110101101110110111111010111111110011111111111a1110111111111111111110111010011101100111110
11110110111111011111111111111110110a1111110111101010111a1101a0101111101110111111111011111111110110011111111111111110a1111111111011011110111110111111111111110111
01011111011111111111111101111011110a1011111011100111111a0011a1111010111111101111111011110111101101111111111010101111a1110010101111100101011101111110111011111111
11111001111100111101111111111101110a1111111101111001111a1011a1111111111001011111111111111111101111011010011111111111a0111011010101011111011011111111100111001110
11110111110110111111011011101101101a1011111010001111111a1101a1111111111110111111111111110110111111010101111111010010a1111101100111011111111111111100110110111111
11010011101111111110101100011111011a1111111111011111111a1111a1111111111111110110111111111111111111101111111110111101a1011111101111101110110111100111111111111101
01101111111011100111101101011100111a1111111111111011111a1010a1111111110111111111111111111111111100110101111101111101a0110111101111111111111001011110111111111111
11101001011111011111111111111011010a1111111010111010111a1011a1011111111101111111101111011011111111001111010111111111a1111100111110111110001110101011101111001111
11111011111111110011111111111101111a1111111111101101111a1111a1111010110010110111111111101111110101111111110111111111a0111111111111111011101011101111100111111100
11100111111110110011111111111101110a1001111111110111111a0001a1111111111101100111111100111111111111111110111111101011a1111111111111111011101111010111111111111111
aaaaaaaaaaaaaaaaaaaaaaaaaaaaaaaaaaaa1111111111111000110a1011a1110111111111111111111011011001111101111111111111111101a1110011001110100111111111110111111111111010
1111111101111111111111110101111101011110010110111011111a1101a1110111111111111111111110011110101111101111101111110111a0111111011101100111111111111010111110011111
1111111111111110011111111110111111111111011111101111111a1011a1111111111111110101101111111110110111111111011111111110a0011110110101111111011010110111101001101111
1111111111001001111111001111111111111110111011110111111a1111a0011111111101110011101111011101101011111101010111111111a1001001111011111110111011111111011110011101
1111001111111101111111111011111111101111001111110111110a1101a1111111111111111110111111111100111011111111011111110111a1110100111011011111111110111111010111111011
1111111111111111111111111111101111111101111001100110011a1110a1111111111110101011011111101011110111110110111111101111a1111110101011111111100010001011111111110111
0111111010111111101110011111111111101101111111111011101a1100a0101111011111011111011111100111110111111101111111111011a1111111110001111101111111111100111001101101
0011110011011111111111111110101101100111100111111111110a1111a1111111101011010111011011111011011111111001111011111111a1111111111110101111111111101110111111111111
1010010111111111111110101111111111101110100111111111011a1111a1110001010111011110011111110011111101111111110011010011a1111101101110111111111101011110111011111111
1101111111110111120211020102112201202222022111111111110a1111a1111111111000011111010101011011111110101111111111011111a1011111110111000111011111101111111001111111
1010010101111011121211201110221010112010011010111111101a1011a1111111100010101110111111101101111111011111111110011010a1111111010101110001011111111111101011111011
1010110110110111111111211212211122120011221222000110011a1101a1111101111111110111001111101101111101111111010011101111a1111111111110111111101110111111111111111111
1111111111111101021112210021221211020221011210111001111a1111a1111110111111111101111111101111100111111110111111111111a0110101111011111101011111111011101110011111
1101111011011011002022201221122021121111112220211111101a1111a1111100011101111111111111101101001110111111111010111111a1111111011100111111111101101111111101111001
1011101011100111122112022121012222111212011202211111111a1101a1111101011011011000101110111101111011011111010110010101a0100111011111110101111111101111001101111110
1110111111111011110122222122212221122120101220211101011a1001a1011111111011111111111011111111111101111110100011110110a0111111111101111111110111011111011111111110
1111110111110111110110212121012201120100012120201101110a1110a0101111110111111101101111111110111111111111111110101110a0111010011110101111011011100111111111111101
1111111111111111122112210000101211011221220221211111111a1111a1100011101101111111111111111101010101111101111110111111a1111110011111101111110110101111110111111110
0111111111110111222122221121210211122112222001111111111a1111a1111111011011111111111111011110011101101111011110111111a1111101110001111101111001111011111111110111
1011111101111111110221122112110202201100020101111010111a1111a1111111111111111111111011111011011111110111010101111111a1011111110110110011111111101101111111101111
1111101111101111211110122120011211111220211020111011111a1110a1110111110111111111111111111110110110111111111111111111a1111111110111111101101101110111111010110101
1101111110111110211021112121122120001121110220111101110a0011a0011111101111111111111011011011111111111111101011012112a1211021102012200121121211110101111101110111
1111111111101110122121011212021201121022112101211110111a1111a1111111111111111011110110110101111111100110011111121102b2211112112120101202012210010111111101111111
1101001111111111122212212200121011101102111202211111001a0111a1101111111011001111111111111111111111111111111110111022b2010001212121212212011121111011101111011011
1111101111111101221010002211221101121202011002111111111a1101a1111111111111011101011111111100010011111111111111012112a2122022112212222222110111111101110111101111
1110011011011001120212202101101111121002012122211111101a1101a1100111110110111111011111111111100101011111111111212021b2021112110212211021122010010111111011111111
1110111101010111222202120220111210222111222210201110111a1011a1011001111111001111111111111110011111011011111111012222a1202211200121221221112101011110111101111000
1111011110111111212220100201212121022101120211010111111a1011a1110101111111011111111011110111111111111110011110021101a2220121120120012221122220110111100011111111
1011101110111111110200222122222212210110110220111101110a1111a1110111101101110111111101110111101110111010111111022211a0112210210002202211221111001111111111110111
1111111110111111220200202210221221202201101102101111100a1110a1111111110111111111011111101110111101011110111111102011b1211220212111120220022110101001111101110111
1011111111111111222012122122102212111101110122111111111a1111a1110011111111111111111111111101010011111101111111112111a2221211020100110212201221111100011111111110
1011111111111111221221101211011221222221010012111001111a1111a1101011111101111100111111111111111111101110011011102222a2212222222211011020010221101110111111011110
0101111101110111111220122221202222222111111200101111111a1111a1101111111111100110111111011110010111111110111111221210b0210221111122202211101221111101111111111111
1011111101100101111112211111021212022110121111210111101a1111a0110111111111011111101111110011000011011111101111122222a2211121111112221221211100011010111101111110
1111111111111110222021120011220111221111102221111110110a1111a1111111111011111110111111111011001111111111011010102121b2222201221211210022120211101001111111111111
1111111011011101201102100110201212112102202110111101111a1010a0111100110011110011111111111111011111111111111111111002a0122122111011111122211220111101111000111111
1111011111111011021220122120121112110112120112111011110a1111a0111111111111111111101011011111110111111010111110121222a0221011112022202010022221111101011011111111
0111111101110111201121212011210101221222011212111100111a1111a1111111100011111111101111111111110111101111111011201111a0012220011021221111211101101011101101111111
1110111100111111120212222211120100101102012112101101111a1111a1111111111101110101110010111111101101000111011110220222b0201122222222212022021211111010111011111111
1111101101111111121211121111102201101112021222111111111a1111a0110111111011011100111111011011111110111011100011111201a2112122221111121222212220110111111111111111
1011111111111111111111110101101011111101111101111011111a0110a1111111001110110011111111111111111111111011111111101210a2200011121001112022001011111110111111111111
