143 49
8 116
22 23
138 34
46 38
18 4
125 115
31 103
80 5
1 47

101111222111b02222221000201121001211110111111111111111110111111112012110a0112011021222110012120211111110111111111111011001000111010111101111a1110a010011111101a1
101122200211b02111212122201222020111111111010111111111101110111112210112a1211112212111211112220211101111111111100011111111101111011111101111a1100a011011111101a1
011110122211b12211212221110121212111101110111001111110011010101102021112b2011112221202000101220011110011111111111111110101101111111111011001a1111a111111101111a1
111011110221b22112222202111212212011111111011111010111110111101112221212a1221002222122011021210111111111111110111110111111111111111111110111a1110a111111111010a1
111211202122b20211012221221111111111011110011110111111111011110101222111a2211120211020122222221201101111001110111111111101110011111111111111a1111a101011111111a1
111220101101a10210002112121001101111110110101111110011111101110012222012b0211211aaabbbbbbbabbabaaaaaa111111011010111111011011011111111111110a1111a001111111111a1
101211111201b11222001121011012121111011101111101111011011011011102211221a1021101b1110201220122211101a111110011111111111011111011111111011111a1111a111011101111a1
110102120222a21121201011202211122211101111111111111111111111111002121102a2112101a0211201222112001111a111011111011111011111111111111101110111a1101a011111111101a1
101011102222b20201212002112220202222211000111110101111110111011112010110b2101121a1110212222112211111a010110111111111111110100111101011111111a0101a111111111101a1
111121121222a21220100201122221022222211010111111101110111111101002112121a2102111a2001121112202121111a111001101011010111101111111101111111110a1111a110111111111a0
011121220022b22202222022200011221002221111111100110111111011101111021010a2002121a0101210011122110111a111111111110110111101101001101111111111a1110a111111111111a1
101212221222b22211121102112022022022121111111011111000011111111112201200b1121212a1122120110201211111a111111111111111111111111111110101010111a1111a110111101111a0
111022121212b22211221212100220020122111111011010110001101111111101101220a2200122a2212100022111100010a010111111101111011111111111101110110100a1111a111111111111a1
111112222221b12112222221100221210212001111111110001111011111110112211122b1221112b2212111212121121111a101011111111111101111111111111011011111a1110a111111111110a1
111112222222a02220211222012221222222021111111111110111111101111112012011a1021011a1202022202112111111a111110101011011010110111110101110011011a1111a101011111111a1
111122122022a22122100012110022222202220111111111111010100011111112112010a1221211b2121201220222221111a011110110110100111101111110111110111101a1111a110111011010a1
101120122222b10022212222222222021222021010111110111111011110101110222121a1222121b0210121212211121111a111101111111111111111110110111001111101a1111a111111011111a1
101101201021b02022200220222220212212010001101101111111111011111002002111a2200022b1120112202112201111a111111111100111111111111011111111111101a1010a111111110001a0
111221202222b10222021221001122221212211101111110111111111100111001201020b1212022b1111121121210011101a111110110000111111111111011100100111111a1010a101011111011a0
111201102010b21001212212122120202211221011101111011010111110101101212212b2202112b2122100122212011110a111111111111111001011102222122222122120b0112b111102121111a1
101200121212a21012222222202012211012010111111011011111110111101101121100b2112021a2200021022122211101a111111101111111101110112221222221120102b2211a012211011101a0
111121022220b22222222201220220112212201111110111101111101111111010220211a0212012b1121122000010221111a110111111101111111111112222011112202110a1010b202110211100a1
110112212112b12121221212200121020111111111111111110111111111111111120221b1022222a1121121222112221111a111111110001111111110122211221222121012b1022a112221111111a1
111220222221a22020202022002112020022221122011100212122111122221111110021b1122210b1221112022222211100a101111101101100111111112202220010210220b2122a121022001111a1
111211201220b02022102102222121202221020002000210101221121221211110220112a1022121a0101221022012021101a110111111111111111010001022222212122202b0222b212121121111a1
001221221022b22222122220021210222201011112011112121022221011211111212212a0112221b2021210011101011110a001111011111101101111110011011212101212b2221b012122111101a1
111112012122b11220102202222221122222211111121112220122012221111102012021a1222222b2021210020221111111a110110011111110110011111212122121201222b1222a222121221110a1
011101022222b21012022222102010220222221122200222010222021110101102022212b0022121a1220122220112110101a110111111111011011111122011011112122122a0211b211021221110a1
111222022010b12222022122112221220221222121020012202021222222121011212222b1110212b1022210122112111110a111011011111111101111102210222211201210b2022a202101111111a1
110221202012a20210102120202122220102222121222122221022202211211112121111b0121021b2211221222212221111a111010111111111000111122021220110122111a1101b212222201111a1
111202012201a22020222022222212220112002111212020211212102212010112011211a1202110b2021121222120121110a011101110111101110111112200221211202222b2211b010211221111a1
111011122200b11111122112110121121221121111111211111202121121221111111011a1111101a1110101011111101111a111101111001111001110102012121211102021b2101b211101221001a1
121011122221a20102220222201222201020221211221111122202202222201111111111a1111011a1111111100111111011a111101111111101111111102222110112221210a1112a021210001111a1
100022122222b11222221212202222212210021121121112111111220111221111111111a1111110a1111101111111110101a111111111111111011111121122202020122111a2211b222202120111a1
111112002202b01222220102021021221220202220221220211200222200211111111111a1111111a1111110111111101111a111101011111110111111012202022212221112b1111a122110221001a0
211012112202b22211012022212222210121202000211002221221202122221100111010a1111111a0111101111111111111a111101111111111111111002211221211112101a0101a102112211111a0
021021101200b22202211012122121102220202221002212100202121000101111111101a1111011a1101101111111110111a011011111110110101111012121212210012111a2202a211220010011a1
112121222222b02221222002220220210222221222212021212110101202101110111111a1011111a0001110111111111110a011111111111011110111011211211110010120a2002a011111210010a1
010221222222b02100101202212222221222220101001111210210212211110101011101a1110111a1100011111110110111a111101111110111111001021112111121112211a1221a111212120101a1
101112102221b00022211212211211102001221220120212000110201110111111111111a1111110a1111100101111111111a011111111111111101111011111220121022221b0021b222222211100a1
121011222212abbabbababbbbabbabaabbaabbaaaabaaaaabbbbaaaaaaabbaaaaaaaaaaaa0011111a1110011111011100110a111111111111111110101022201211221221021b1201b111022121111a1
20111220221112112222221022021201122212121202122212002221112211111111110111111101a1001011111101110011a110111111111001111110122211111122201020a2112b210201111011a1
11122010111222122210122021011121101121211211001120022212112112111111111111101111a1011011111111110111a000001011111111100111111122110212111212a2112a220002111111a1
12220210111010212112221212212110222221101111212021102020010201111111100111110110a1111101111111110110a110111111111011111101111011022211120111b0112a111202201111a1
11220021211121221222022122121112200220121211100021210221021222011011111101110100a1111111111111111011a001111111111011110111112112212011010011P2222b120222121101a1
01220122112100211122111211011202012222020210121022201221111111111111111100101111a0111111111101111101PPPPPPPPPPPPPPPPPPPPPPPPPPPPPPPPPPPPPPPPbP010b110012101111a1
12111222220210210211122222212011122112000211011212201121222000001111101001010101a11111111111110PPPPP111010110111110111111101202220111012210222P10b222102111111a1
02100220111110202110212202202221122222121210121122201011211011100111111111010110aPPPPPPPPPPPPPP111101111011111110011110011121100012211100212212P0a120102110111a1
02202012021120201201220222121220201122220112201220220110120012110011111110111111P11110111101010111111101111110111111101111122102122121212221120P2a211021101100a1
22221112221202221212220101111022012222221201121111222111101120010001111001110111P11111101110111111111010011111110011101111010210022110120022121P0b112211220111a1
21221010000020111002210221120210122211222010111112222222011211101101111111111111P1110100111011111111110011110100110111011010111110000111001010110a111001111100a0
22112101120101110211112122212221202012212220201122222121002210011111101111111111P0010100110111101111111111110111111101111101111111111111111111111a111111111110a1
12112021221121211220221222212222210001212121212221211222022012111101101101111011P1111111111111011111111011111101111111011101111110111111111110111a000001101010a0
21211121112010211212221221112200110120021112112110202211221210111101111111011111P0011111111111111101111101110011111111110111110010011111111010101a111101111111a1
22202210211022121112222212101221011110100111111111101111111111011110010111111111P0101011011011111111111110011010111111111011000111111111110110110a101110111111a1
02222222121210202101212201111121101011111111101111111110111111111111111001011111P1110111111011001011111011101111111011111111111100111110011111110a111111111110a1
01111121212002211202101221022211101111010111110011111111111111101111111111011111P1111101010010111100011111111111011111011111101111111011111111001a111111111111a0
01220212211011110012220020120211111111011111110010101111111111111011011101111001P1111111111111010110111110001111111111101101001111000111110010001a101111101111a1
10220022012112221121222212202220101010110100010111011111101111111111111101111101P1101011100111011011110111111111011111111010111101100111111101111a111111011111a1
22101121201110212120121122221121011011111110111001111110111111101011101011111001P1111111011100011111111010111011110111111101111011101001010111111a111111111110a1
01022211211112122211121222212021101111111101110111111111011111111111011111111101P0111111111101101111111011001111100011110111111111011100011111111a111111111111a1
12211211121212200000012222021211111111111111111011110111101010011011111111011110P1111111111110011101110111011111011111011111111111111111101101110a111110111110a1
02202112120012201122222221122221111101111111101111111111101110011110110101111111P1111110111011101111111111111111111111101111111111011110100111111a111111111111a1
11111010110111111110111111111010101111100111111111111111111011011111101011101101P1101111111111111111111111111111110110011111001101111111111011111a111011000111a1
11111111111111111111110110111111011111011111011111111110011111110100110111011011P1111110111111111101111110111111111101111100111111101110111011111a101100011111a1
10111111111110110111110110111011111101111111101111111110100011111011111011101111P1111111111111111110001001111101101001110110111111111111110111111a111101111111a1
11111111111111111111011010111111100010111111011011101111101011110111111101110010P1011010010111110111111111010111011011101011111111111101111110111a111111011110a1
11111011111111101111011111101111111101110101111110110011111110001111110100011100P1011110101101111011100011010111011111111111111011011010110101011a111001111100a1
11011111111111111110111001111011111001110011111111111111111111001011111111011111P1111011111011111111011110111111111110100100001111111110010111101a010011101010a1
00111011110111111011111101111111110111011111111111110110111001111111110111110101P1110011111111111110111011111111010101001111111101111101110111111a111111111011a0
00101111111101110111110010101011111110101111111111111111111111111111111110111111P1111111100101110111101111111111111110111111101111101111111110111a110011111111a0
11101110110011110011111111111011000110111111111111110110111111111101111101111111P1101010011100111100101111111101111111111100001001001111101110101a111111110111a0
11110100101110111010111101111111010111110111110110111111111011011110111101100011P1111100111100111111111111101001110101111111011101111111001111011a111000111110a0
10111111111111011110110101110111110111111111111110111111111101110111001101110110P0001111111011110011101011110101111011111111100111111100010110111a110101001110a1
10111101111111011110010110111111011011111110101011111110111111110111011100111101P1110111111111101110011101111011101010100011111110110000100111111a101111011101a1
11001111011011110111111111011011011111111111110111101111111111111011101100101010P1111010111110111011110111000111111111111110101001111101011100111a110111111111a1
10110101111111111101001111111111101011111111111001110011111111111111111110101111P1010101111111101101111011101110111100111111101111011111111111111a111111101111a1
11110111111111111111010110110110101100101111010101111111111110111101111010101111P1001110110111111111111110101111101111111111111111110101111111101a101111111100a0
11111111111101011101111110011011111011110100111111111011111101011010111111110101P1111011111111110111111111101111110011111111111110111011111111111a111111111111a1
10111110110111110111010111111011011011110111111011111111111101011111111101111111P0101111110111111111111010111011111110111011011010110011111111111a111010111101a1
11101111110110111111111110111101111111111111011101111110111111111111101110011111P1101111111111101111111110011111111110111011111011111111111110111a111111111111a0
01011110110111111111111111111101001111111101100110101111111111111011101111110111P1111111100111000011111111111111110110111111110101111111101000111a001111111011a1
10011011110010011111111111111101111101111011111111001111111011111111111111101110P1110110011111011111110111011011111011011011110111111110110100011a111111011100a1
01111111111111111011110101111111010111111111111111111111010111111111111110111111P0101111101110111011101110111111011100011111111011111010111110111a101111111010a0
01111110101111111010111111110110111111111111111111111111010111010110111101110011P1111110101111111111001110111111011111111011111011111100111111111a111111111011a1
aaaaaaaaaaaaaaPPPPPPPPPPPPPPPPPPPPPPPPPPPPPPPPPPPPPPPPPPPPPPPPPPPPPPPPPPPPPPPPPPa1110011111100101011101111111101110111011111011011011111111111111a111101110101a1
1110011110111P11111111111110111110111101111111011111111111110110111001111110111111111111111000011111101111011011101101111011111111110111011101101a110011111111a1
0111110111111P11111100111011111111111111101111111111111111111011111111101111111101011101101101111011111101111111111110111100111110111111101111111a111101110111a1
1101111111111P11112212221110111222101211012221111110001111110110111110011101011011110101111111110111011111101111100111001111101111111111101101101a111111100011a1
1111111111111P01021001021012210022212022212210111111101111111011001111111101001111111110110110111111110111101110111101101011111111101111111111001a001111101111a0
1111001101111P11001111121211221021122010021122101110111101110011111101111101111111111111110111101010110011111111010100111011111110011111100111010a011111100111a1
1111111111110P11221221111210102112012102201101111000111111011111111111111101111111101011111111111011110111101101111101111111101101101110000111101a111111111111a1
1110110111111P11222112012211100020111201222122111100111101101011111111101111011111011101110110111111111111001111111101110101111110111101111011111a111111111111a1
1011011111111P01021011200112112212100102011210110100100001111111111101111111011111111111111111111111110111101111111111111111111111110010101110111a111111111111a1
1011101111101P01122111121212011212220110202102210011110111111111111111111111101011111111111111111111110011111111111110111111111111111111101111111a111110111111a1
1010101111111P11221111010122221111002121012022210011101111110010111011110111111101100011101011110011000110111110011111111111111111111010101110011a111010111101a1
1110111101111P01212222102121122121220221221112111110111111111111111111101111111111011111111001011111111011111011111100101011111110100111111111011a111001001101a1
1111111110110P11011221220012021012111001222221201011011111111111011111111001111011101111111101111011111111111111101111111111111110111111101111111a111111111001a1
111110111101P011122112200212021212222110111120111111111011111101110110111110111111111111111011111100111111111100110111110111110011110111101111111a111111111111a1
001111111111P111201211001222210120211020222022201111111111101011111111110010111111010101001111111111111111100101111111111111011111101111011100011a101111101101a1
011111111111P111210211120221122011022101202212101111110011111111011110111110011011111111011111111111111111011112011222122210102211221211220001111a110000111111a1
111110111110P111101221020220110121222200200012211110111110100111011101011110111111000111111111111111111011111110121120222112111110001211001121111a011011101101a1
11101110101P0111212212122102121222122210021021211100010111111100111111111100101111101100111111101111101100110021222112222222212022112221222101111a111101101111a1
1111111011P01111100021211022221122022221202111210111111101011100111011110101111111111111110101111111110111111112222222020012111122112112201111011a100111111111a1
1010111111P11011111121021111101121022210121222110111111111111111111110111110100110111111111111111111111101110000111222120221021120021020102111111a111110010101a1
000110111P011111111211100220221010222222222210210110101111101011111110100111111111101011011111010111110111111122122212111001011212212002021011110a011111110111a1
111101111P111110211011112001220210122222122211210001111101110101111111110011110011111001101010111111011111111122210211200200102111101121122221111a101111011111a1
111011111P100111112011112112102112220102122210101111111111101011111110111111101011111001101010111111111101000011012110210022101211121220121110111a111110101111a1
111111101P011101012221011221212212211211110202111011110111011111101111011110101101111011111111011111111111111112112212101012212222101112221121101a011111110111a1
111111111P111101121211211012122201121122101101010111101111111111111111111011111111111011111111111110111100111122211022110202111222021021100210010a111111101100a1
110110011P110111012012121002101202121211121221111111101101111111111111111111111111101111111111111001001111100121212122112202201021222120212121011a111101111011a0
011111111P111100012101202121121002202120100110111111111111111111101101011111011111111111010011111111111111111012011120112201200221212111120110110a111111111111a1
111111101P111111122220100120220220121121121222111111101100110111111100111111110111111111110110111111101010110120111201122122220211112212121011010a111111111111a1
111001111P111111012201121001211222112202111212001111111110001001111111100011110111101101011101101111111001101100020102102212212021211220221210111a010111111001a0
111100101P111111221122102220222122020021102112111111111101011000101110111110111111001101011111110111111101001121011012101210111201121112222110011a110111101010a1
111110010P110001221120011221210011211212221121101101011111111111101111111111101010111101111111011111111101111112211010111211212011222022112001111a011011111111a1
10011110P0011111112001220211022121112021102201111001001111110111111111111111100111111111110110111010100110111101121202122112221211021222222120101a110111011111a1
1011011111111110212221112211022102201212222102011111011000111011111000111011110101111101110110111101010111111122012212002210122011210221112111111a111101101001a1
1111110101101011221220222111212221010002122222211111111111111111011001111111111100111111011011101111111101111120102011122222221122102222112211111a001110111111a1
1011111111110101111110111111111110111111101110101111111111011111001111111010111111001111111111001011011111101110122210212111102122212111112201111a011111111111a1
