11 112
157 33
22 23
138 34
46 38
18 4
125 115
31 103
80 5
1 47

110221212201021001102112120121121011111a11111111101101011111a1111021121011121022202220022212022111111111101110111110111111111110010011a0111110111111101111101011
100012120121212121102221111211120111111a11100101111111111011a1111212201111111121110020102222102001111101110110111111111111101111111101a1001111111011111100011111
111122222211211202210011221020212211111a11011111011111011111a1111222022221020110220011100200022111011111111111011111001101110111011111a1100011101111111110111011
011021200111210011221210020222222111111a01111111111001011111a1110002121222211121221221222111221111111010111111111111111111110111111111a1011111111111111101111101
101111102001202010102111110110122111110a01111110111111010001a0010222201220112212122122202201212111111110100111111110101110010111111111a1011110111111111101111111
111122112011101110212120222210112111111a11110111100111110111a0111120222022001201012021121111122111100111010111101101110111100011111101a1111111110111111111111111
111121210102122112101021112220100111101a11111101011111100011a1111121000212022121112121211201022211100111011110101100111111111111111101a0111111111111101011111111
111020111102211012122220121011010111111a11011111110111111111a1101120102211021120120221101212100001101111101011111111110011111110011101a1110011011100111101111111
111111222222222222201101122222121212220a11110110101111111111a1101101221211121022121212121111002211111111111111111111111111111110111101a1110011111011011101011111
111220122222020201122202122202002111221a11111111111111111111a1001211211120022111211011210122212010111000111111010111011111101110111111a1111110110110111111111111
101020122212220011022012210010221211021a11111111111101110010a1111012222111122110122110012221212110111111101110101111101111111111111001a1011101110011110111001111
101110210022112211220012200212020100220a10100010111010101110a1111222221122211220012221112222112211111111110101111100110010111011101111a1111111111111111111011011
111211022210211200202121210210202101101a00011011011111111001a0111202211201222220010221101012201210101110101111101100101111100110101110a1011111011101111111100011
111112222222202202101112222222221211121a10011111111100011111a1111111022221112020202211212102122111111111111111111010111011010111111111a1111011001111011001110011
111201021201100200222112102222222201120a10111111111101111101a1101112220022212212121212211111221010111111001111111111101111000111101111a1111111110111101111110111
111121112222202220222202221022122222110a11111001111111111110a1111120022121122202111212212212120201101111111111110111011111100011111101a1111111101101011111111111
111011122202222222121200222112222210220a11011111111111111111a0111221210022112110100221200121202211111111111110111111111111011101111111a0111110111010110111111111
111221211222122111222221222212122220211a11001101111111111111a1111120222221220102211001212102101010011110111011111111101111110111011111a1111111111111111111101111
111122122122020022010112022022210022101a11111101111111011101a0111211222221211210122011211211201111111111010100111111111111110101111010a1111111101111111111110111
111201222222220220222222202202221201221a11110111101111111110a0101000212122221001021121122202120111111101111111011111010111121120112111a1121012221102021211110111
000221121202222022120212122122221201011a10101011111110101011a1110111112221001022200121121111112111111101111011111101111111021011211021b2200222111021212221110111
111021222221212222120201222100200222220a11111111111111011011a1111122111222212212211012112212112211111010111101101111111001110111221012a2022100121020202022111011
111221122001120220002221022122122222020a11101111111110110111a1111122211101212100012220121211210211111111111111111110101101111120011121b1122120110121222012011111
111111000121202022221222221112022210222b10220211012111211020a1111122100210012212202112101122021101111111101111111110111111002121221102b2011022112221212212010111
111212222000212202102012222201120022220b12112011112210111011a2111201222111110021201222011210002110011111100111111111111111112112110221b2021120111121221102110111
111011120210222022222222122222221222200a02002021122112111202a2101121111201212001111221112121221111111110111001111011111111011020022201b0112002102100121122111111
100201022011222102221212122222222222211b01202021122212112201a2001002220202001202010022110022211111111111110111111111011111012212211020a0111211221001211121111111
110221112000112022021222122010102222211a11112111121120112111a1110210111111211220112011212122111200111111101010011111010111120120222111a0112111211111222110111101
111110222012210122222202121221220222201b21111221212121012022a0011112111121021211221212121122111001101110111110111101111001012221110201b2222220222011111022000111
111211122221222201020220212221202221221a21220212112120222121a1110011122202001212221020210120201211111011101101111111111011110011212210b0112112121220211121100101
111211022212200020001022021002222200211a21021120111102210011b1111222222222012120212212022110012111111111101111111101110111112220210222b1121222112211101222100111
110111110202220101202202121211112222100a00102112121121221012b0101111111001111111011111111111111111101111111111101111110111111221201012b2110111111222211101111111
011210220212222220022201222022221200201b22112101012221110112b1111111101011011111111111111111111111011010111111110000011111120221102211a2212022221202111021111011
022212221222221221212221221220222220221b22002111121010221222b0111101010101110110111110111111011111111111111111011011100011121111121121a1120021010022211112111110
102200122212222202112222011201202211102a11200111112222211211a0101111110111110111111111010111111011110111111111111111110111110201122112a0022120211112222121111100
120121111210221221002222222120102222212a11121100211122012111a2101110111111011111011111111011011110011111111111111111011111112121111101a2021121211211010102111011
112120201222211000122200121012220222222a12110112110121122222a1110101111111100111111100101011111011011110011111110111110011120120210112a2212222122220211021111111
101011122222212101212222221110222210221b11021011222102022222b2111110111011111100101111011111110111111110101110111111111100111102112221b2001200122111212010111111
021122002202221020221220121211212220002b02100121210212111211b1110111111111111011111011111111111111011111110111111101001111121211211221b2212111222220201212111111
202012122020002121022000202121211202001b20121122212121012102a0111110101111011110111111010111010101110110111111110111111111121112222102a2121022210221121121100111
012121111111000122112111020212222212201a22111011020012112122a2111111111110111111111111111111110101110011111111101110111101001112111111b1021220112120022202011000
120202112221112112112111121221202121122b20122112122102222122b1111111111111101110100111011110111001011011111111111111111101122120102002b1100211112220111100111111
211100001011021121100112221212122011211a11021202012121212212b2111100111111100111011111111111111111011111011111111011011111021222111022b0121021111002101121111111
111211201112212120212021210010122211222a10002121211121221212a1111110100111110111111111110111111001100101101111111101111111122222101111a2122112100121212110110111
100210200222101121011122211012211101122b20221210122212200022b2111111011110011111111111111111011100101111110110111111110111101002220012a1111121002111222222010110
201122221110111211220011212111210212210a12202220222222212102a1110011111111111111111111110111101011100011101111101111101101110121210120a1211202202021120221010110
012100211112110102121021122212010201012a12101101202212212222b2101010011111110110011011111111111110011111111011111101111111022102121110b2111020101011100111100011
212202221000212012112202111110010011111a11121012121212021100b2011111111101111111111111111111111111111111110111110111111111110221102221b2212111121121021212111111
211221211022101212112121020121111222022a10210221101011212210b1111111011110011111111111111010111110111110001111100101010111012211012121a2111112101121111121111011
022200112022211012201001211111121122110a12022202121212121212a2011111111111110111111110111111111111110111001111111111111111111001200021a1222021112201111122110101
112110011212012222112200012112202201122b12211120121222222102a2111111111111111011111111111101011011111011011111111011111011101111110111a1101111111110010011111111
202212110021201201022212020111222121111a02222111111112111211b0111101111110101111101111111111101111001111001101101111111110111110111111a1000101111111111111111111
221222101222022121221122020121210122010b22110112110111112122b0001110111101110111111101011111110011111111111111111110111111100111111101a1111110111111111111111101
222211222211020112222200111012122112211b12111021212210122212b1011111111100111111111110111111111011111000111111111100111111010111011101a1111110111111101111111010
112021111111122202010121211221201110101a11111011011111101111a1111111111100011111111110110111111111111101111111101101110101011111001111a1011111111111111101011111
122210211121211120121121201100201111101a11010101111111111011a1001111110001110111001111111111111110111001111111110111111111101011111111a1111100111010011111101111
021122212221212220020102021212211111101a11111111111110110100a1101001111001011110110100111111110111111111001111101110011111011111011111a1011101111111101111111001
222212122112110201112122002222210111110a10111111011011111111a1011110001111101111111111111111011111111101111101101101111111111111111111a0111111111111100100111111
100211002222212011201122221211111111100a10110111111011111111a1111011101100110011111111101110001101111111110101111101111101111111111011a1111101111111111101110111
111111120101021111101211000020111101111a00110111110111101111a01111111111aaaaaaaaaaaaaaaaaaaaaaaaaaaaaaaaaaaaaaaaa111011110111011111110a1111111111101111111111111
202120112222110121011211121222201111111a10010100111110111111a11111111010a111111111101111101111101111110111111100a100111011110111110111a1111111011111111011011001
101020002221111222201021102211011111111a01100111111101110101a01111111001a111101111111111111011110101111111111111a111111111100011111111a1110111111111111011011011
211211200221200101220021202211210111110a11101111111011111110a01101111111a011010111111011011111010111011111111101a011111110110010111111a0011011111111111101111110
111111111111111111011111101111101011101a01001110111110110011a10101100101a111111111110101110111011111111111111111a111111101110110111010a1111001110111100111011111
111101111100111111010111001111111101110a00001111111111101100a11111111111a111111111101101011111110101111001011011a101110011111101100100a1111011111111111111111111
110111101111111111110010001111111011001a11111111110111111011a11111111111a111111100111111101010011111101111110011a101101101111111110101a1110001111111111110111111
111111111010111110111111111101011111110a11101111111111111111a10111111110a111100111111111111111100111111111110101a110111111100111011111a1111100100101111111011111
111111011111110101101011011111111111111a11111111001110111111a00111111000a111111111011111011011111111111111100111a110111110111011111110a1111111101110100101110111
110101001111101110111101001001111110111a00010101111111111010a10110110111a111001111011111111011111110111001111110a110011111101111111111a1111111111011101110101101
110111111011110111111111101110011111001a01111111111101111111a11110111111a111111101111111011111110111111111100011a110110111101111011111a1111111111001111011101010
010101110011111011111110110011011011101a11011001111111010111a11000100111a111011011111110110111011111111010111111a110110111111100001101a1011111111101111111101001
101111101011111110101101111011111110111a11101001111001111000a01111001101a111011111111101001000011111111111110111a111101111111001111011a1111011101111010101111011
111111101111011111111011111111111111011a10110111111111111111a11111101111a111111111111100111111111111011111111111a101101111111101101111a1011111111111101111111111
110111111011011101111111111111101111111a01111111111111110111a11110111110a111111111111111111111111011111101111111a111011011010010111001a1101111111110111111110011
110110111110001111111111111101011101010a11111111110111011011a11111111010a101111101110101111110111101111110111101a010100111011001011111a1110101111011010110101101
111110111101111111111111111111111111100a11101011111011111111a11110110110a111011111111110010100111111011111111111a111101110111111100111a1111111111111011111100111
111011101111011100111111111111011110110a11111111001111111111a11111111011a111011111111110111111111001101111101111a110110111011111111110a1111110111101001111110110
111111111000111111111110111011111111101a11001111111011111111a10010111110a111111111101111111100110111111111011111a111111111111101111010a1111111011111111011110011
111011110100111100110111111111110110101a11111111111111111101a11101100111a111010111111111111110111110101111111111a111110110110111111110a1111111001111110111111110
101001111001111101111110111111111101101a11111100100111010011a11111111111a1111111101111100101aaaaaaaaaaaaaaaaaaaaa111010111010000010101a1101111101111111111110111
aaaaaaaaaaaaaaaaaaaaaaaaaaaaaaaaaaaaaaaa11111111111111111101a10111001111a1011111111111111111a11011111111111111110011101101111111001110a1111100110011011111010111
101111011010011111111110111110111111011101111101011111111111a11110101011a1011111101111011111a11111110101111110111111011111101111001111a1111000111111111100111110
110111111100111111111110111110111110111111111001111011001111a11101111111a1110111111101110111a01011111110011110011011111111011111111011a0111111111011111111011110
111111111111101011111111111111111111111111010111110111001110a10011111101a1111111110111111011a10111111011110011111001000111111111011111a0111101101101111111011111
011110111001101111111111110111111101111111100001111001111110a11111111011a1111111110111111111a11111111111111010110111111010111111111111a0111101101111111101111101
101111111111111111110111011111111111100111111110011111011111a01111111111a0111101111100011100a10100110110101101111111111111111101100111a1110100111100111111101111
111111110000011110110011110111111110111111111010110100100111a11001111111a1111011001111111111a01110111111001101111110111011110111101010a1011110111101111111111110
111111111111101111111110011111110111111111111011111110111110a11111111001a1111110111011110111a11111111111101111111110110111111100101101a0101101111110110111111111
aaaaaaaaaaaaaaaaababbbabbbbbbababbbbaaaba2120121111111011110a00001111011a1111011110111110100a11010111110111111011110111011111111101111a1111101011100111101111111
0010110101111111220221122110100020221112b2111221111110011111a11111101100a1110111101011011010a11111110111111011111111110111101101101111a1111111101111010111111110
1111010111111111120221212212122022211120b1120111111111110111a11110111110a1111111111111110011a01001011101111111100101111111111110101111a1110111111111111111101111
1111111011111111111221121122220220211011a1210111011101111101a10111111110a1110111111110111111a11111100111111111111111110001111110111110a1011111111111111111011101
0001111111111111022021110021021110211121a1211110111011111100a11111110110a0111101111111101101a11101111111111111111001111111101111110111a0111111101101010111110111
1101111110011101122221121211111002101111a2012101111011111110a11111101111a1110101111110101111a01011111001110111111110101010011111111110a1111101111111111011101011
1111111111111011022202121212200022110022a1202021110111011111a11101101101a1010100111011111111a10111111111111101111101101101010111111110a1100001101110110111111111
1111101100011001011110201211200201212111b2110220111111011111a11111111111a1101111111111111110a11101111110011111011111100111111111011010a1001111111011011111110101
1111111111111111221002120221220212102112b1222111111101101111a11110110011a0110101001100100011a11010111011111101010111111111111011110111a1111111111111011111111111
1111111111110111221122211101201221111201b1220221111110111011a11111111111a1101101111110111111a11101010111111101111110011001111111111111a1011111111111111111011110
1111100111110010122111100211102222021010a2121120110110101011a11111111111a1111111011101111001a11111001111001111011111111111110111100111a0101111110101111101101111
1111111111111100112022020222121101222222b0122221010111111111a11111111101a0011101111110100110a10001111111111010111011111111110011111101a0010101001111111111110110
0111011111100101210222220212200220222111b2222201010111111111a01111101001a1110101111110111010a11111111011100001111100112222210111202201b1122111111111111111101100
1111111111111111122202002120112102200221a2201101111011110111a11111101111a1111110111001111111a10111111111111011212111112212112221111222b0112211001111011110101101
1111111111111011121110101212211211111211b2111110111111111011a11111111110a1111101101111110111a11101111111111110110111212112122210012210a1202211111111101100101111
1101110111110110122121021111021210121201a1212121111110101001a01111001111a1111101111111111111a11110101111111111020212111112222111112112a2201101111110110111100111
1111110110101111212121122020112212222220a2221211100110111101a10111011010a1011001111111111011a11111111011110111110022201012222002112220b2101211111010111111101110
1111101011111101020210212010212220112022b1121121011111110111a10111111111a1111111111111111101a11111011111111101210002220222222212212212b2200121111111111111111011
1111110111111111020010021021202001212212a1110121111110111111a00011111111a0111111111110111111a11011111111111101012112121012120102022112a2122111111111111111111001
1111110101111111102212111211022110211220b2210121101111111111a01011101011a1111101011111111110a11111111111111111212111102220121112020112b2222121001011111110101111
0111111111111111111100110210021011111011aabbaaaaaaaaaaaaaaaaa11101100111a1111000101110111110a11101111111100110110122221111210210001222a0121021111111111001111111
111110111111101111211011222102101210222201222111111111100101111011011010a0111101111111101110a01111111111011111211201101022211122111000a2000021011111111101111111
111110111110010111220201202111122110202120222121111111111011111111111111a1111010011011101101a11110101111111100222121212211121002222210a2100111111111111111100111
111111010101111020022221001202122111121011022201011111110110101011111111a1011011110111011011a11000011111010111000122100122211122111210a0102221111111111110111010
110100110110100001222101211020212221012210120110111111011110111001110111a1110111111010111101a11111111110111111111122200120221110021221b1221121110101111111111111
110111101111111112211220112212200121201110200011010111111111111111011110a0101101011101111011a10110100111111011021220011221222212212022b2220221111011011111111111
011001100111111111110212011011022210210211111011111011111001110110111111a0111100111111110111a10101110101111011120221200120222010022012b0111121011111011111101011
011111100111011121211122121120021111222201212111111111111111111111111011a1101111100110111011a11111110101111111111121200111222211022220b1220021111111110111011111
111111111111101021000102121211001112222021112211110110101111011111111011a1110110111111100110a11010011110111001201222222211112121002200a1211120111110011100101101
100011101101111101121211221122201211221222122210101110111101111111011111a1111111101111110111a10110111111111111011100222222121212020111a0200010111111011011111111
111111111001110101122121200211112211120001111121111111111110111111111111a1111101101111111111a01100101101111110201212111212020102012102b0112121101111111111111101
111111111111111111101010111101011101111011011100010111110011011111101111a1101111011111111111a11011111111111111002002012001202220211222b1210201011111111111111101
