11 112
157 33
22 23
138 34
46 38
18 4
125 115
31 103
80 5
1 47

01122212122211210111120a21201112210101101111111a1111011111111111100011222122112011222012122112211111011110111011110000110111111111111010111011111101011110111110
11122212112110110110222b11121201001101110110111a1111111111111011112121212112001120011121111211111111110111101111111111111111110111111111111011011111010110111010
11121112210100220110011a12221020110111111111111a1111111101110011111221122010022021202022011120201111111111111110111110111111111011110111111111011000111111011111
11120212122111222121110a01220221011011101111111a1101101111111011112101202220121200121201220112121111011111101110100110111111001111111110111111111000111110011100
11121202221212201212000a21212121110111111111111a0110111111111111112111200020021211012111211122111111111111111111111111111111111111101111111110111101111011111111
11110011200212111101122b12211211011111101111111a1111111111101110121210111211212211111211122201111011011111110111111101111111111110111111110011111111111011111111
11111201010212222011120b11122111221111111111011a1111111011110110021120120112222220201112121120211111111111111111111111101011111000111111111011111111110111001111
11112211102212202011201b21220120101110101101111a1100111111101110111221101210121211210112102012211101111110110111101111011101100111111111111101010110011111001111
11102002202102222222222a11221220102110111111111a0001111111111111121002212112222212211111221002111011111011010111111111101111101011011111111001110111111111100101
01111002002220102210211b22202222222110101110011a0110111110111111121210211221221120222211002002111111110111111010101110111111111111011101100111101111011110111101
11111222012202022102220b10221201211212110111110a1111111111110101021112202222111121001110022220221110110111011111011111101101011110111111111101011111111111111110
11021212122022202222102b22212220221022111011101a1110101111111110120121121112120120221221211220121111111111111100101111001011110100011111101011111111111111110000
01120122222112222221122b12121202221121101010101a1111111111010111110010212201121012202201110112121110010111010100111001011111111111011010111111100111111111111011
11100220202200201212202a21020210222120111111111a1111111111110101121111122101221222212202120211211111111111111110111110101110100111101010011111111111111110111011
11112202120222220122212b02212112002210111101111a1011111011111111112122121102011211112122102120221111111110001111111000110001011101011010111101101101101111001111
11101022000201222210212a22220222210112010011111a1111111111011001012211221221102012212222121022211110111111101111111011110111111111111111111101010111111101101101
11121022011222212202200a20120221000012111111111a1110111111111111002110111122211212100101122221101111101101110111011110010111011010101111111111111111111111111110
11122222102212222222200a12200222212022101111011a1111111111011100102121211222222022111000212221111111111011110110111110111111101101001111111100111101101111111111
11122202022022220222222a22222220010111111001111a0111111011111111122122211121011111100121201211121011111111111111101011101101101111101111111001011111111111111110
11112022002222221021012a12021001202211110101110aaaaaaaaaaaaaaaaaabaaabbaababaaabbbaabaaa2112012110111111111001111100110100001202022110101110122022100221221110aa
10102222201222220212021b222010220101121011011011111111011101011100122210102021202010112a2221222111110111011110100111111111120210100002221111121012210210220111a1
11112120222222200222220b212120222020221101001111111111111111111111102220110102112211212b1120111211010110011111111111111110110202220202101022120112112110011111a1
10101222220020211122202b122122212212020110010011011111110110111111222022202201012212212b1111111200101000111111111111111111121122001011211010222012221110010111a0
11112012221212112200222b102220220210221212211112011100112221021112022212022120111201020b2200212211011001111111111111011111120201100121201212122101120010121111a0
11120210212022222202201b001200022022000212212122221202101200100111222200101001021201212a1121202000111111111111011111101100022212010112021202011201222201021111a1
11102202202220222122212a202222022200221121212021102220020101211001122211222210011012102a1012112111111111111111111111010111100211112112222122121010222001221111a1
11111101201222212212212a222222202021222020211021012000121122111110221112202222121101110b1200212210011011111110111010011011111012021211120012112012011122211101a1
11101220221120021222202b220022002222110122021211112112112111111111121111101022221222212a2110220111111011111110111001011111120121221201222100221010120121221111a1
01121222122022020211222b222022222020201212220112121211221212121101001211101112001021111a2022220111011011111111111001100111110212201111221121111111112022121111a0
10112120221222212020200a012120202010221202221222212121211111220011202221122100001201210b1220121111110010101110111111110010111222022212121011212000212010211111a1
00110222202202000022122a120222022010200012112012022102221201120012220122122002122211211b2120212211011111111111101101101110022122111211212101121202212222211101a1
10101111011110121102200a212210122202222112211112112012121121101001111011111011110011001a1111011101111100111111100111111101110202112212201112211122010202211011a1
21221022211222122212102b200220221210221221200111112120202202221101111111011110110111111a1111111011110111101110101111110101121221021102121010222201212212220111a1
21001112202222010211201a021120221222222211112022111120222120221111100011111111111011111a011011101111110101001111111111111111202121112220111211001002122222111Pa1
02011212011222200201222b202210222112121122212222112021001211121101110011111001111111111a0111011010111110111111101111111101111222120101111011122111122021011111P1
21121111011020202102012b122212122220222211110212110221102201111011111101111101111011111a1100011111111111111111011111110011111112220222212012022102110121121101P1
21222002212102110022210a022222222222121210121220121022120122210011101011101110111010111a1111111000011110111100111001110011122202122002200201122112222100221111P1
22111200220222200021221a202212220102201120120112221011121022020111111110111011100111001a0111111111101011110111111011101110122221121021211022111211001212021010P1
01222110222212210211220b022021212212020012220112222211201122100111110111111111111111010a1111111111111111101100011110111111101121011110211022111012120112111010P1
11202112211101200112222b211212111121111211212020102111020212011111011111101011110111011aaaaaaaaaaaaaaaaaaaaaaaaaaaaaaaaaaaaaaaaa221021222111121022121222101101P1
12121101120122222221212baaabbbaaaaaabaabbaaa21202201001121111211111101111010111111101111101011111111111111110111011110111100110a211002112222112102122021010110P0
0221211100121222210110111111122211111212212a02001222121122221101100101111111011111111011111111111111111111111111111011011111011b002222112100121222120121220111P0
1222212221121121111021111001110121011022112a20021022021121111211111111111111101111111110101111111111110110001111111011110112121b210201221211211200111122011111P1
1110222012210111221122202202111001221122001a11121111221021222201011110011110011011111011110111011111101111111101111001010102020b112111211121220121212102120111P1
1211212112121001020111211202111101201121201b12112022121211101211011110111111111111101011111111110111110111001111011111111012211a011111211220202202012111011111P0
2022221101122122111001122021110210122201102a22112121210121211210111111111111110110100110101011111110111111111011110111110112222b112122210211121022022022220111P1
0222210021112122221112012221212111111212120a22021221202111212211101011011111110111110111101101111001111111111111101111111110112a212212112202100112002020221111P1
1222001211111221122201112021212221112121221b20220212211122112011110111111111110111111111111111111111110111011110111111110111221a122101120221021021111111011111P1
2221111120221212221122022001121211111001012b22100112210202222111011101111011101111111111011111111111100101111111111111111110211b221122221111211011212010111011P1
1011212112102220121220002110112112022002101a21100101012122211111111110101111110111111110011111100111101100111111111111111112012a222112200222220211222210011111P1
2112222211222021111122101122211112202210022a11112010011002220111111011111110110111111001110110111101110110101011110011011100111a010111111010111110111011011111P1
0022122212221101021212211111112122111221221a12122102110021122111111111011111010100111010100111111111111111111111111111101011111a01111111111111111101011PPPPPPPa1
1101222221112221101222112222112112220100120a00021010220021121211111111110111011111111111100111010111110101111111111101111101101a11111110111001100111PPP0110011a0
1102110112221021120012212122222221201011122b12200201201211111111001111111110110111010010111111011110111101101011010101111011111a111111011111111PPPPP0110011111a1
2210212220011201022120021202122011101110111a11111111111101101101010101111111111101111011011111110001101111111010010111011011000a11011111111PPPP011111101011110a1
1012201111212211011212112122212100111111111a11011111111011111101111111011011111111111101110111100111111111001111110101111111001a0001101011P0111010111111111110a1
2202220112121222202121212120212110111110110a01110111101111111100111111111101111111111111111111011111110110110111111111111111111aPPPPPPPPPP10111111111101111011a1
1021021202012211122101112222120111110111111a11011111110110111101011101011101100111111011111110011111111111101111111100111011011P111111101111001111001110111111a1
2111221000120112111012112211111101111011011a11111110011101111111110100001111111101010111111111110111111011111111111111011111111P111111111110111111111010111101a1
0201021122221011101220111021221111111100111a10110111111110101101101111110111111111101110111111011111110111000111101101011111111P111011111001111111111111110111a1
1211120022212222222211111211212111011111111a11111111000101111110110011101101111111111011011111011110111111110111111111011011111P011111111011111111111111111101a0
2121112000110121112222222002110111100110011a11111111101111111111111111111101111111111111111101111101111110111100111111111101111P011111111111111110111111111100a1
1101010222212102011112121021111011011011101a00111111110111111010111111011011100111110111011011011101110101111111010101011110100P010111111110111101111110101111a1
1011101111111010000111101110111110111111110a11111111111111110111001111110111110111111111101010111101101111111110110111101010110P011101011110011111110011101101a1
1011100011111111100111111111111101101010011a01111111011111101011111111111000111111111010001011111100011111111111011111111111111P111111011111110001011111101110a1
1111100111011111111111110111011110101100111a11010111111111101111111110111100011111111011111011101111111111110111011111111111100P101111111101110111111011110101a1
1101110001111111111111110110111001011101101a11111111111111010111111110111111101111111110111111011101111010111111010011011111111P111101111011101111111111110111a1
1110111000111011110110110111110111110111111a11101111011111111101110111111111111111101111111111011111111110101111111011111111110P100111111100110110110111101111a1
1010111100011110111110111110011001111011111a11111110111111011011011110110111011111111111110101111101110111111111110010110010111P001111111111110111111001111111a1
1110110111111111111111110111111111001111100a01110110111011111111111110101101111111101111001100111111111111011100111110111111011P101111110011111111011101111111a1
1101110111111101111111110101001011111011111a10111110111111011111111011111111110111110011011111110111100111101111111011111011010P101010111110111011111010011111a1
1111101111101111111111111110111101101011011a11011110001111110111111111111111110111111111111111100011111111111000111001111100111P101110111111111011111111000111a0
1111011011110011101101110011111101101011010a01011011111011111111111111111010111111110111111111111111110101111111011101111111110P011110111011111111101110111110a1
0110111111111101111011111111010100110111111a11111000010011011111111011110001111110111110111111101111111001111011110011111011010P011011110111111111111000111111a1
1011101101111111111111110111111111110111101a10010111111110010101111101111111111111011110101111111110001111111011111111111111101P111011111111111111110100111111a0
1111111111110111111110111111111111110011111a10101111111111110111011111111101101111001111111101101111101011111101111111111110111P001111110010011111111111100111a1
1111101011111111111111110111111111111110101a11011011011111111111111111111111111011111111001111101111111111100101001111111110111P111110011111011001111110110101a1
1110101111011111111111101111111110110111111a10111111011101111101111111111111111111111111001111011011111111110111111111111111111P111111111101011011110111110011a1
0110001010111111111110111111111111011111111a10101101111011011110111111111111011110011100011111111011111101111111111110111111101P001111001110110101011111101001a0
1111110111110001110110111111101111111010111a10111111011111111101011001101111111101111110111111111111100111011111101110111111100P111010111101110111101110111010a1
aaaaaaaaaaaaaaaaaaaaaaaaaaaaaaaaaaaaaaaaaaaa11111111111101111010011110111101101110011111111111111111111111111101001001110111011P111111111011111111110111111010a0
1111111011011001111111110101110110001110111111111111001111101110011111111110111110111110110111100011011101111111111011100111110P011111111011111111111111110111a0
1110111111111111111111111111111111110110111011100111011011110111101111110110111111111111001111111111111111011111110110111111111P101111011111011011011111001111a1
1111111111111101110101111111111011111111110111111011111111111011111111111111111101111111001111111111111101111111110011011011111P110001111110110111111110111111a1
1111011001110111011101111111111101111011001111111110011011111111101111111111111101110111000111111111111101100110111110111PPPPPPa111111111101111111110111111110a1
1111111111111101111111111101011100111101010101111110100110101111111011111111110100011101011111011101100PPPPPPPPPPPPPPPPPP010101a111111101011101111111111111001a1
1111111111011111111111111010111110111111aPPPPPPPPPPPPPPPPPPPPPPPPPPPPPPPPPPPPPPPPPPPPPPPPPPPPPPPPPPPPPP011101110111111011111111a101101111011110111111111011110a1
1111111111101101110001111101111111011111P101111111111111111011101111111111101111a0111111111111101100111111111011110111110101111a101010111111111110111111011101a1
1111001110110111101100101121221222112121P201221011110110001101101011001110111101a1001010000111101110111111001111110111011011111a010111111011001111111111011111a1
1100110111111101211210122211112212200002P112202110111101101111111111110110110101a1111010101111111111111111111110001111011110111a011111111111110011000011111100a0
0110111111011011111002101201220121112111P211220111111110111101111110011101101111a0111111011111000101011100011111101111111111111a111111010011101011111111111111a0
1111111111101111020110212221012122111121P112112111111111101111111111111111100111a1111111111011110111111110011110011111111111111a101110111111111111110110111001a1
1011111111011101121120100122200110111221P002010110010111111111011101111111111111a1111110111111111101111111111100111001111111111a011111111011101111101111111101a1
0111111111011011022011200121012221112112P212102111110111110111110111011110111011a1110101011101101111101011011111101111111011111a111011111101101111101111001111a1
0111111111010011011211002210102111002220P211121111011011011110111111111111111111a1110111111111101111101111111111111111111101110a111111001101111111110101111111a0
1011110111111111122212100212102102101101P212122111111111011111111010111111001101a1111011111111111111111111011110110111101111101a111110111111011011111111111111a1
1101111111101111211221201121001121121221P021212111111111111111011111111011111011a0111101111111111011011011111101111111110101111a111111111111111111111111110010a1
1101111110111001112202012202211110001102P110220000011100111110111111111011110111a1101101111111101111101111101111111111111111011a111101110001111111001111110101a1
0111011010011111022112012122110221222021P122211111001111111111111111111111001001a1111111110011010111111011111011110111111110011a111101101111111010011111111111a1
1011101111111111211120111012111020112201P112110111101011111110111011001111111011a1011101111111111111011111011000111110111101101a111111111110111101110101011111a1
1010111110111100012221211222220100010211P122011011111011111111111111100111111110a1101111011110111111111011101112021120021222121a020102120120110111111111011110a1
1110110111011111121210211111112120201012P222001111101011011111111111010111011111a0101111101111101010011111110122222111112001121a121020021120211011001111011101a0
1111111110011011112201202111210110211221P010211111111011111110111111111101110011a1110011111111110011111101111110021201121012222b212121210102211111110011111110a1
0001111101111111112221222020220002002111P012111011111011111111110011111111111110a1111001111111011111011111011020121111121112212a210122111100211111111111111101a1
1111111111111111202211110122222202212001P212022111011111111111011110101101111111a1111111110111001111111111111111212112201211222b021111121112111010110111111111a0
1101111111111101112021221221021022020220P102121111111111111011101111111111111111a1111110011011010011111111111112010211120202220b111211121121011111110111111001a1
aaaaaaaaaaaaaPPPPPPPPPPPPPPPPPPPPPPPPPPPb102122111010110010011001001010111111110a1111110111101111111111110111112122012201021112a021021111210211111111111011101a1
111001111111P0112212112120112111220212221112211111110110011111111111011111111010a1111111111111101111011011111110022211212112111b011122102200111110111111111101a1
011111111111P1010202222221112211221211201022021111011100111001111111111001101111a1110110110111111111111111111110112021122012210b212221022100010111110101110011a0
111011110101P0112012112122222112111122010121221111101111000111101111010111111111a1111111101111111011011111110111220201221121212b120112222222211110111111111010a1
110011111110P1110100122012020101121211121011211111111010101010111111101001111101a1111011111111111111011011111122112211222102120b222011121112101111111101101111a1
01111111101P11110200111011012022211120111221121100111011101111011111011101111111a1101110111111010111010011111110200011111212202a111012102222200011111111110111a1
11111111011P11112110122111102112021200221122121001111111111111101101111111111111a0111111111011111110101111111110211210012212020b220011110212111111111111111001a1
01110011100110111220112121222021022021212001211111111111111111111111110111111010a1111111101110111110111110110001012012210122120b221201121212201111111111110110a0
11111110101111001121212220011020111201202222222100101111001111101111111111111111a1111111100111111110010110101120001112122110022a120222222220201011110110011111a0
10111110110101101201000222102110121111222101121111111111111111111111110111111101a0110100111111111111111111101012210211101121212b112221012111110111111011110111a0
11111111111100111200200211122210211122212211211111101011111011110110101110111111a1110111111101010111111111100122221221112021001a102120121022211011111111111111a1
01010111111111111102211211210112102222202121101111100111111111111101111111001111a1111110011111111111101101010112221122111021111a102121222121101111111010111101a1
01101000011111112121222221222210122222221121020111111111111011111111010111011110a1111111111111100110100101111101020212101221022b121020122221201011010101011100a1
10101111110111111110111111101111110111111111011101011111101111111011111111111111a1111101111111111000111111111110022010122121221b212021121220211101101001111101a1
