118 19
96 102
22 23
138 34
46 38
18 4
125 115
31 103
80 5
1 47

111011122212011201211020222211212110111111110011110110111111011101200100110111111b2101222111122111111111111011101110011a111011111a111111110101111111111110111111
111212011111000121022112221210221211111111100111110010111111111111021221211222111b2122011001212210001110011100111111011a011110111a111111111011001101100100111101
111122011211210100210012121200111211111011111101011101111110110012012011202010122b1211122222222101111001101011111111110a001111110a111111111111111111111010101111
111111212211120221220221112122120200111110111101111111111111111111020112102010022b1122222200012211111111111111111011111a111111111a111110110111110111111111111111
101212212221212020211102120211102110000111101111111111111110111110212221121112211a0020122221221101111101101111101100011a111011001a100011111111111111111011111111
111020222122112001121222212112111011111001111111101111111111110112121122011111111b2221212122022211101111111111011111011a011110111a111111001111110111111111001011
111212011122020022121210121120102211111011111111110101111110111110222122110111112a1210212112011211011111110111111111111a011110100a111111011011111111111100110011
101201022110220220122222221110121111011010101111011111101111111111122112021121222a1210221221212211011011111011111011111a111100110a110111101111111111011111111111
110212122222210122221221110122021220011110111101011111111111110112201220211222112a2012121002202111011111011111010111111a111111100a111110111111110101011110111111
111221222021202221222222021021222012220011011011111111111101111002211111120101101b0211221210110110111111111111101111101a011111111a011111111111110111111111011111
101222021222222222202201121222222222201111110111111101111111101102111222001202121a1111211211212111011101011101111111101a111110111a111111111111111111101111111111
111122222022222222222221212222212221011111011011011011110111100112220102222021022a2201220120120211111110111110101111111a110111111a110101111111111101011111101011
aaaaaaaaabbbbbbbbabbbabbbaababbbbbaabaaaaaaaaaaaaaaaaaaaaaaaaaaaabbbabaaaaabbaaaba0020020122222201010010111111111011111a110111111a110111111111011111111011011011
01111101022221102102212222022222012221111111111111011111110111111111001110112010ba2012221111120211111111111011111110111a111011111a101111110110011010111111011111
01112212221122222222022122120022210121111111110010111101100111101022221121102112ab1121011022112201111111111111111010110a111110100a011111111111110111111111111011
11010002112202022212022221210222202221111111111111111110111111111211101011012022ab1121211222221211101111111111101011101a011110111a011010111111110111111101111111
11102202201221212222122222101122220122111111111111111101111110010010122112121221ba1202210021210011111101111111001110111a111111011a110111011011000111011111110111
11111112211122020222222221222221212102011101101011110010101010100111202211112101ba1212221222122211001101011111110111011a111111111a011111101010110111111111101111
11011212002020222212122202220000222000011011110111011111111111011102011221212022aa1221210222002211111110011101011011110a101101101a111111101111111111101111111011
10111212221221212211221122012222111121111011111101011001111010110021111001012201aa000212221201211111101110111111111111Pa111211111b211221211020211112120120111101
11020102212212102222122222202020210211011101011111111110111111101121100211002120ab2110010212101111111111110100111111111P111221112b210002101121211011111111100111
11112112210122020220222210112221221201111011111111111101111111010202210221111021bb1222201212111210111111110110111101111P011201101b120222112121210121002112111111
11111210012022210122101102212202220122111111111111101111111111111012111201011111ab2201222112022111111011101111111101111P111020120b021020222100221212211101111001
11111121012022022212020122122220020212020220210112222200022212011122121200000010ba2202111212121201011111001111110011111P111002212a022021001021212111221122111111
11111222212210122222202212222222222221202022111022110200001102111122122120221222bb1011011021121110111111011111101111011P011112122a112121221020122122200202111111
10122122210221222221120222022122221010212222111122222111111202010022111210121201aa2101202202011011110111111111111111111P111212010a110221112221122221012221111011
11010210222212222221022222120222022220221211022111201211212111111102222012112220bb1100022010020211111110011110111111011P111122022b022110000001111211122002110111
11112112202110220121120110221221222212221121112201111222122001111112112001121101ba1122121122202011110111111110111111101P010212211a102121220021221012120111111110
11122222020022222221222222212222222212211222211021221220111202101001201100011021aa1201001122122101111111111111110011011P111111022a211220002101011110212211101111
11110112022222121222222222221202022201212021110121121112212220111202021121111222bb2121021221110201111111101111111110111P111112012a122212122102102022112121111110
11111122012020222122112221021112220102212101212220112121202201111122221122122102ab0222102220220211011111111110111010001P110012222b111102212202110201120210011101
11001112001101222212221221112212022221212221021121122212212022001101011110110111aa1111001111111011111111111100111111111P111212111a022122221221022022220212110101
11121122210202222022220122222121101121211001112011102111122111011110111011011100aa1111011111101111111011111101111111111P111121200a111211222111012200011012011001
22020122102020120222001210022220122212112121221022112102211122011011011111111111aa1011111011111111110111010100111011110P111211211a202111021212120122010101111011
10111111211221220020221222122022220022222120121111221101221122011101111111011111aa1111001011111111111101100001011011111P111120212a211120112102211112111222011111
01221111102222202122221122211212202102112211112111211112111222110110111111111111aa1111011111110111011110111110111111100P110021200b212221112112212110122112101111
21011212222111221122222112222202022202022122112112211122222120011101110111111110aa1101011111110111111111111111111011011P101112211a211020212211202222212211010111
21111202002221222210202221211220012200111221210220202222011010110110111111111111aa1110111101111101111111111111111111111P111210112b211220010020212221212120011110
11211202222221122222122212222122021112021222112112021111111122011111011111111111aa1101011001111111111101111111110110110P110122110b112120122122210121112120111111
02101121001221212101221101212211201210222101011211202121212001101001110011000101aa1111111111111111101111001011111111111P000120110b121202220222121212202010111111
12022122121212211222201201212120022022210211122211101220021011111110101111011111aa1111011010111111111110111111111011111P111111111b221112122121112110011212111111
01021210100112100121202202110021212220120010021012021220221011011011111111001111aa1111011111111111111110101101100111111P110121211a112100122111022111001221111111
10002201222120110200222221201221122221112021202120202221100121110111111011111110aa1111101100111111111101001110111111111P110212102a211011122121001222200211011111
01111212102222021112112222122111111022022101112120221222221120111110011111111111aa0111011111011100110111010101111111110P110112022b102102222220001222222222111111
21112221122022211100222112121012122122211220100220012011022102011111110101111111aa1111111000110110111111111111111111100P111221122b122121121121220102102220111011
20211111212002221112110112211101122122212221210121112212020122111111101110111111aa1100101100111111011011110111110111010P111220012b222112212212110212021122101111
20021212011121110202111111121012012220210121211201111201222122111101111101111101aa1111111111011010111111110010011111010P101212101a012000221201100122021201111111
21111122221112202211111121221212111122211101020202200221210120111101110010110111aa1101111110101101111111111111011111111P111111102a221210201220022102201211111111
12112102001222220121221222212121012211211110220200122100112021111111111111101011aa1111111100110011101111101101101111011P011210212a210111112021222211121012111001
22011202121222011221102001212122110202110222022000211001102122101101111111001110aa1111011111111101011111111111111011111P111202012a111212222100212122101022111011
11102112221120201121222022012001021222120010111200221121221111101111010000111011aa1011111111010110110111111111011101111P111110111a110010111111111111111011101111
20122122211101122220210111111021221212020112121220220222012211111111011101111010aa1111011111110011111111111100111111111P000110111a101111111110111101110101111010
babababbaabaaaaaaababbaabbaaababbaaabbbbbababababbbbbaaabbbabaaaaaaaaaaaaaaaaaaaaa1111111111111101111111111100010011111P101111111a111111111101111111111111011111
002112112022220220002212212101222011021210120121201212111101201001110111010101011a1110111111111101111111110111111111111P111010111a111111111111011011011111111011
221111200220222021201202121122201011001110110101110011101110111111111111011111101a1101110101011111011111011111110101111P111111111a101111110111101111111101011011
122212112221211220220021121001001110111111111111111111101111110111111011110101111a1111111100110111110111011111111111110P011011111a110110111101111101111110110111
221111022202011221121121200101211101011111011111011111011111111111110111011111111a1111011110111111101001111111111111000P111111011a111011100111111010110111111111
102202012110111212011201122220201110110001101111110111010011111111111111111011011a1110111110101111101111111110011111111P011011101a011011111111101011111111111001
211221221202112111102100121112201111111111011111111111010111100101111110111111111a1111111111011111010111110111111110111P111110111a111111011101110111111111111111
121201101110211122201110021020210111110111001111110011111111011111100101001001111a0110111111111111111111111101111101111P111111111a000011111010101011011101111111
220121211212120001021222102021211111111001111111111011100110110111111111110101010a1111011111111011110110111101011110101P101111101a101111101011111111110111111111
122011112211010111122110022212101011110111111111111111011111110101101110111110111a1111110100011101111011111111111101111P110011011a111111100111100111110011111111
111120021210222021111121221022211111111110011011110101101111111111111111110111111a1101111100111001010111111101111101110P111111011a011100111100101111010110111111
111111111100111110111111100111011110111011101111111111011011110101010111110111111a1101111111111111101011111111111111111P101001111a111111111101111111111111111101
111111111001111011011111011111111011111111111000111111111010101101111010111110111a1111111111111100001010111111100111011P111111110a111111111101111010111110111110
111111100111111010111011111101110111111111101001111111110110111111011011011101110a1101111111101111111101110111110111110P111111100a111111111110011111101011111100
111111110101101101111001101100111011111110111001011110101111110111110111101111011a0111110011110111011111111110110111110P011110111a101101111111110011111111110111
110101101111011111110111111111111111101111011010111111001110111100100111111111110a1001110110111101111110111100111110101P011010110a111111011111111011111001111001
011111111010111110101111010111010111111111111111111111111111101111110101101111011a1000111111110111010111111111101011101P111010111a111011101111010111101111110111
010111101111110001100111011111111111011111111111111101011111110111111100101010011a1111111111111111001111111111001111111P100011111a111111110110111111110100011111
111010111111111111110101111111101011101100111111110110100100111111110111110001111a1001111101111111011111101011101110011P101111111a111011011111011111111010111101
111111111111110111110001011100111111111111001011101111101111101110100110110111101a1111111111101110101101111101111111111P110111101a111101101011101011011111100111
111111111111011111111111111011111001110111110111101111111111111111111111111111111a0111101111101111001111011111001111111P110110110a101111110110101111111011100111
111111111111111101111011111111111111111111111111101110111011110101100011110111111a1111011011110111111111111111111111111P110111110a111111011111110011011101011111
111101101111111101111110111111111111111101111111111011011111011111011111001111110a1111111110101110111110110111111111111P111001111a111101110011111001011011110111
111000111110111111110111111101110111001111111111011111111101111110110011111111011a1111101111111111110111111111111111111P111111001a000101110111111101110101110111
111111011011111011111010111110111011111111111111110110110111011001111110111101111a0100111111111111111111111011011111110P111110010a101111101001111111111111101111
110011111111011110101111111011111111111101111111100110111111111111111111111111110a1111111111110011111100111111111101110P111001111a101110111111101111111111111111
111011111110101111111110000111111011111101101101110111101111101111001011100111111a1111111111111011110111011010101110111P110011001a011111111111110111101011011111
111111101011001100101011111111111111111111111111110111111111111111111110110001111a0111111111101001111111011101111110110P111101111a111111111111111101111111001111
110110111110101100111111111111111111101111111101011111111111111011111000110111111a1111111111111110111111100111011111101P101100111aaaaaaaaaaaaaaaaaaaaaaaaaaaaaaa
010011110111111111111101111110111010111111111111111101111111111111111111111111110a1011011111100110111010111111110111101P1111111111111111111111110111111111111111
111101101110101111111111111100101101110110111111111100101111110101111010111111111a1111011011111111111000100011110011111P1110111111111111011111111011011111001110
111011111111111101111111011111111110111111111111111111100101110111110111111111011a0111111111111111011011110111011111111P1011011111111111101111111111111110100111
111111111110111111111110111110111111111111101110111011111111111100011111111001110a1110011110101111100101011101111111010P1110001111110001111111111111010011011101
111111111101101110011101111111111011111111111010011110111010111011101101111111111a1110110110111101111110111111111111111P1100111111111011010111111111101101101111
111011111110111111110111111111001010101101100110111111110111110100111111101101011a1110111101001111111101101001011101101P1111111101101110110111011111111001111111
011111111111111101011101110111101111101111111101111111101010111011111101001101111a1011011111110111111111101111110111111P1111101111111101111110010011111101111111
101011110110111121102102122112010102211201012021010111110111010111111011110111111a1111110001011011111111110111111111110P1001110111111110001111010111101111111111
011111011110110121112211121222021211122202112001111110110001111111010110111111111a1001001111100101101101111111111011010P1111111011000101111111111101011111111011
111111101111000111212211202211110112122112002000101011110111111111111111011110111a1111111011010100101011110110111101111P0111111101011101100111111111101001100001
111110111101011121222002202112221122221212202111111111101111100101111010110111111a0011111011111111111110110110101111011P0111001111111101101111111101111011111111
011010110101111101012211220011222122211221121121101100011111111011100111111111101a1111111011111110111111110101111111010P1100011101100111111110000111111111011110
011111110111111121110120112010111122112111021201011111011111001111010111111100111a1111011111111101111111111111111011011P1110111111111001111010111111011011111111
111111110111111010212202221021102111111211121111111111111110100110111011111111111a0111111111111011011000100011011101101P1111111111101101111111111110100110101101
100100011101111121220122012111212212222111002101101111011101011000110111010111011a0110111111110011111010101110111111010P0101111111110011011111111111111101011111
100111101111101120121020211121121222101000110220110101111110100111110111101111111a1010101110111110010101111001110110101P1011110111001111111111101111011111111001
111011110111111100120211121211210120102202121111110111011111111111101111011111111a0111111111111111111111011110011110111P1110111111111111011101010001010010111111
111110110110111112001211110210212122001211221121011111011101001111111111111111101a1111111111111111011010111111101110110P1111101111111110110110111110111111111111
011101111111111111110211222121110201220222101120101100111110010111101111111111110a1111111100111111001111111100PPPPPPPPPa1101001111101101111110110111011110111110
011101010010010112121211111022221121212110022011110111111111110110111111011101111a001111110111111011011110PPPP221220202b2220202022101110112201111111111111111011
111111010111111120102002212100112220111012000111111101111111100111111111111111111a111111100011110PPPPPPPPP1111110221112b1112111121110121021111011111111111111111
111111100011111112110000100121201021211001201111110101011111100111111100100111001a11101111011101P1111011101111222201012a0111100111111201021201111111011111111111
111111101001101122212202111212001000122021212211011011011111100101110010100101110a1010111111111111110110111111212122221b0212022001222022111111111111101111100011
011111101011111102222121220122020221211112111001100111111110101111111101110111111a1111101111111011011011111011212122112a0022101111220122222220111111011111110010
011111101111110022121222212211202221121202010211010110110110111111110110101111111a1101111111111111111111111111201121212a1110101022111221221221111110110110111110
111011111011111122201122200121221111201122110211111111110111111001111110111111111a1111111111111011011100111111202122102a2112122020001222222211111111011011111001
111111101110111122202001212121110221122111111021101111001111111110011111101111111a1110101111010111111111110011110020112b1202201021212122112111111111111101100111
111110111011111102011021100222021121212110212211111011011011110111111111101110110a1111111100111010100111010011211121202b2010202002112212212111111001011111111111
011110110111111112112210111220201111212011110121111111011111111111110101111111011a1111101101111100011111001111211210111b2112110011111111122011111111111110111101
111110111111111021111102201110110010122222012221111111011111111111101111110110111a1101111010101111101110111111012212112b1001101210200112212221111101111011110101
011101001111111111022121222211201200012221120221111111111111110111111111111111111a1111110111111011011011111111110222022a2210111222022222112120110110111111001101
111011011111110122012012211020221120210000111201101111111111111110011011100110111a1011101111111111111001110111210221201a1022222122120211202111101011111111011011
000111011011101001211101211121201112212212012111111111111111001111011011110111111a1100011110110100111011011111212012122b2011022101211222022111111101101011110111
110100100110111122221021220201221210110122022211111111101011110111101111111110111a0111111011011111000111001011001111222a1121020120202122222001100110111111001011
111101111011110111112102111120122222210211111011111010011010011101110111111101011a1101111111011111111111010111210012111a1112021112121001222110101111111111111111
111111111111111102112102112221122211211201101001110111111111011111110100111111111a1110110010111101101101111111111111021a0101121100112022120121101111110111111111
101111111011111122221111210122101002201210212011111111010111011110111111101111011a1111111111111011111111110011122220102a0202101212212122112221101111111010001111
011101111111111100021202111102202111222220122201110111111111110110011111111111111a1111111111111011111111111101211211111a1222210001221122122221110111001110011101
111110011111101111010111111111100111110011110111111110111101110110101111110111111a1100111111101101111111100110201221021b2121222001221221221001110011111111111011
