143 49
8 116
22 23
138 34
46 38
18 4
125 115
31 103
80 5
1 47

1111212021121221110020002122210220111111011011a01101111011110111121222102212002112100210211121221101111110111111110111011010011111101111111110111111001111111111
1112210111111212012221122122001221011111111101a10111111111110111101222222021111011210021212111121001011101101111110100110111111011110111111111110111111111111010
1011222212212220102121111101022121010111111111a11111111011100111121221122112120210011102211121120011111111111111110111111111110111111011101011111111111111101011
1110212102102222102210122111212111110111111111a10011111111110001121111002011202122121122112221021110110111011100111101111110101010110111111011010111111110001011
1010001222220112102012021222111111111111100110a11111010101111100111222111120112212222221102110011111111111011111111011111110111111111111111111111111011110101111
aaabababbabbbababbabaabaabbabbbaaaaaaaaaa01001a11111110011011111110111210212212000100012011220220111011111001101111001111101110010101111111111010001110111110110
1111111112022000211111122121210210110111a11110a01110011111011111112202102100102210021222012112020101110111111111011101110111110001101100111011111111111111100111
1111220111111121122021201101112220111011a11101a01111111111111111121102101111121221110011121221211111111101011111011101111010111101111110111011110111001111011011
1111021122222222212012222222102021222111a11111a11111111111111111110212200222110111212222011012011111101110111001111111011011111111110111111110111111111111111011
0112121001112221222011222222022222022211a10101a11111101111111011111212221122221201110211101221221011101110110111110110111001111111011110111111111111111101111111
1010222221112222122222212220222112021201a11111a11111111111100101112210221222222102121211201021121110101110111111011111101110111111111111111110111110111111111111
1102111212221122222001222122101022212111a11111a11101111111101111112002121120022120220002202201121111011111111101111101111111111111111011111011101101101111101111
0011121121221222221212021220122110221111a11111a11111111111111111101002122212212221211012212022021111101011111101111111011111111101111111111011111111110111111111
1101011220222002210222221122222202222100a01011a11101100111111001020112122022112001112201122221201111111001111110111011111111110101101110111101111111111111111111
1110112120220211122002012022222112211000a11111a11011111100110011120110121122001122121121122100011011111001111111101101011111111101111111011011111111110111111111
1102202202222212022221221022222212022211a10010a11101111111011101000102221121111212121111021122221111111101111101111110111111111101111111100011001111111101011111
1111011021122202112122222120222202021100a10011a11111111101111111011022222211021112002222212210121110110101011111100110111111111100111011011010011101001111111101
1012102202201222222021020220102202211111a11111a11011111011111111121112102220110212112121011012021111101111111111011111001111111110111110111111101010101111011110
1111121212210220020022111211010220102211a11101a11110111111111111122120000221211021222222112001111100111111110110001111111111111111110111111111111010111111011011
1112202220222222022221221221020022121201a10110a01011110111111101121100212221102120211201212222221111111001101110111111111012110120102111202021121222021021101011
1112111121010012221002222221012222221101a01111a01101111101101111122110220212222022202102222021111011011111101111111010001110001121011111112212221022201211111111
1012201022212122222022120221021012201110a01111a11101111111111110120112112121220222112010112111201111111111110110110111111112222221012112101022012111101121111111
1112200021122212212201012222221220221210a11101a11111001011111111020212022201211221101022112112201111111111111111110110110111121122012010222110102221021011001011
0112120210200100021001221221222002222122b21102b12212220220100001112212011221212112122122210112110110111011111111111110111012212122111102221221112222021022111111
1010212222020112222021220222202222202220a21020a12211222122221101121111110100010112012221122221211011010110111111101001111112011122111121202221200012220021011111
1112121221011222202222122020222222220212a22221a11212222122020201121201112122101022221211120201211111101001011111111111111112222002100210120122202012010212111011
0110210202112122121221202221102112021211b21201b11011102112110111122100000212211002200020200211200011111110111101110111011111202100121122112201011222011212111111
0012111221122122122220212220020222021221b12012a21221221112212211110212211122121220111022120001221111110111111111111111111111101121211102221202111001111021111111
0112012202222212221222222202221021202112b22221b21111011100211211121101120221210020212111021211121010111110101111011111111102000122221221112222111111221202111111
1111102221222221102222111222212222212212a22111a22211002001211011100211110210221122101211112121001111011101011111111111100112112201111221122020001122111220111101
1100121221022212222222110222202021222022b00212a11020212102012011112122211002010121102010012200011101111111100101101111111102212012011211022111021222002222011011
1111110122112220212200210012121112111012b22221a12220112021022111111110101011111011111101101011111111011100010111111011011111222221212221220121011112121100011111
1202022222221012202222222222222120122021a11221b11122101212022211111111111111111111111111111111110111111111110011011111111110221221112202021010022102201211110101
1022121222022221221002201020002202200021a11222a00011212022221011111101111110111111111111101011101111110110010110110011111012202120021221212110122002101221110110
2201212020222222121211210021222202012210b12121a22210012210012001110111111110110111111001100101101111111101111111011111011110211000011121001121110212211111111110
0222221122202210002221222121222102222222b21212b11212222112110210111111111101011111110001111111111101001110100110111101111111001121111012120212201121120212011111
2121221202022022022112022122010122200212b21221a11112010121212111011101101101011110111111001111111011111111011111110010111112210101212202202101102211011211111111
1212120212222022122212222211212210021222a01212a22020222122112111111111111011001001111101111111111110101110011111110111001112202011112222212211111211111222011101
1211220022222221221022000122012010112220b11220b11212201021121211111101111111111101011110011011111111111111111011101110111111221110022201110111221011112122111011
2202012202101120101212201112222010111211b21000b02011212222212111111011111111111010101111001111111110111011111110111011111112202101211211221102211221012012111111
2212210221121211120121220122200212101221b22210a21111210222101201110111011010001011111111111111111111101111111110101111110111122211002212211120221011212210111111
0102211102202111121211022222011011011221a10121a10212100101111111111111011011110111111111011110111110111111110111111101100101221022211221212122110100210110101011
2222222010222211211022211110112022120212b12021b22211211112212011111111111111111111111101110111111111111011111111110111111101112212111110020110222200212221111101
0122200111112212111220212122122202211021b12211a21110100010221111111101110110001011011111111111111111111111010111100101101111222001102201211111111121120121110101
2200112120222120211121222021211112121112b22211a11101201222101211111110111111111101111111111110001010111101111111101010001102201112212212121212111221221121111111
aabbbabbbbabaaababaaabbaabbaababaabaaaaba21121b22100010201210010111011101111111110110110011011110011011111011111101101110111220212112120212121211212112212111111
1221211021021222122121121212011212112220101021b10110121212112001111111111111111111011001101111111110111111111111010111110110022222010122122110201021101112110111
2222222211101121011112222211022211120101121111b20112221201022011101111111000111011111111110110111111111111011111110111111002112112211222111202122101022012000101
2112221112111022121110202222112121211001220221a02220121111110001111011001110010001110111101111110111101111011111101110111112021221202112211122202002212122011101
2210110121020100202111222112002120122012211012b211211121220122101111011110110101111000011111010111011101111111101111011111111011122221211011122P0020111011101111
0210112111111220221202211021122221121112202120a012202121211010111101111001111111011101110110111101111111000101010110110111011111101010111111111P0111111110111111
1220112102102202221000112110111121022121220222a012121001022121111011011111111111110111101101111111111111101110110111111111111101101111111001111P1111011110010111
0212222122212122222121211222101111022021221211b221210122121212110011111111011100111111110011101001111011101111111010101111001111110101100011111P1110111011111101
0121212211121221121112121122212202122222112022a212111122212220111011011111111000000111110101101111101111111111101101010110111011101101111111111P1010111101111110
0200210102010010220202111020122111111111110100a111111111001111111101101011011111111010111111111011111011011010011100100010111101011111111001111P1111111001111111
2112122212211002221211121111210111101111111111a111100101011111111101101111111111101111100111010111110111111111011111111111111111111111110101001P1111111111111111
2221211212202101222020112111102111101111111011a11011110011111111111111111101011011111111111111111000111111111111111111111011111111011011111111P11101011011111110
1212121121121102011201121122002010111100011111a1111011110011111011011100110101101111000101111011111110111101111101101111111101111111111111111P001111011011110011
2110011211021121202111102112212111111111101101a1111101010011110111011011111111110100111100110111101011101100101011101001111011111011011101101P111101111101111101
1122222212021202221121202111221111101110000111a111110101011111111101111111111111111011111111011111111101111111110100aPPPPPPPPPPPPPPPPPPPPPPPPaaaaaaaaaaaaaaaaaaa
aabaabbabaaaabbbbbbabbabbbbbbbbaaaaaaaaaaaaaaaa110111001111111111111100110111111111110110111101111111111111101111011P0101011011111110110111111011010011111111011
12111122021111201112010111110021011111110110100111111101011111011111111111111110111111111111111101001111111111101100P1111111110111000000111111100101111001111110
02222012111222121111202012220101111111111101111011111111110101101111101111111110011110101111101011111111111111111111P1111111010111101100111110010111111110110001
01111100111101101011111110011101011111111111101101011111111001111111101110110111111111111111111111011111111111111111P1111101111101111110101111111111111110011111
01101011011111111111111111111111100111110010111111011111101001011100100010110110101110111101111111110101111111010111P1111111111011110111111011111110111111111111
11111111111111101111011110011101111111111001001001111111111110111100011111111111101111111111111111101110111111011111P1101111111011101111111111111111011101111111
11011111011110101110110111010111101111111111011111111111110111111111010001011111101011111100101101101111111111110001P0111111111101111101111101111111111101111111
11011100111111111011110111101111001011100111110000111011001111111101111111110101111111111111111010111111101111111111P1110111111111111111101101111110111111110111
11111101010010111010111010101101111101111100011111111011111111110011111111101111110111111111111110101010101110011111P1010110111111111101111101011111111111001110
11111111110111111111110111001110101000111111111111111111111101011110111011111011101111101111111101110011110111011101P0011111100010111111111111110110111001111111
11110111101111110101101101101111111111111111110111111101010110111111010111111101110111101111111111110110011111111111P1111010111111111111111111111111111111111011
11111111111110110111111011011101111111011101011111111111111011101111110001101100111111110011111100111101110111011111P1111111111111111101011111111111011111111010
01111111111110111110110011011110111111111101111111111111110101111111111011101011111111111111111100011110111111111110P0111010101111010101011111111001111111111111
11111111110010001110111111110111111111110110110110111110111111111110001111011111001111111111111101111011101111100111P1101001111011111111110100111110101111111111
111111101111010100011011100111111110111001101011111110101111110111111111111111111111100110110111011110111110110110PPa1011111101011101111001011111111111011110111
011101101110111110111111111111001111111110111111111111101111111111001111111111111011110001101111011110PPPPPPPPPPPP01a1111001101111101101111011111011110101011101
111011001110111110110011111011110100111111111001100110101011110111011111101111111111110110PPPPPPPPPPPP11011111011110a1111010111111110101111110001011111110111111
10011011110111000111101111111110101111111101101101111111111111111011111111110111111111PPPP10111011111111111111111101a0010110110110111101110110111011111110101000
0111111110111111111100111101100111111101111111011011100111110010111110010111111110111P110110111101101111111110111111a1111110011111111011111101100111111111110111
aaaaaaaaaaaaaPPPPPPPPPPPPPPPPPPPPPPPPPPPPPPPPPPPPPPPPPPPPPPPPPPPPPPPPPPPPPPPPPPPPPPPP1011111110111111111111110110111a1111011111010111111111111111011010010111101
101101101111P11111111111111111111111111110111000110111110111101101111101110110111111a0111110111010011111110011110111a1001111111011111101110100101110111111011101
100101111100P11111111011111110101001100110111111111110111001101111111111111110111111a1111011101111111111111101111011a0111110111111111110111011011110111111101100
111101111111P11101111111011011111111111011111000110001111111110101111111110111111111a1110101011111111110011101111011a1111011111011111111111110111111111101111111
111101111010P01101111011101111101111111111111011111111111111111001111111111111111101a1111110111101011111111111111111a1111111111110011111111111111111101111111110
111111111111P01111111111101110110111111010011111001110101110111110111111111001111011a1110111111011101011111101111101a1110111011111111111111111111111001011001111
100111011011P11111111111111111111111111110110100011111101111011111001111111111001111a1000111111001111111111011111111a1111100110101111101011010111111111111111111
111011111111P11111111111110111111011111111011011111111111111011111101111111101111111a1110111111111001100111011111111a1111111111111111111111011111111101111111010
111111001011P11101111011101111111111100111111011101001111111111111111111011111111111a0111111111110111111101111111111a1011010111111111111100111111111111001111101
111001101110P11112102110112222021200122221211201111100111111111111111111010101011001a0111111111111111111101101111111a1111101110001111110111111101101111111111111
111110111011P11011221102221112201112222202222011011111111111011111110111111111011111a1001111111110111111111111110111a1101111111110111111111111111010101100111111
101101111111P10101201022221110111222121102211221011111111111011100111110111110101111a1101111111011111111111111010111a1111011101111111111111111011111111011111101
111011111110P10110212212210211211202010210110010100111110011101111110111111100111110a1111111110111110111011111111111a1110100111111111111111111110001111101011100
011111111011P10122121010021101211222001111211111101111101111111011111111111111111011a1111111010111110111110011110111a1111011111010111111101001011111000110111101
111100110011P11112211202222100212112122111112211111101011111011111011111111111110111a1110011111111111111111110101111a1101101101111111111101111111111011101011111
110100111111P10120220201221112120221211122210210111111011111111111111111011011101111a1011111111111101010111011110011a1101111111101111111111000111010111110111101
110111111111P11111221201110010110001222101221121011111111111101111111110111111101001a1110110111111111111111111100011a1110111010101101111111100111111010111111100
011101111111P11002111212011012222122122221020001111111110100110010010111101011011111a1000111111100011110111111111111a1110111111110110111111001110101111101111010
111011101111P11112021120112222111222211121012221111110111010111111111111011111111111a1111001010111111111110111111101a0111011111111111111111111110011111111010111
111111111111P11122110022100212112011102120212121111111111111111001111110111111110111a1111110111111100010111011011111a1111111111111101111011111110111111000101101
011100001111P11022201112211110121211112110122101101111111101111111110111110010111011a0111100011101111111111111011011a1011111111111011011111111010110111011001110
011111111111P11111211102222202211022112102222201111011101101011110011111101101111101a1111111011111011111101000111110a0112212011221202121201110110111111101111111
101011011011P01111221002121120111011022211212121111011111111111111100111011111111011a0111111100111111111101111222112a1111202010212100220201120111110111110110110
111101111110P11001011112012011221120021101212210011011001110101011111111111111111111a1111111111100011111111111212011b0122201011210110212021211111111111100011111
111111111011P10002020112122021211111112022021100111111011111110111001111111110111111a1111101111100110011011001201112b1101021212122221202110001111101111110101110
000111111001P11111201212121112202111122202202211111110111101100111101111111111111101a1101110100110001010100111202112a2121222110211011210122221011110101011001110
11111111111P001101222112212111001212101101211221111111111111101101111111111111111111a1010111110101011000001111111211b2122022122122122121222221111110111111111111
1111111101P0111012111101202021022122100011121021111110111110111111010100110100110111a1110111111111111101101011212201b0221211211111220021220111000110111111111011
1111111111P1100001101222110122101112002010012121101111111101111101111111111111111111a1111111011111011111111011111102b1221122012222112021022221011101011111111111
1111110101P0110110120221211200122111212222222210111110111001111111011101011111110100a0011111111111111111111011202022a2121000121011111222121021111110010011111111
110111101P01011021122111110021012202222112022101111111111110111011111111110110111101a1111111111101111111111111122002a2221121202222211222212221110100011111101101
111111111P10111102121220012112112121022021212211111111011101101110111101111111111101a1111111110111100111110111211101b2012222121112012112202211011111100111100111
111101111P11011010222022110111222020112120211210111111101011110111111110111011011111a1111111111011111111110111101211b0021121210112011002110221110111110111110111
111111111P10111110000112212002122110122111221111000111101110111111011111111001111111a1111111111101111110111011111211a2211220011101122212002211111111101111101011
111110101P11101112010102110000211122101221122121111111111001101011110011011111110111a1001111111111010111010110012011a1210111100111211000221011010011110101000111
111101101P11110121110122211101111211212121110121111111011111001111111111111110111110a1011101111111101111111011001211a2202220122102001212222221011010111111111111
111111101P11111010211200110111101012201012112211110111111111110111111111111111011011a0111001111111111011011011220210a1101201221221110211200011111011001110111111
11110011P010111121112211021112221102020212012011111110011111101111111111101111111101a0111111111110111110011111020222a0120222222202212021002121111111011111111111
111101110111101110012211011021101121001212120100001111011110011111110110111111111111a1111111111101111001101111201112a1112102111211211221011211111111111110001111
011111111111111112211112201121101012222111211000111101101110111110111111111011111111a1101111111100111011111111100111b2221200222012211210211011111010111001111001
111111010111111111111111111011000111111101111111101100111101110111011001011111111111a1110111111111111101101101111022a1102212011212101021121221010100111101111111
