118 19
96 102
22 23
138 34
46 38
18 4
125 115
31 103
80 5
1 47

1110220011220010012b12120212022102001111011111111110101101101110121221120112222122020210121101111110111101011101101111111111111011101100100001101011111111111111
0112121221112101112a12012022110212111110101111110111110111101111022221122120212211201012100201110111101111110111111111111111111011101111011111111011001010111100
1111012022202210222a11202012121220111101111111101111111110110110111121120012211222211121112111110111111111001111111111010101111111111101111111111111010110011111
0111220022211210212a20222102011021111111010101110111111101111011122022022022200111110202122102221111111111111111011111111111110101100110011111111100111111101111
1111122221110222002bbaabaaabbbabaaaaaaaaaaaaaaaaaaaaaaaaaaaaaaaaabbbbbaabaaaabbaabbababaabaabbbbaaaaaaaaaaaaaaaaaaaaaaaaaaaaaaaaaaaaaaaaaaaaaaaaaaaaaaaaaaaaaaaa
1112112222221101201220222221112221111111001111011011110111011111121221111212201111122221212211111111111101110011101100111011111110110111101010111111111111111110
1112211212020211201112111201220012111110010011111110101001010100122221222121210112221022221112011110111101111111111111110111011110101111100111011111111111111111
0110012100020022202211112010200121111111101111110111011001111111120022111121211111212110221121221001111011110110110011101111010111111111000111111011111111111010
1012201212212212202222212220211222220210101111111111000110011111011111210222212222110222002111111111111111111111010111111111001111110111111110111111011110111111
1111122221222212200211121221110222101101111111111110110110111010021212112121110111202022212102221111011111111110111011111101100111101101111101101001111100111111
1012221111022212200122102012200222020011111111111110111111111111111021020211011120021102111112110011001001111111101000111111101111110111111111111111011101111010
0112121101220221022222102202221122222111111011111110011101011111122210221111112122010121121211200011111111011101111110001111110001101111111100011110111011111110
1011102002012012122101122200222222212111111011111111111110111101012101121110222112021202211211121111111101111011011011101111111110111011110111110111101011101111
1110122222212220210010222221110222102101111010111101111111101111112201221222211101011221221120001111111011111101011111111111101111111011101111011101011111101111
1111120222222022122200211201221222222211111101111011111111101111002110011211112112212202112211211111111111011111111111011011111100111011111111011111111111111101
1110221022222020200222200212220222210211111101111011111101111111112100211222200121121102211221021110011110111110111111001111101011111110111111011111100111111111
1010221222202220202222222211222222221211111111111010111111100011002220111112112221012110221121011001111110111011101110110111101111111111111011011110011111110111
1111222221012200220201110022211202220211111101001110101111111101100122221120220221101110201220111111100111111111011111011111101111110011111101111111111001101111
1111112112122012122222121122021220021100101110111111001111110101112200211102221121122222112021021010111111110111110110101101011010111111111aaaaaaaaaaaaaaaaaaaaa
1111212221222222221112222200212220111001111111011111111011111111112112212111220012122221221121011111111111011111110111111111211101221202111a10121202221101011111
0110111022102112222121222102220222212011101101011111110111101011121112111111021121201120122102111101011111111100011011111110212102212201111a22121021112222111111
0110122222100222101021001112202222111111111001110111101001011001111121122100211222210001221100221111010111111101001011111112111121002112112a21212122111220111111
1100112021200202210022111222222222202110011011011111111101100111112101102100101121022202211111201101011111110111100100001101210210221210221a11112211102212111010
1111121002222102102221202121122222222111211211202120201110201211122121212220120112212112021021211111111110111101110111001102221011022122010b12121102220210110111
1111222210222221222222100212222122122211210111020121222102222111100220011212221211011111102021211111111111111111111101111110221221202212101b12102121100110111111
1101220122222222222022112222222200022211120212110111112211120111100122202211121212210201222220221101101101111111001111111112200002100212110b10212122101221101110
1111012200212222022211222222222002202121122211122120121211102211102010221122201001022202100211120111111110000011111111111011222110112222020a00121122022120111111
1011220121221222222222022022222222220211122102221212110212221201121122110110212122101021111220221111111111101111111111010112112210011011212b22222012102210111111
1110201120221002012122121212222221122221222201221221111111121201121101201221011121111122202211121111011111100110111110110010222112202211120a12102101121111011111
1011221012200220112222220202210202220021102022021111202100012211100110021001212211121101021102211111111111111111111101111111211122021101100b12102012112212111101
1112121211222121000222112022122221022111022112122222221212202211022022120221211222222010221220010110110001111111111111111102010012112211222a21101221121102111110
1101111111111202002012222112112222122222212120222122121111121211100101101111110111101111011001011111111111110101110111111101211012212120212a01212220222101111111
2112221222102122221202122002201101221112222121210121211121022110101110111111111111111111111100000011101111101011100111111102210102201021212a12110112122211001011
2202020222122222221112221121102210122100110112022112221012022111101111111111011111111110111111011111010111111111111111111111012122221101121a10112211011202111111
1201101221211222221001012202222201122202211111102102101222222211111111111111100010100111011111111111111101011111110110101010012020102112211a11122021112000111011
20211222020202222212bbbabbaabbbbbbbbbaabbabaabbbbaaabbbaaaabb110010101111100110111111111110001110111011111001111111111001111120122021122101b10122100212222111111
12012112022222122221b121220002202220120122101221002210211021a211100111110101101111111111111011110011111111010101111110111002121122202212101b20112111112222111111
00211012222111220221a222212212122202211102211120222012111210a110111111011101111111111111111111011111110111010110110111111112222202202122121a21022121211121111111
22111212211201222122b222022222222020211212212211112102111211b200111101110110011111101101001101101101111110010101101111011111222010010122121a21112112121211111101
12212021122112221101b211011220111221021202011122222220112221b210111011010011111111011111111111111111111001111101101000111112220020021022221b22222111110122101101
10121212222122211212a202101102110220120101112212000020001221b211111111111110111101011011111111111111101101110101101110111110110010011211112b11122122121022010011
21102121112120212020a101021212112101112112100102121121210112b211101011101110110111011101111111111001110111011111111101111012110022121220112a12122112022010111010
12222022122122122220b112120222201212101000011212201111111222a110111111111011011111111001011111011111111011111101111110110111221101221022212b10111010120100101100
22211210102221012110b211122111121220220122021112121012221021a111111100111111111101111111011011110101111111111111111111110111222221112122212a11101220112022111111
12211112212201211202b101121211112201210212211101022202220211a211111011111111111111111101111111111101101110111011110111111112211022112121222a21110111122222111011
12212110110222122212a110211112111222202211212220221111112120b010111111111011011111111011110111011111111111111111110111111012121210010202111b01111220202011101111
22122011021221102120a121000110221112111120120111202122212222b201111100111111100000011111111110101111111111111111101111110110201210101110211a11211001122121011101
21212201222112102011a202121221101010022212222011011200021111b211111111101101111111001111010111101111111111011111111101111112021100122211211a12011102010100011101
22121222121220122220b200001212212210222102212201022201200102a101111111111111110111111111110111111111111111111101110011111112112212121110012b12220112200201111001
22212222222011011220b011012111200121022201011202122222121212b111110100111111111111010010011111101101111111011011111100110012122202201101221a02202112010211111111
22102122122221122021a012111002222221121221021022021112202112b201111111011101101111110100111111111111111111111101111111110111111111011111100a11111101111111011111
21111222211211010202b021212221121202221111222200201122011112a201110110111110111111101101101111101111110111110010110101101011111110111111111a10101111111110011111
20020120110112121110b200120211211210201110111111222110022122b211111111111011111111111111010111010111111110110101111101011101100110111111111a11111111011101110110
21111220211222112222b221001112102212002002221121001001100212a211111110011101011111111100111010111101111110101010111101110111111101111111110a11100001101111111101
21201100021110022210a112221221211101111111011110110011111111a010100101110000111111111111111110111011110111110111111011001110011111110111111a11111111110111001001
02121122211221102121b210002201111111111111011101111111011111a111111010111011101111101110101101111111111111011111111111101101111111111011111a11011110111111111111
02210101121211121010a110011210211111111111111111111110001001a100111011111111111011010000110111011010111111101101111111110111110111111101111a11101111111111111110
22221021112121202121b111112120211111111111111010010111101111a110111110111111111110111111111001100110101111110011011110111111101010111111011a11111111011001111111
21002112201212021012b212100211111101011100111111111111110010a101111101011111010011111101111111111110111110100011111011111111010011111101011a10011111101101111111
01000201221220100101a202122212011111011111111011111101111111a111111101011111101110111111011111011111111111111111110111110111110111111111101a11111111111101111111
21120120121120101012b022021202111111110110111111110110101011a111111111101111101110111101111101111111111011110111111111101111101111011101001a11101001111111100011
02012011102021212112b212102102111011001011111010001111110011a101011111011111101101000111011010111111111000111111101100111110111111111010111a11101111111111111111
12212121021212021210b121212012211011110111111111111111111111a101111111011101111111110111111011111011000111111111101111111110101110111111110a11100111111111011111
11111100111110101110a001011111101111011111011111111011111110a111100101011011111110101111111011111011111111110111110111111001111011111111111a11111011111111010111
11110111111111011010a111111100111001111111111101111111111111a100110111111111111111011110101011111111001100111110111111011110101110001011111a11110111010010111111
11101011111111111110a010011111111111101111111111110111001111a111111111111111111000101111111110110111101111101101111001110100111011011111111a11111101101101111111
11011110110111111111a110111111011011111111111011111101111111a110111111111011111111110111111111111011111111101111100111111111101111111101111a01111111101110011111
11111111111001010011a011011101001111101011111111111001111011a111010111111101110110110100101100111011110011101111011100110111110111101110111a10111111001101111111
11111100111100111111a111111001111111111011010111011111100101a111110111011111111111111011101011110000111101011110101101101101111111111110111a11111111111111011111
11110011111110111111a101010110111011110111111101101111010111a111111111101111111010011010110110111111111100111111101101111111100111111111111a11101111111111101111
00011111111011111101a001111111111111111010111001110111101010a011111111111011011111111011101110111001101111011111111111111111011111111111111a01111111111111111000
11111101011101111101a110111101111111111110110111110001111101a100111001011111101111111101011111110111111110111011011111111111111110011111111a01110111111001100111
11111111111111111010a111111111111110010011111111111101011011a111111011110110010111111110110110111101111101101011111111110011111111111111111a00111111111111011011
11100101011111111011a101000111011111111111011111101110101111a111101101110010111111111111111010111111111111111011111111111111011101111110101a10111000111111110111
11101011101101100110a111001111010111111111101111101101111111a111111111111111111101111111011111101011111111010011110111011111111010111011011a10111110110111111010
aaaaaaaaaaaaaaaaaaaaa011111111110111111111111111101111111111a011111110111111010011011111111011101010101101111111110011111101111111101010101a11011111111111101111
011101011111110111111111001111111111111101101111111011101111a111111100111111110110111111111111011101101101111111011111110110101101111101111a11111111111111011111
111010111011101111011101101011110111011111011011001111111010a101100101111101111011101110111111111110111110010111111111111110111111011111101a11111111111011001100
111101011011111111100111111111111001111110111111111111111111a111111001010111011110010111111111100011100111101001111111011111110111111111110a00111111110111011111
111111110111111110111111011110111011111111011111111111011111a1111110000111001111aaaaaaaaaaaaaaaaaaaaaaaaaaaaaaaaaaaaaaaaa110110111111111111a11111111111111101111
111111101011111110010101100111101111100101111110110101101111a1101110100100111101a101111111111111110111101111111111011111a101101101111101011a10111101111000110110
111111011011111111011111111111111110111110010111000111111111a1011011011111111111a110111110101011111111111110011110011011a011111111101110101a11111011010011110111
111101100111111111111110111101101101110110111011010111101111a1111111011110111111a111111110111001101111111111101111111100a101110111111111111a11111101110011100111
101101111111110111111101111111111111111111111111111011111110a1111111111110111111a111111111111011010111111111100101000100a111111111010111010a11110011111111111111
111111111111101110110111111111111010111100011111001100111011a0110110011011011011a111111110111110111011110111011011111111a111110111111010011a10001111111111101101
111011111101111011010101111111111101111111001111111110101111a1111111111101111101a110111111100111011111011111111110010110a111111111111010001a10111111111111111101
111111111011110110111111101111100001111111110011101111111111a1111111111110011111a111111011111011111101110111101111100111a111101111111111111a00111011100111010111
000111111101111011101101011111010111111101011111101111011110a1111111111011110110a111111001111111111110101111111110110111a110110110111101010a11011101111111101111
111111111111111112200202102101212111201221210021111110111111a1111111001111110111a111101111111111011111111111001101111111a111111111100011111a11110110011111010111
111111111111111121222110110112122112112211201121011101011110a1011110111110100111a011101011111110101101111101111111101110a100111111101001011a10011110111111111111
111110111111111111212001022111201111021222120021111111110101a1111011110111010111a111111101111110111101011111111101111011a111111111111111111a11001111111111111110
011011110011111101202212112022212201122120121001011101101110a1011111111011011100a111101111101110011111111111111111111111a101110011111011111a11111001111111111111
011111011111010122110122102010021212111020220111111111111011a1111110011011011111a111111011111111101111111101111110101011a111111111111001110a01111111111111110011
111111011101111112001222222020111210112012201111011101111111a1111111111111111110a111011010011111111111101111111111011111a010110010001001111a10110010110001011111
111111011111111121010111111011010012111222102201001111111101a1111011011111111111a111110000001111111111101111011101111110a110111111111111101a11110110111111111110
101011100110011101121020110101222022222122021111111101010111a0111111111110110111a111111110110111111111110111110111111111a111111111110111111a11011111101111110110
010111111101111112212221100102212212221220211211010101111111a1110111101101111110a010111111111111111110101101010111110110a111101101110111111a11101111111001011111
111111011111111111112211222012021000120021121010110101111101a1111001111110101110a111111111110110111101111111111111111111a111111101111011101a10111011101011111110
111110111111101121120022012211122212222122022111111111010001a0111111111101111111a111111110111111111111111111001111100111a111111111011011111aaaaaaaaaaaaaaaaaaaaa
100111101111101011021222112101022122112122010000111110111111a1111110101111111111a111111101011101111110011111111101111111aaaaaaaaaaaaaaaaaaaaaaaaaaaaaaaaaaaaaaaa
101101111111111122201210211200211112121122112121011111111111a1111100111011111111a0111111111101111111101111111111211201212120202122201102222011101110011111111111
110011101101111012122200111111021022222210120100111111111011a1110111101000111101a1011111100111110101111111111122120212212120112222102122122220101111101101101111
100101111111110111211200010011202021102022102210111011111110a0011110001111011110a1111111111010111101111110110100122110122112212112111201121211110110001011001111
111111111111111112021220122111110211112122211121011011111101a1101101111111111111a1110101101111010111110111011102111102021111021202210111122111110101101111010111
010110100101100112222121121111202222202201102121111100100111a0101111111111111111a1011111101111110111111111110122201121120121221020111202111001110111001111100111
111111101111100012221211212120220111102001111121010111111111a1011110111111111111a1111101111110111011100110011101211120200221022121111212120111111111111011111111
101111101111111112200120101021012012211122211211111101110111a1111111111111111110a1111111111011111111011010110002211021200202121212222212012211011111111000111111
110001111111110012220010121121222111021202111121111111011100a1111111110111100110a1111111110101000111011011011102121022122000221110121011021011111110111111111111
110111111011101121021212222121011212222121121121111111110111a0101110101111111110a1101111011110111111101101101121111121021222202101111211210221101110111110111111
111111111111111002212102101002121111110201220211111111111111a1011111011111111110a1111111111010111111111110111121211211210111222222021112212121111111110011111101
011111110010011110120011100111111221211012222020111111111110a1111101111001101011a1111001111011101010110111111102221212222211121201102012122221100101110101001111
001011111111111120121022120122121112022222120110110111111010a1111111011111110011a1111011111111111111111111111020010200010121212021212220111011010110111010010001
111110111111101101111010221222111220212201111211111100101111a1111111001011010111a1111111110011011110111111111111221212111022021122112021122211101110111010111111
111111101111111121212212011222100222212122220110110100111101a1111111101101101111a1101111011111111111010011000122211221220201211122202222202101101111111111111011
111111110111111012200121222111222111210212220111111111111111a0101000101011111111a1111110111111111101111001011120111110112122221121102211122021111111110111101101
111110110110011121220110212002102212212111122121101111111110a1111111111111110111a1001110111111111110111111111111111212221101210022112122222011101011100110010101
111111111111111110021111110210012210021112111101001111101111a0010111111111101011a1101111011111010110110111110122011122111121012112212010101201110111111001111011
111110101111111011010010210211220212011221121221110110011110a1110011010101111011a1101100101011011111101111111122101210221112011202101212122110110111101101111101
110111111001011120110121110202221222120112222021111111011111a1101111011111110111a1111111011111101111111111111102101110112121111210102111211221111111111111110111
111011111111111101111111111101111111111111110101111011111111a1111111111111110111a1101111111100101110100011111111201222222221012112122001221211111111101111110111
