54 17
98 106
22 23
138 34
46 38
18 4
125 115
31 103
80 5
1 47

111210012122212122121121112112b211111101011111110a1111111001011012111021210010201100111022220222101111111111a111101010111110111111111010011111111010111100111011
111111022200211210112202212121b211111011111111011a1101111111111111111122201012201022112122122112010011011111a011101101111111110110111110111111101111111010111110
110102112102212200001210021222b020011111111111011a1111111111111111011112212222120112021100012122111111111110a011110100111111111111111001111101011110111111111010
111020200211011112221211111121a121111011111111111a1111011111110112121121020110111221110122112122101011111011a111001000110010111100111111110111101011111101111111
101022011202201010122221221021a112111111101111011a1111111111010011022211210002211011221120001222111011111111a111111011111111101101101111110111110111111111111100
111020122001101221121122221221b222101100111111111a1111111111111011112120110110202012120012101100011111111111a111111110111110111111011111111111111111101111110110
111210010121110111221202222021a002111111111011111a1111111011111101200111222222011221211211101110011110111111a011010110111111111110101111111110111111000111111111
111122120102111101122111211201b111010111111001111a0011011110110112122210012122110121121212221011101110111111a111110111111010111100011001101101110101111110101111
111211221222202211112222222121b222102101011111011a1011011111111111110211211201211221120212201001110011010111a111111111111111101111101110111011111111010110111101
111022122012222020122222022022b222221201011011111a1111101111110112012212222201022111221201210220111111111001a110110100111011110111111111111111111011011010111111
111011112120220212012221002222b222111110111101011a1111101111111112221202210112200110101000122212111111111111a111111110111011111110001011111111111111110111111111
110220101122001220220122222012b022122211101111111a1111111011010112201002111012020200202012212210111111110011a110111111111110101111101111111101110111111101111111
111120001222022210211221112220a221112011111111111a0010111111101112112221212121220200111222222221111111111110a111111111111111111111111111111111111011110111110111
111122212122120212112212102020a221221111111111111a1001110011110111220101210222212012122221021010110011011111a010110101111111111101111011111110111111111011111111
101112022222212222222201112222b211222111111110101a1101111111100111012211100021122212021012202211111111011111a111100111111111111110111110100010001110110111111111
111121122222200122220101120222a222022111111011110a1110111111111112112211201111212222122122210111111011011111a111111010111110111111110111111101010100111111110011
001011121201102222212210212202b211122211011101111a1110111110100111221020111101220101222112111222101111101111a110111111111111111111101110110110111011111111111111
110222212122222222202200220010b210211211011111101a1101111101110111220112120122212121111212120112110111011111a111111111101111110111110111111101001101011101101111
100211012210112022112202202020b222222100110011101a1111111011111101221012211101222121010222212011111011101111a111111111011111110111101111101101111110110110011011
111112102201222222222022221221b222120011110111111a1011001101111101022111020212121101121120212221111111011100a010101101111012112222210100110120122210021011111111
110210020222200212220221002121b122212211111011011a1111011011111110221122201121222121210221222010111101111111a101111111101111211220221202211200011201222210111111
111121212212222022111222212220b022121211101111101a1111110111111100102222210111212211112112211121111101110011a111111111111111122221122221002200120110212220111111
111122210122222022022221222221b222202111111111111a1101011111110112121202211112222212212021111210101111111111a111110111111112222221110221111212211120210122111110
110210022221200022222200221202a202221211221210101b2222202212121100020100222211210010211110200201101111111111a111100101101111022112210110202122222122110001110111
110202122202221222202211222222a220222001011202222a1122122111110112221011121022011211212210212022111111110111a110101111110102221120010021212211201211121222111111
111112121122201002222212102222a222022221111121022b2021101110100112101220021222111211012101110220011111110111a111010101111100012111220200112212112212121201111111
110121122222220212112211222000b200100210122202010a1021121112101110112220022112221102020012222111101111110111a001111111111112101220222122222221222210001202110111
101222222002121212022002120201b022111211202120222b2221121121021012211121022012021112210012110200110110111111a100100111100112111210211012101101121011011011111101
111011122222222112210202222201a222210221222211202a0221112201211111202210122012201111021121100212111011011011a001011111011112201211112221011101111120011222111110
111221202222102020100202012222a222022212110122211b2201111102221112222112121011121122000222112212111111111011a101111101111112222122122121021222112020121001111001
111222122202022222122222222222b202222102021111111a1111102001211111121200221112121021121211002021010111101010a111101011111012220100121022121222121022222112110111
111101121211200001122020111021a212202201211211121b2112221010020101101111111101101101111111111111111111111010a111101111111111202210111220122122212121011212100111
001102201201112122221222021122a222212200201021212b0121202211020101111111111111111111111111111011101111111101a111110101101112021202212001222012021010121221110111
120022102110022121222122222202b220020021020002112a0112111001121100110111011111111010111110111111011111111011a010111110111011012121021222121121220102121022011111
112101220222210221202222112220b202022222212201122a1211011010211110011100111111111111111111111011011011111011a101101111011111112122121212201200122221202202111101
021111110222212220222220022022a112222212011022121a1102122202221111111111110111111110001110111111101000110111a111001110111112222100210111221121121111212021110110
100220211222112122102122112221b112222000112221221b0202121010201110111111101110111110111111111111111111111111a111110100100112221202112111100001222202021021111110
211110002202011020110101222221b100220101220121222a1211200211201111001110101101001111111111101011111111110110a101111101111011002110212111210112201212211120100110
200001222202221211121202020120b012222211122021021b2211111002120011111111111111111111111101111101111011011111a111011101010110212121012212112111221002221212111111
222001022112112111011121010212b112222222111112112b0101220112110111111111111111101011011111011110111111111110a111101011110110221112002220220022111022102222111111
110121220102102222000220022201a211122120201011102a2022120222111110111110101111110111101111111101011111001111a111011111111112121000121122202202001121002210011111
121012122212012222211112121110a222121121111121002a0221210212211010111100011011111001101011101111011010111111a111111111111112221221122112212120002122112221110111
111121120122110011202222110012b220021022212121201b0011221222111111011110011101011110111011111110111111110111a011110111101012120221122212121122001122222101101111
221112122000200010212202210111a212212210121212012b2020122121121111111111011111110101110101111011111101111110a111111011111101211012020222211211212011101222110001
111200111010121102010120211211b222122212020111022b2022211200111011011111111111111100011111111111111111111111a111111110011012100121220122022122120221221220111111
222222212111220211201101111122b120021122020002222a0102210220221101011111110101111011111111111111011111110100a111111111011112122222221121202121212212221120111111
112021212122212221221022102211a222102211220101020a1111220122021101011111111111101111010111111110111111111111a110111111011112012012222222221210222101222211011111
012122210222110122112011122102b021211021121011222a2102221012101110011110101011010011110110111111111011111111a111111010111111112222122222011102212220210101101101
120201222011220100211121211111a111212111011211221b1202202220111111011111111111111101111111111110111110011111a111111111100111111022111222122220211222212212111111
111120001211122011112001202221b211012221120212122b0211012111121111001100111101110110110111110111011100111001a111101111110111220010211121201111212002121101101011
012200121112212221000211022222a111211121112211221a2110002012121101011111011111110111110101110111010101110111a010010111111011111111110011111111011011111011111111
011212020220102202022221102220b212211211011102120b2211122012011110101011111111110111110111111111111111110111a111011001111101011001101111111111110001111001001011
022112112101011211201020211020a102200112212222112b1222122201210111111011011111111111111111011111010111011101a011110111111111111101100100111011111101111110011111
101110211022012121111202222111b220012202220002100a1222022222110010111111010101010111110111101011111111111111a111101111000111111111100110101111111101111111111110
112112210122101012222122001110b111110111000011111a1111110111111011111111101111110100111010111001111111111111a111100110101011111010010110111111111111110101111111
102221222222122002221011112211a111111111110111111a1111111101110101111011111111111101111101111110101100010111a110111011110111110111111101011111110111111111101111
121211212101012121101121110222a101110111100110110a1111111111100111111011111011110111111011111111111111011011a010111110011011001111111011110111111111111111011010
121011201000000112101221000010b111111111110010111a1111101111111110110110111111110111111111111111110100111111a111111111111011111111111101111111111101101111111110
120202101211222111212211110220b111110111001110111a1011101101111111101101011111011111011110111101111111101111a011100111110011101111110111111011111111111011101111
121112112211222212102211220121a110011111111111111a1111111111111111111111101111111111111111010011111111111111a111011111111111111011111001110101111111100111111111
211221011012120021220121221121a111111010011101010a1011001111101100110111111111011011101110101001111011111111aaaaaaaaaaaaaaaaaaaaaaaaaaaaaaaaaaaaaaaaaaaaaaaaaaaa
222111221112111100111210022211b111111111111111011a11111001110111111110111011011111110111011111101111111111111111110111111110100111011111011110111111111111111111
110212011211001212221220212112a110111111111011111a11110011001111101101111110110110111011101100101011110001110111110111111111111101100110011111111110111111111111
111111100010101110111010111111a111111011111111111a11011111101011111111111110000011111001111111111110111111111111101101010011111111110110111111111101101111111101
111111011101111010110111110111a111111111111111110a11111111111111101110111111101111110101101111111111011111110111101111111111111011111111110010111111111111111011
110101111111111101101111111110a101111111100111011a11010111101111101111111111111111111011011111111111111101100101011110111111010111111111111011101111111111111111
111101110110111101111011011011a111111111100111111a11110111111101110111110111011100111111101101111110011110111101110100111111100011110101110011101111011111110001
010011101111111111011011101111a111111010111111110a11111111001111110111011111111111111111111100110011111111011111111111110111101110010111111100110101111100111010
001111101001101111101111110111a111111111111111111a10011111111011111011100101111111111111101101111101111110011100101101111111110111111110111111101111111111111111
010101111010111110011111011010a101111010111111011a11110011111011111111101001111111010111101111111111011101100101100111110100100111111101110011111101101110101110
111111101111111101101111110111a111011111111011011a11111111111001111101100110111011011111111111111110010110111011111111111110011011111101001111111111111011110111
011101111111011001111111101110a110101111111101111a10110111110111110011110101101101111111011111101111111101111111111110111101111111111011101011111011100111111011
111111110111101101111111111011a111111111111111101a11111111111111110001111111111111111111101011111110111111111111111111111111110111110001111111111111111111011111
111111111101111001011011111111a110101110011111101a01111111000101111011111101111101111111101111101111111100111111101011110111011111111111000110101111001111010110
001111101100111110111111111001a111111111011110111a01111111011111110011111111111101011111101111111111111111000110111111001110111111111111111101110110011011011001
111111111011111111111111100111a110111111111111101a11111111001001011110111111000101111101110111011111111111111111011101011111111100110111011111111111111111111111
111011111111111111111101111111a111101111110011111a11101111101111111011111100010111111111111110011101111110010011110111111101111111111011001111111111111101110011
111110111011111111111111111111a011011111111110011a00110110111101111011011111111110111100111111110111001001011111111111110111111001101110111011101111101111101111
110011111111111001110111011001a111111111110101111a10110111101111001111111011011110111101111111111110111111110110011011111011111110010111111110111110111011111011
110011111111111101101111011111a001110001101111111a01111111110111110110111111111101110100111001110111101111111111100111111011101111100101111101111111111111010111
001111111111110111111111110101a111111111111110011a11111111111110111101010111101111101111111011101011111111111110110100101111110111111111111100111101111111111100
110011111111110110111011111101a110111111111111101a11111100111010110111101110111111101110001110111110101111111111111111111101011111111111101011110101101101001011
010011111111011010001110001010a111111111111100111a10111111101011101111111110111111111111101111101111101111110111111111111101111010101011011111111111111111111111
111100111111110010011111101111a110111111111111011a11111011111110111110101001101111111111101111111111111111111101110100011111110011011101111111010111110111111011
001101010011111111010101011111a111011011111000111a11111111111011101100001111101111111100111010111011011101011001111001110111111110111111101111111111000111111111
111111111111110111010111101011a011110111011110111a11101101111011111111111111111011111110111011101011110101111111011011110010111111111110111011111111101111111011
011101110101101111101011111111a111101110101110001a11110110111111011111101101111110101111100111111111111011011111111110111110111101110111101111111100011001111110
111010111010110110111111111111a011101111111001011a11111111011011011111010111111111110110111111110101111100101110101011111110101101111111110111101110011111111111
111111111111111122221211121002a020111212001210211a11011111101011111111011111111111111111111111101011101111111110111111111111101111111111011111101111111111011111
000011111111101101111011210011b210011112021221100a11001111110111101111111111111100111111101101100101101111110101111100111101010111111101101011101111111111111111
111111101111110102111122212001a000100011021121211a10101100111111111011111011100001111111000111110111011101010111011111111100111111101111111111111111100010110111
111111111111110112112222211222a102221222112112111a11101111111000111111111101111111101111100111011110111011101111111101011111101111111011101101111100111101110110
111011111110111111211000220221a021111221120112211a01011101111110111111101111100111111111111110111110111110111111111111111111001111111111111011111111111111111110
101101110100111012211002022200b112121011012211211a11011101110111111101110111111111111111111001101110111110101110111001001010111100111101101111111100110111111110
111111101101111121100121121011b112220122221020201a10111110111110110111111111111011011010111110111110111011111110111001111111111111111111111011111110101111111111
110111110111101110212211111121b212002220001122111a10001011101101111011111110110111111111111011110101111010111101011111101111110111111101011110111011100111111111
111110110111100021012221111212a122000122012122201a11110111111110011110111011111111011110110111111111010011101110011101111111111111111111111111100111110111011111
101111101011110112120111112122a222012200111111111a11110111111001101101010111111110111111111100111011110111111111111111111110101111111111111111111111101111111110
111111101111110122022121122212a221122122101210011a10111101111111111111111101111111011001111111111111100101011111101110011111111011110111011111110111110111010110
111011001111101111111201022211a122210210101222211a11111111110aaaaaaaaaaaaaaaaaaaaaaaaaaaaaaaaaaaaaaaaaaaaaaaaaaaaaaaaaaaaaaaaaaaaaaaaaaaaaaaaaaaaaaaaaaaaaaaaaaa
111110110111110121121211212202a202122022010221211a01111111111a11111111110111111011111111011111111110101011111120202212110112112021220111210020111111101111100111
111111101111111110221222221222b110122221020002101a11111011111a11110111101111111011111011101111010101110111010120111122222010222221112020220120111010111111011111
110111010101011111111120221122a122202220210212100a10001111101a11111111111111111111111111111111111111110111111120122202222202221122022111202220111111111100111001
011011101101101100121222111012a221112201210121101a11011011111a11101111111110111111111111111111011101111111111111201221212121102101100101222111111110111011111011
111111011101111012012200221212a102211122010120201a11111111011a10110111111110111111111111011111110101111011111112111021120022010020012111012121110001111111011110
110011011111111112122122122222b022212122022211211a00111111111a11111111111011011111111111011111101011111111011022022220112212211201110211011111111111111111111111
011111111110011020001211012121b122022111221111211a11111011111a01110111101101011111101111111110101110001111111121122112102011022100010221102200101001111110110111
111110110111011121021021011100a221122121211211200a11001110111a11111100111111110011111111111111111111110111001122000212101121010111221212121120111101111111111111
111110101101111112221111201222b202021000001122111a10111111111a01111011100011111111111111110101111011111011111121112201201200210110020002221121111110111110011110
111111011111110011111101120012a102122201202010201a11111111111a11111111111111011110111001001110111111011011011102021111202221220201212222022110111101110001101011
111011111111110121101101112021a211221001111221211a01101111011a01111111101001110111111111111101111111110111101012222111022121221122221222122111110111111110011101
110101101111011120221222210222b212122112122220211a11111111110a11111111111101010111111111111111101101111011111111002122102212012112012112220211111111110101011111
111101111111110022120110212110b220122011101222111a11011101111a11011111011111010101101111111111111010101111111112101021212120212210211222021121111111110111111111
011101111111111120211002222210a102201111110022201a11111110111a11101111111011111111111111111110101111111111111100200221221222010221212000120220111111011011111111
111011111110111020122020222211b212222121122111111a11010011110a11011011111111111111101111111111111111011101000112021211111101012120221011222121111001100101110011
011011000100111121112120202012a002021121111102111a11111111011a11111111110110111011011110110110111111110111111112011212211111111201220220111100111011111001111111
111111111010111100120011001121a210112020220112211a11101111001a10011111101111100111100111011101101101110111110122221111210121210102222212221021100111111110111111
011110111010111022220202201200b201210120000222211a01111110001a11111111111111111011111010110111111110010101101120111110121101012121210002202111011111111111011111
011111110110111112221112202221a221112122122202210a11101101111a11111111110111100111100110111011111110100011111112111220111220112012110221211021111111111110111111
111011111111111101111111101111a101111111011111110a11111111001a11111011011101110111110110111110111111111011011110211212211210212021101221210110110111111111111110
