1 19
143 112
22 23
138 34
46 38
18 4
125 115
31 103
80 5
1 47

11012a0a2122212222221221211122221001110a001110111110111110111011101112222121201211121201221100201111111101101111111101001111110101101111101011101110111111111010
10112b2a0011122121122112120112212210011a111101111010101111101110022112112222111102112122121221211011111111111011101111111111111011101111011111110010011011110111
11100a1a1022200111202121020011211111011a011101101111110111101111122212221220111022210110212212001001110011111111110111100011111011011011011111101011101111111011
11122a1b1011221110022220012220121210011a111111111111111110011001112022100220212111112222202120101101111111110111110111111011100111100111111110111110111111100110
10121a0b1121201122221022121101122110111a111011111100101100111101122111210100112211202201111111221010111111111011011111111111111101110111111111111111101111111011
11111a0b0111210111111102101220012201111aaaaaaaaaaaaaaaaaaaaaaaaaaababbabbbbabaabbbbaabaaaabbbbbbaaaaaaaaaaaaaaaaaaaaaaaaaaaaaaaaaaaaaaaaaaaaaaaaaaaaaaaaaaaaaaaa
11110b1a12021211211102221210112202111011001111111111010111111111100021021202111202101210121221221111101111110111111111101111111111011010111110101111111100111111
11011a0b20110110022202200022222122001111111011111111101111111101120121121220112220011102222222110111110011110101101111110111011111111110101111100011110111111111
11102a1b22112220202122221202202112112211110011001111010111011111112222102222110221020220011121111011111111101111111110111111010011111111111001101010111101110111
11112b2b12220222212221220222222222122201010111111111111111101111021101212212120001211122122011120111100111111110101111111100111111110111111111111111010011111111
01112b1b22201000212022222221200211012001111011111110111111111110120222202022111100122011212020111101011111100011101111101011111111111111110111111111111111111111
11122b2a20212101202210220122222222221111110111101111011111101111122110121211210222221122021022221011101110111011101111111111111011111111111111111110111110100111
00012b2b22211212012122002100201212110101011111101111110011111110110120010201220221021220222110211110011111111101101111110011111110101011111110011111101111101101
11010a2a21212222212022202100022222112211010111101010101111111111111212000101112102110111120210210111111101111111111111111001000111011110111111111011111011111101
10122b2a22202221222222220122202020221101110110111011111110111101121001220201202002222210202121020011111001110111000111111001111001100111110110111111111011111111
10121a1a21102222022211222022221212222211101011101111111111110100101222011200222122121121111121211101111111111111101111101111010111101111110101111101111011101110
01111b2b22220222122222121220222202011211111111001110011111111111020022112011110202122210112220010111011011111101111111111111111110101111111101111111011111110111
11112a2a01122212201100222122222022120111111111101110111111111111022112202212221110121212201020201001101111111111001111111111101011101011011111110111111101111111
11011a2b22221121021022012221102221111211101110110111110111101111101121222122002122221111102011101011111111101111011111111111100011110111111111011111111101111111
11121a0b01202102122222221022021122112011111111111111010011111111122010102111121122122021012122221111010111011111111111011102021110120202011211000002120210111111
01111b2b01111212221222222220122221012111101111111101011100111110101121122202201110211022122021221111111111111111111011101110211021122210110212211001121221011011
11002a0b20222221121202210221222022012211111111111101111111111111111101111211211121100002222111210111101011101011111000111112220110211222120021222112110002111101
11121b1a20122211121111100220210220110001111111100110111111011111022120101100101122221212212200121110110111011111011011111111212012002210012210211212121220111010
10110b2b20222212221220122122222022111021011102121210200111021110111111021111202121021221021102221111111111111111101010111112101021222122210110022111122212111010
10112a0b22202102112122220202220222101202202111122102122201111111112111122111211121221110122121201111111110011110111111111100212210101221202222021201210010111111
00110b2b02102200222222210202222222022210120201121110220022212010121001211222202122210212200222211111110110111101011111101111210220020121111221000221112220111010
11101a2a12022222222022022221022222022110121020122210121012122011110220212121221112002210212021110111111111011111111011111111222201001100111222212221221222111111
00110b0b21101222212222221201221202221222112211011122121121210201122212212201121212011200121201221110111111111111111111011011221211112222222101022111220001111110
01101b1b02220222222211222210222021102220120202112222201112222101002000120211112112201011122002221111111111111111100110001102121121010201122012122100121111110111
11122b2b12020200222202221020222122222211102212022222221212202111122220212211221121212101022201121111111111111011111111101012212011112001222121102221022210101011
10112a2b12220212000222202222121222212221220122221200222022211201002222221021121202120111200220221111111110111111110111111112210122021111212122112200222222011101
11111a0b21201201201222111121002211111221002122112020201122022211111001100001111111001111111111011111101111110111111110011111012121112110221212110112121122111111
22100b1b20201122221012002202022201221210211120220221211121202111110101011110011110111101111111110111011111101011101111111010110120112212112221120012020220111101
22212a2a22202022202202212220212120212212111022110201122212112011111001111111001110111111101111011111111110011101110110111111022110221202121011210211120011111101
22012b2b02221220222222222022222222002222211212121112211121200211111111101110111110111011100111101101101101111111101100101111221210111112201202122210120222101101
22011a1b10221221022222222011221202022201112222122201112122120011101011111111111101111011111111111101111101011111110111101111012010010102021012221212110112111111
20211b0b12220212002021220202202211222220221210221211112001001111010111110101111111011101011111110110111110111111111111111111020101112201102222222200210121111111
02002a1b22001212210221220220022202122210210122221012222222022111111001111110101111111111111110111010011011111111101111111012110011221211212011111212000211011010
20121a1a02202220202211211121110010221112220201220002111120212201111111111111110111100101111111000111111011100101111111101111221202121000222112221001220211111110
21022a1b110122211202211121210102020221121020210011011012121022111111aaaaaaaaaaaaaaaaaaaaaaaaaaaaaaaaaaaaaaaaaaaaaaaaaaaaaaababababbbabbababaabbabaaaa02201111011
21111a0a122210011212122111121211212020110101201212121111112120011101a1011111101111011111111011111111100101101111111111110112201210221202020112211012a21222111100
12201b2a121212121012111220122121120222201202111122202121120120111110a1011111011111111111011110111111001111101111111110111010121111112122121111112211a12202010111
20012b2b122111122121012202122211211121002211121022120210221020111011a1110011100011111111111111100111101101111110101111111011121111001222221211122120a12011111011
21211a2b012222211001212201220221210021111110112111222222102011111111a1110111110110101111110111111111111111111101111111110111121022111200221212212120b11101111111
11001a2a111212101121210211110211202112220211112220212212121211101011a0111111110111011111110011011010111011111011111011111100111222121122122122112120a22222111111
11012a2a100222222120102221122120112221100201222121221001111012111010a1110111111110011111111001110111101101100111010000011112212012221222121220202202a22201011111
22121a2b110122111220020121121112121220222211122121212211201212110111a1011001011010110100011011011111001111010111111111111102201212122202121211121212a22011101111
22222b0a021012110220222002222202212122021111220122110010201021110111a1101111111111111111110111111111100111111111110111111111221212122122222222121211a22110001111
22222a2b202122212112221011212202100212211020121222101100021221111011a1111111111111100111111111110101101101101111100111111111221122121021211122122122b11111110111
01100b2a111110101122210111010111120112222221121212010012122222111111a1111111111001110111111111101111101011111110111110110102221222122020002122121111a12222100111
21111b1a212100001210111221211202110212120112111211201201112220111011a1111111111111111011111111001111111111111101111011111100101111111011111111101101a11111111110
21110a0b200101221111020001010221221111210202210121211222220111011110a1011111111111100101011011111111111110101111111111110011111010111011111110011111a11101100101
22222a0b211122111122021112222012012112211121112022222212112112101101a1111110110111111011110001111011111101111011111111011001010111111101111110011111a00110111111
02012b1a112201102222111211111021012212222102122121100102000100011110a1111010111111111111110111111111101111111111111111101111110111011111111000011111a11100101101
11222a2b011210222122102111022121111111111111111010111011111011111111a1011010111111111011111101111111100111011111011101111111011111111111101111111101a01111011010
21110a2a200022211101001110011211110111011101111011101001100111111110a1110111111111111011011111011111111110111111110111111111011111110111110011111111a11101111111
00110a0a222120120110120010121021011111101110011011101011101111111111a1111011101111011111111111011011110111011111110110111111111111001101110111111011a11111010111
22122b2b121112120122121111012001111111011111111111111011111111101001a0001111111111111111111111111111111111111111111111011110110111101111101111111100a11111011101
12202a2a210211211211100222100111111111111111111111110111111111111110a0111111011011111111111101111011111111101011111001101111111100100111101010111111a11111110111
01100b0aabbbaaaaaaababbaaababbbaaaaaaaaaaaaaaaaa01101101111111111110a1110111011111111001101111111111111111111101100111100111111111111011111111010101a10110011011
21212a20111111001111101012211121111111111111111a11111011111110011011a1111100111011011111011111101110011110111110110101101111100001111100111011111111a11111110011
01211a11202222212012000102112221111101011111111a11011011101111110011a1010000111111111101011001111101111111111111111110101110111111111111011011111111a01011110111
02201a02211102222102212021110011111111111111111a10011100111111111101a1111110111111111111110111111101111110111001101111111011101111110011011110101111a11101001101
10101a01111111111011111111111010111101011111111a11111101011011011011a1110111101111110001111000111101111011111101111000111111001111011111010011111110a10011011110
11101a01111111101111111111111111111111101110111a00111100111111011101a1010011111101110111111110010110111110111111111111011011110110111111111110011111a11011001111
10111a10111101101111111111011110101110111111101a11111111111101110110a0111111000111101001101101101111111110111110111111110110111111110011111110110101a11011111001
01111a11011111011110111111111111011101111111111a11111101101111111111a0111111111111111111111110111111001111110011111111111111101101111110111011101111a11111100011
01011a01111111011111111111111111110111111011101a11111111011111101101a1111111111011111111100111111100111101011111001110111011100101111111110111110111a11111100111
01111a11101111101110111111111111111101111111111a11011011111001111001a1110111111101110111111111111111111111111111001100111100111011001111111101111011a11111011111
11111a11110111110111110111110011111111110110011a11101111110001111110a1011101111111111111111101111110110011011111101111011111001110011011011111111101a01011111111
11101a11111111111110011011101111101111111011101a11111101111111111101a1101101111010010101111111111101110101101110111100111110111111111111111001101111a11011111110
11011a11111101111111111111110001111111011101001a11111101111110011111a1110110111111111111011010111111111111111101101111101110011111111101111011101111a10111110111
01011a10111101111111011111011110011111011111111a11101011111111011111a1111001101111110111010011101110110111001111111101011111111111001111111011101111a11111110111
01111a01101001110110010111011011111111111110111a11111110101111110111a0111101111001111101001111111010111111111110111110111111101111010011001111111111a11111110111
11111a01011010110101111101111101111111110111011a11111111110111101110a1011101011111100111101111110111011110111101110101101111111111111101111111110111a11111111111
11111a11111011111111011111111011110101111111111a10111011111110111111a1011111111111011111111111111111110011111011111111110111111111111100011111000101a11111111110
01010a11100100111111111011111011111011111011111a11111111111011110011a1110110111010111101111101101110111111111111111001111111111110111010111010111111a01111100111
10111a11111011011011111011011110011111110111101a11111111110011111111a1111111101011111010101111011111001111111011111111111111011011111111111011111111a01111111101
11111a01110111111111110101011111111100111100011a11011011110011110011a1111110100111111111011111011111111011001111111111111111110111111101111111111011a10111111110
11111a11101111111101111111101011111111111011111a01101111001001001110a1111001100010101111111111110111111111111111111111101011111111011111110101111111a11111010111
10111a01111111111111011111011010111111110011111a11111111101011111111a1011111111011101101111110111011011111001111110111111011111111110011111110110101a10111011111
11111a11111111111110111010100111111111111111111a01111111011111111111a1111111111001111111111111111011011010101111111111110011001100010010111011011111a01111111011
11100a11010111111101111101111011101011001100101a01111111001011011011a1011011011110111100111111111011111111111111011111111111111011001111100101110111a00101110110
11010a11111111110111110101111111111111101101111a11111111011001101111a0111011011110110111111111011111001111110101100111111010111110011111111111111111a11011111111
11111a11111111110111111110011100011101011001111a01111001111111111100a1111111110111110011101111111111111111101101111110110111011111111111101111101101a11110001111
11101a10111111101001111111111111110110010111101a00111111110111111101a1110110111110111111111111111111111111011011111010111111111111111111111001111111a11101011111
11111a11010111111111111010110111101111101111111a01111111110111111011a0111111111111110000111011101111111111111101110111011101110011110110110011111111a11111110110
11111a11110111111011111111111111010110110111111a01110101111011111111a1111111111111111111101110111111111111111111111111111111111111111011010111111011a11111111110
11111a11111111010011201121102220102210202012220a01111110011111101111a1110110111111110111111111110101111111111100111111110110110111111101001111011111a10110111111
11111a00111111110022110221110121111002212210012a11011110111011110011a1101110111011001011111111111111111111111011111110111110111100111010111110100100a11101011101
11101a11111111110002202102200022112120222222212a11111111111101011011a1111111111011111011110111111110111011111011111111111110111111111111110111011111a11110101011
10111a11110110010111112102012110201221211202110a11011111111111111111a1110111101111011111111111111011111111111111110111111011111111111101111101111111a10101111011
10111a10111001111121211220212211221111200112120a11111100111111111111a1111111111111111111111111111111011110111011111111111111111011101101101111111111a10111101111
11111a00101011112122211001121020101221122021121a10110111111011111010a1011111111111101111111111110111111010111111111111001110111111111111111110111011a11101111111
01111a11001001112212111021120212022112121112022a11111111111100101110a1111111110001010110101101101111110111101111111110101110111011101110010111111101a10011111111
01111a11001010011122220102211021212222122022121a00111101111111111111a0011111011011111110111001100111111111111110111110110111011111110111101111110111a11100111110
11111a01101111111112212210220211101201122112210a11101111111001101011a1111111111111110111101101111111111111111111111011110011111111110101111011111011a01111111011
11111a11110100111111111211111120111122101002122a01110100011111101011a1111110111111111011101111111111110111101101111111111101111111111111111111011111a01111111110
01101a01111111002110120011020020211111120000111a11011111111000111110a1111110110111011111011111111111011111101111111110111111111011101110111111110110a11101111111
11111a10101011101212121122202102111021012001121a11100111111011111111a1100101110111101110110111111111111111111111110110011111101101101111111111111010a11110111101
11111a10110111111111211101211122211220221122121a11111111011111110111a1101011011010101110011011101111011110110110122211210211022112112110012101011111a11101101101
11111a01110011111221101022011110121101121022012a11011111101111010110a1010111110110111111110110111110011111111122221021222122222122021102021010110111a11111111111
11011a11011111112021222222211022202112211121201a11111101111111111001a1101111011110111111100110111110111101110101202120011211020122122011221111111101a01111011110
11101a10111101101112021201121211102121121121122a11101110111111111101a0111011111101011111010111011111111100111122222010212021021121101011212221111101a00110111101
00111a01110111012102001002121110112101201111122a11100111100111111111a1111011111110011100011110111011111111101110122121212022112211212210101110100111a11111011111
11111a01111111112112102221111211112111101202011a11111100111111011111a0110111011011111111110011011100101010111122112021112210022211121022012121010111a11110011011
11110a11111101112112122222012111121222121110101a11111110111111110000a1111011111111111111111111111111111111111110211121121011221211212022111111100111a11110111111
10111a10011111112212011220112021201210212011001a00100111011110101011a1011101111101111101111111101111111111000020101111120011112221100101121220110011a01000111011
01100a11111110110102221121220101002211020122221a11111110111100111111a0011001111011110111111111111110110111011122021220222212110212201122122101111111a11011111111
11011a00111111010022022120111111011212011220212a10011111001111101111a1111111111111111110111100110111111110111112122111201111221022122012202111011111a00111111110
11011a11111111111221012012212012022001121221100a00101111111110111110a1111111001110011111111111111111111001111112112122012202210212212110021121110111a11001111111
11111a01111111012101021212222211211211021101121a11110111111001111110a0111110110111111101111111101111111011111102110010212212202122111111121220111110a11100101110
11111a11111111111202102211120120122121111222112a10111101111110111111a1101110111110000111111110001111111111111021022112100101001201222221221121111110a00111111001
11111a11111101101121112012120111211002121201201a11011111011011111110a0111101111011111110101001011111111110110101012111022121101102221121220221111011a11011110110
01100a10111111112022202221012020222020110222101a11111001111111111110a0011111100101111110111011111010110011000121111122221211201211012022122201111111a11111001011
11111a11111001111121212112121112212110210211021a11101111001111111111a1111011011111110011000101111000111111111122221111100111200110112102202220001111a11110111110
11010a11111111111112211202101012221211221021221a01100101111111111111a0111110111111111111111111111111101110100111022112210222121011211221211110011111a10110101101
10011a11010111111202022112220201122222222220002a10111111111101111111a0011011111111111101011111111111101111101101120002121120112122212221102011110101a10111111111
11101a10111010111200222022211122200012111122221a11001101111111111101a1111111111011110011011010011011111111110101222211021110200012020222201110110011a11111011111
11111a11111110111011010111011101111111111111101a01010111111100101111a1111010111111111101111111111111001011101110222001111120121221111102220011110111a10110110111
