106 0
10 114
22 23
138 34
46 38
18 4
125 115
31 103
80 5
1 47

01111202211221112111201201112211120111110111011111111111001111111122222011110000101222020212a0211111a11111111101011111101101111111111111111011111011110101111111
01102202121121100021211210102022210111111001111111110110101110111221121011012212021222010201a2021111a11111110011111101111111111111011111111111111111010111110111
11121111210222012211111021211021010111111111101111111110111111001122221112221122221211120212a2121110a01110110100001111001011101010111111101111011101111111101110
11101122220010120010122211021112201011111111110110111011111111111121222212101211122122012102a1221011a11011011111111111011111111010111101111110111111111111011011
10020111121112011222221012111210210111011110111011101011111011110022202121121212022012110112a2201101a11110111111111111101110111111111111101110111111111101111111
11021212122011121110112220111122120111101100111101110110111111111101210122122112210121120221a2111111a01111111100111111111111111011110101110111111111111101100110
01102121110122112011211212110012121111111111010011111101111110111110212221101221202222020200b2111101a11001101110111111111111011111101111111111111100111111111111
11121210212200101112020112211110111000111111010011111111111000011201211101011220220101112211a2101011a11111011111111100111011111011011111011101111100110111111111
01122020221222222020222222221121022121111111110110111010001101111112012212211021102211222120b1201111a01111110111111111111111111001111111101111111111101111110011
00111112211122221220200012220200221121111101101111111101101110010210112200112122222021202200b1220111a11111111111101111111110111110110010011111111101111100111011
11121211220122222202102222022221221120111111001011101111111011110221102120012111122122220011a0120011a10110010101101111111111111101011111111110101111111111001100
10110122222022012220102222222002010121111111011010101111011111111221112121121122220122122011a2111111a11111111111111111111011111110111110101111011111111011111011
10102222122202221022022221211102211222110111111011011111111111110112110221102112211110022102a0101111a10011111111111111111111111111010111101111111100010010111110
11011212012122221022220211221221121221101111111111111111111111110212222110111020012212111011b1011011a10111011111111111111001111111111101111011011010100111001111
11011112222222221102201212021211220212111101111110111111111111111211112200110212112221221122a0111001a11111111111111111111011111110110111101100100110111011111110
11121122222202222022001122000202012211111101111111101110111010111111212011221101222212122202a1210011a11111111011011111001011101110111111111111011111101111110110
01110110010222122222011222222222220012111111111111111010011111111122101101122011211010020211b1001110a11011110111111101111111011111111101100011111111011111111110
11121222221122212222211222021101202212111111111011001101101111110112112110112000222220112212a2121111a10111111111111101001111111110110011110011111111111110111101
11112002022221220222212212211202221222111111111111111111001011101211122220021120121121010121b1121010a11011111111010111111111111111011111111101101111111111111101
01102022222222222120202122200202222212111110011011111110011111011212220101201101111221122211a2111111a11011111010110011111102211201111012221210101112221110101111
aaaaabbbbbabbbbbbabbbbabbababbbbbbbabaaaaaaaaaaaaaaaaaaaaaaaaaaaaaabbbbbaaaaaaaaabababbbababa1121111a11011101010111111111111101212211122112122121212021112110110
1111201222200122110002121202122102211111101011111111111111111110112111120212111112110010001201101111a10011101011011111111111111210211111010212011112201121011111
aaaaaaabbbbbbbbbbbabbbbbbbbbbabbbbabbaaaaaaaaaaaaaaaaaaaaaaaaaaaaaaabaabababbabbabbaaaaaaabbaabaaaaaa11111011011111111011110011111120111120210121121122212111111
1101122222211211221122122101222120221221211210202211011222212101122110021121122011212120212111120111011101101111111111101110111220220020202110011202112220110110
1112122022222220212200212221210221121221002122122222112020221201002212211211222201221201101100111011111111111111111111101111220111201211121211111211112201111111
1112120220012121221022220222221122112011221201222012211201122101111202122222110221221111222122010111111001111101101111111111012112102112212111212101122211111010
1002221211222122222212022221222202221212000221221110121211202011121222120221021101022120111122121111111110101101110101010110220222111101112202220201112102111111
0110222121101222022201120220211200222220011010121221001221122110021111112121122211212221021211221111111111111011111101111112101111011100211012212022012212111100
1111210220200222102222220222021222022101122100220221202011111211121102020021222212212120010121121011101111011111111111111012110210210212102100022210112012111111
1111121002220222002112220111100200012101222212202011111222102111110211020222200022101101121220221111110100011110111110101002210121121202121221102022220212111111
11112222222200222202bbbbbbabbbbbbbbbbbabbbaabaaaabbbbbaabbbbaaaaabaabaaabbbabaabbaaababaabaaabbbaaaaaaaaaaaaaaaaaaaaaaaaaaabbabbaaaabbbaabbba2122011012222111111
11111011201011220220a11211012010222200202202111121221011221222010100111111111010110111010110111001011100110111011110111101121220112122222020a2202020220202110011
00122221222211221122b22222211220221120102011102201001212212102101110101101011110111111011111110111111111111111111111111110111202222011221112b1221111122020111101
02111210211122212120b22222221121020111020020202111122111212021111111111111111111111111111111111111110001111111011111110110021112122102201112b1211020112020001111
22120120222212122212a22200221220121120002100101101122211111212101111010111101101101111111111101111111011101111111111100111121122112212221102b1111221010111111111
10202111222222221212b12222220222222222212021220211100120122122110011101111111111111011111111111110111111011110010111111001122221211220101022b1122111121212111011
22220220001222222112b20100102222211221102122220211121222010211101111010111011101110011110111111101111111010111011111101011121120012101202221b0200221122201000101
11110022120221120212a00122101221012022101211222210210011121121010111111111111111110101101111111011111111111111111110111111021012212212001212a0102102110021111011
02120100002221212221b02220022111222122220021011001202110212211111111111111111111111101111101011111111101111101111111111010122222001022211010b1202221211222101110
12120200012222120110b01210121211111122201221111220002122001012111010111101111111111111111111111111111011111111011101001110112212022101212220a1122120210201111111
22220110111221221212a11111102102121211120000110211210002211122111111111110111101111111110111011101111111101010011011111011120101011112122102a0111220211112100111
21221022122012022101b22100111112101112122020222020202111222120111011111111111101101101011011111110111111111110011011111111111221102121001121a1011121121222101011
21211000221001021210b11211220202122102011112222122102020221122111111011101110101001010111110110011011110111111111111101110120002122212211120b1221222122110101111
11111112122220012011b21111110211101000122220121110221111120220110011111111111000011111011101111111111111001111101101011111122201222121122202a1202120022120111011
22022121001212111011a11121101111211220112120111121120012121111111010101011111011111001011111110111101111110111101101011111122212120200210200a1211212120120111111
21110201020122112212a22212211222212121211222102221210121201222101101111111111111011111000111111111110111110101111111111111121222011221111111b2200110221202111011
20102221021200221110a20012112112222211210111212200010222022110111111111111111101101101101110111001111111111111111100110111122021102200221211b2102112121221111111
02221210121122120102b21112012210221221220112212011110011110201111111111111111110111111011110110111110111111110111101111111101221102210211012b1122102211021111010
21010120211001120122a00121112222120011221221021011112112102212111011101011110110101111110111001111111011110111100111111111111222021120222021b0020011222001101011
11111020022212211112a12122221111110111202202111201221012111112111101100110010111101011111011111011011111001011011011111011122002201212200200b1221101101222111111
10111222211022222222a21022111112101111111112102121220012202212110100001101010011111111011011111110111011011111011111111111111111000111111111a1111110111010101110
21012011121112110022a22022101221110011120221002022212211212201111111011111101101111110111110111101111111111111101111111110111111011111111011a1111110011101111011
02011021002112110212a01222121212022112110121121112220122212120111101011111111001111111111101001011111111000111111101111111111011110111011110a1111011111101111111
22112021222101011212b11220212012121202120221121211212222012202111110111011101010110111111111100100001111111111001110110111111100000100111011a1010101111110111110
21012212222112221101a22211012220111111111101111110010111001111111111001111110001011111011111011111011111011101110010101111111011111111011100a1111111010111011111
21111111110210120211a22212022111111110111011111100011011110111111111011011111111101111111101111011111011110111111010111010111110111110111111a1101011100111111011
12120120002211111020a10200110011111111111111110111011101101111111111111001100011111111111011111101111001111110110111101001111011110111000111a1111111110010111010
11012101222120222112b11102120011111111111011111111111011111011101110111111111010111101111011111101010111100011111111100111101101111110111011a0111010111011010111
22000211222020012212a11122012111111111101111110111111111111111110011011011011111110110111111111110111100111111110111011010111111111111110111a1111111111110111111
21010211120220101222a11221110221111111111101010111111111101111110110111111101110111010101011111111010101111101111111111111111011111110110010a1111101111111101100
12101110021200101222b21212121221111010111111111111011111111011101111111011101111100011111111111011111111111111011111111111010101111000111011a1111111111111111111
12102110201121211110b11220100120111010110111010111111111111111111011111111111111111111011111111011101111111111101101011011001111111111011111a1111111110001110011
11102220202002121222a00212022111101110111111101111111111111101111011111111111111111111110111101011111101111101011111011111101101001110111011a1110110111011111001
11101101111101111111a01111101111111111111111111111111001111111101110111010110111101111111101111111011011011110011101111111111100110111110101a1011111111111010011
01111110110101101011a10111111111111111111110110110001011111011100111111011111000111111111111111010111111100111111011111011011111101111111011a1111101111011111110
01101011111011011010a11111110111111011110101110110111111101111111011110111001111110101011111010010101001111111101010111111101011101111111011a0011110011111001110
11011111101011110110a11111111111010100101011111110100110101000101111101111110111000101111111110110011110111110111111111001101111110110111011a1111101111110111111
01110111100011111101a10110011011111011111110101010101001110111111011111001101111111111111101101111101111111111110111110111111111101111010111a1111111111101111111
10111111111111111111a11111111110111111011111011111001111111111111111111110011111101111111101011111111111111111001111111011111111111111111001a1111010111111111111
11111111100111111101a11101110010111111101011111110001011111111110111110111011111111011111011111111111011111011111111111110111110001111111111a0011111110111111001
aaaaaaaaaaaaaaaaaaaaa11111011111111111011111111111111111111011101111111111111111111111111110111111110100111010101111110111111111111111010011a1111011111000101011
11011111110111110101101101010111111111111111110011100001111100111101111111111111111101111111100111011011111001110111111011111111011111111111a1111110101111111111
10101111011111111011111111111101101011111111111111111111010001111101101111101011111111111100101111101011101101100111101111111111101111111011a1101111101111111111
11011110101111111010111110111111111110101101001111101111100101111010111101111011111011111111111001111110100011111111110111111011001110011011a1101111110111101111
10101011110111111111101110101010111110001011111101001111110110111101111011111111001011111101110111110110111110011110011101111111111100110111a1011111010101101111
10110111101110111111110101001101111111111011111101111111110110111111001101011111100011010111111011110100111010111011111111101111111110111111a1111101100111111111
11111101111111111110101110100101001011111111111111111111111001111111111111111111111110101111111111111101111011101111111110111011111110011111a1001101111101110111
11110011111111111111110111011111111111101011101111111000111111111111111101010011111010111101111111110111110011110011111110111111111111111111a1111111111111101111
11110111110111111111110111111101111101111011111111111111111011111111110110101010111110110101111111011101001001011111111111111110101101101111a1111111111101110110
11111111110aaaaaaaaaaaaaaaaaaaaaaaaaaaaaaaaaaaaaaaaaaaaaaaaaaaaaaaaaaaaaaaaaaaaaaaaaaaaaaaaa111100111101111101101111111111111111111110101111a1111111111111111111
11111111011a1111111111010001111000011101111110100111010110111001100111101101111111111111110a110111111110111111111110110011101101011111111111a0110111111111100011
11111110011a1111011101111111111111101111111011011011101111011000110111100111111110010111111a010110111111111011010101111110101011101111111100a1111110100111101111
11111101111a1001010111101011111111111111011111111111011101111111011010101111101101111111110a111111111100111111101111111111101111111110101111a1101110001000111111
11110111111a1100111111101110001111111110101100111101111011101111011110111111111101111101111a110011111101111100111111110111111111111101111111a1111111110101111101
11110101111a1111111110111111100101111110111111111100111111111101101111111111111101111100011a011111111111001111111111111111111111101011011111a1111011011111101011
11110101111a1101101010111111111111010111101111111011111111111111111011101111110110111111111a101111111111111101101110111111101111011011011111a1011111100111101111
01111111111a1101110110111011110111011000111110111111111111011111111111111111011101111111111a111111110011101111101101111011111011111111110111a1111111100010111111
11111111111a1111011111111101111111101111110110110111111011111111011111111111111111111111101a111111110111111111011111110111111111111110111111a1101111001100011111
11110111101a1001012011212212022220202022221202111111101111111111111010111101111111011111011a101110111111111111000111111111111111011111111011a1111111111110111111
11100111111a1111012211202122212121010212212202111111010111111101001101101110101011011011110a111011011101111111111111101111111110111111100111a1111001111111110111
11111111101a0011212111110110220201111211021110111101010110111110111111111011111101100011110a111010111111010111011110111111011111111011001101aaaaaaaaaaaaaaaaaaaa
11011110111a0010211202112102001122211220220011111011111011101111101101100111111110011111111a11111110111011101111111110111111101111101111011101100111110111011011
11111111111a1111222222112212021212121022121110111011111111001111111111101111111110011001011a11101110111111001011111101111111111101111111110101111111001011111011
11100111101a1111222222122122121110212022222220210110111111111111101111111111111001000101110a10111101011111111111111001011101101100101110111001111111111111111111
11111111011a1111011222221122222220011200111011011001101111111111111111001100101111101011111a11000101111111110101111011101111111110010111111111011110111010111011
11110111101a1010021202110201212111122210221112111111111101111100111111111100111111111111111a11101111011111111111111111101011111111111110111111100011111111100111
11101111011a1011122122222212011211111011121111011101111111010101111010111111011111111101111a11111111101111011111111101111011111111111010101011111111111111101111
00101001000a1011122122202101121022211202112211211101111101010111011101111111111111110111111a11110111011110111111101110110111101010110100111111101111111110111101
11101111011a1110212120020112010111222211211101111110111001110111111111111101111001111110111a01111111100111110110101111011111101101011111101111110111110111110101
11011011001a1111112012121120222201121002102211101111011111111011111011100011110001110011111a11110011111111110100101111011111101111111111001111100111110111111111
11101101110a0111100220101212112002212120210112211111111111111011101101111111111101110111111a11110101111011111010210101121101112222011122210101111101011101111111
11111111011a0011222112211202201110112222211022111101110111100111111111011111110111010111111a01111111111101010112222111122112022111112112111011001101111111110111
11111110110a0011211112012120212221210221211112211011111111110111111101101111111111111101111a11111111101001011121210212222122110022122011111121110011101100111110
11111111111a1110122112212222211211101112022011110111110111110111001110011111111111011111101a11111110001011111112202222220220221221012121211121111111111111110111
11011111101a1011002112121112021202001112211201211111111001111001101001110111100111111111111a10001101111110111102101202010101121221210121121120110111111011101111
11111111111a1111122212222212120110212121112211211011011111110110101111111110011111001101111a11110110111111011110011202112222020222222122121111011101111111111100
11111111111a0101120012212121020102122022212110211101111111101101110110011111100011111011011a11111110101111111012221012121221222202100122100101111111111001111110
01110101011a1011112022022212201210212122121022111111110010101011110111101111110111101111111a10011111111011110120222012222010011111122112212111111111101111111101
11111011011a1101022001121221202212020111012001211110011011111110111101111101011111100110111a10111111101111111111221111222210112020022111021121011111111110111111
01111010111a1001222010221211222112202111111022211001111111110111111111111111111110111110111a10111001011101110012120222022222212101022212102021111111111111011111
10001111101a1111112021221122212021221011220201211111011111111111111101111111101111111010111a11111110110110111121102120212122011122121222022121011101111111111011
11110110100a1011112121001022210010221021211211201111101101001111111110111111111011111101101a01111011011100111122222020111222022122122011211011101101101111011111
11111111111a1111200222101112212020111012122210100110000111111110111110111011101111101011111a11111110101011011111210202110210012221120111221011101111111011111111
01111111110a1111210210020211201020222021211211110000111111111111111111011111101101101111111a10110111111111101102110211011222012101112012211221101011011110010011
11111111111a0111221021101011212222120222011220111111111001101111111111011111111101001111110a11011111101001101111221210201020122112220102212221110111011010111111
11111111101a1011121101202012122112101121212120111011110101011101111101111011011111011111110a11011111111111111122120121021202020101011111222201111111111111111111
10111101111a1111212022021201211121102212002220111011111111111111111101101110111101011011001a00010110111111111011221202020110202011012112120211101101111111111110
01111101100a1101220010110202122201112102121012210111111010110101111110111011110111101111110a11111111111110011101221101122021102222211012222221111010111110111111
11101111111a1111221020202121112102012101200101111110111011111111011111110111010110111001111a11111111111111011110220011020121022110002112001011110111111011111111
01011101101a1111111111111111111110111111110111011111011111111111111111011111110111111111111a11111101111101111012221201122221111201111212222200000111111100111111
