106 0
10 114
22 23
138 34
46 38
18 4
125 115
31 103
80 5
1 47

101b201212a211120212001211120012020111011111111111110111111a1000112101211211011222022101202122121111111111P11101110111001110111111110111111001110110111111011111
111a112012a011100202112111100211121111001111011111111111111a11110111220212121202111212201212221110011111110P1111111111110111101111000111111111111101111111110111
111a120112a112102111222110112101021111111110111101111111101a11110211212122112010112122221221200210111111110P1111100111100111111111111111011111100111110010110111
111a201112a101210212111121212101001111101111110111111001110a11101210120221212121112012012200222011101111111P0111111101110111111001111111111111111110111110111111
111b211012a101222112122201211100221111101101111111011010111a11101011100011212100011021201110112011111111001P1111111011110110011110011111111100011001100111111111
111b002121a122201111200111102221220110110111001111011111111a11111102001222112112011120222021120111111111110P1101011111111111111111011101111011111111111111111011
111a022211a202022200021220220222111101010101111111101111111a10110122212021202102222210200220112010111111101P1001111111110010101101101111011101111011111111111111
111a212002b001110110001211211211000101111111101111111110111a11111111211010210121121221110121201100111011110P0111111111101101111111101011101111111101110111111111
111a200201b222222222222111020020020122111100111110111111111a11011020122201122211021022002120121211100110111P1111111110100111111111011111011111111111111110011111
011b221212b222221222122222202012220120000111010111111110001a11010011122200200202002200001120220211111110111P1111010111110111111111111111111101001111111110111111
011a211202b222220202102220222120222101100110010111111111111a10111211211220212221111102202221022211101110011P1111110001111111111111111101011110111011111111011111
101b022122b200121012200011222222221022111110111111111011011a10100212211112120022220212211111121111111101011P1111011111011011111001111111100111111111111100101111
111b111220a220222212022210222222221211001111111110000111110a11001220121210212222121112102212121111110011111P1110111011111110001110111111110011111111110101101100
111a202222b022212222022202221110210212110001101111101110101a10111222212010121220122020221202212011110011011P1110111111110111111111110101111110101111111111111111
111b110212a012012220122112202212121112011111111111111111111aaaaaabbaaaabbbbaabababababaaababaaaaaaaaaaaaaaaaPPPPPPPPPPPa1111011111111011101111111111111100011011
111b110222a202222201002112220212221111111111001001111111110111101112110111111211211121021022101001111111101111110101011P1111111111111111111111011110111110111111
111b201222a012022220121221012121112221011111111111111111111111111002200101011211010011222022022201111111101111101011001P1111011111110110111111011111101111110111
111a122221b222122002122222100120212121011111101111001110111111111221211221210221100210120220122111111111110110101101111P1111111011011110001111111111111111111011
111b221220a022222022222022012222121002110111101101111110111101101012121022221212020002211120211101100111101111111111011P1101111001111011111111011111110011111111
101a220222b000222020222202022021221211011111111111111111111101101211201110100011122122022222122111011111110111111111111P1101221201011201220101220212221202010111
111b222202b222222222022110222021121201111101011011011111101111111121110202222222210221212212012011101111100111011011111P1110212202001211212012012212202110111101
011b100220a222122122022222222022222112100111111111111101010010011121210011211111111222221021111111111101101001111111011P1111212222000212121210122200221102101011
101b100222b202222221210111200022022221111111111111011111110111111122211101222012002122112202122111111110111101111111111P0011120110101222122121102121111222111110
111b111120b212222220122220222112220220222211111202112222012212010211002020010112120120011101101201011111111111100101111P1110201000111211200212222222222212011110
101a211221a212221020022121022220221202122112220120222200112020111122101101112222022111102221211211111011111110110100111P1112221220102211122220012202101122111011
111b012220b222212212222121111221221202202202220112201220122110011111111101012220202201122211111211111101111011111111111P1110121201122010002220212212111111111011
110a022201b012012111122122220222221222122201102202010112212122111121122122102121122211102201021011011101101111111110111P0112212110101002122210122101112210111111
111a010212b202101222202202221122210100101110210012120212101220110022012222212012012211111221122011111111111110111111111P1112111111021221212122120122222122111011
111a212002a212212102021212222202122202110212222120211121222020111222111100111122012211210010222011111111110101111111101P1100021222021212122122101112001110111011
111b122111b112002222210212121122221222102101220122122201121122111221120111121221212102202111211101111110111110101101101P1112011112111220211222221211112121000011
111a102212b221212022201222222221212021202111121021111211000200110102020112222111011222201121222211111101111101101110110P1112211121122112222112101101121222101111
110a101120b211201121121011212221202121212012111110111111211020111111100011111111111111111111111111110111111110110111110P1112112200221211210211000112121121011110
002b122202b122122220222212221120012022222012222021220221220121111111010101000110111101110110111110111101111111111111111P1111021020001212220222012121222022010111
211b002022b222001122222002112220222221210212220211220002202221111111011100101111001100101111001101011111011111111111101P0110001021122211122121212111200100110111
220a111122b12120012222202112212122221011101222211210121102000111011101111110011110111011111110111111111111111111101100Paaaaaabbabababbbbbbaabbabbbbbaababaaaaaaa
122a221212b2222212222112222221211222011002202211212201211210220010111111110111011111110111111110010111111101111011101P000102210212101220201210012211022211111110
112a111222b2222212220222202101212022021121120211021210112222221110111111110101111010011111111001111111111111111111101P011112102210111212021100010220201120101111
122b011222b2221220202222212010200222220012121120102110122222100101111111111010111111111101001101111111101111111111011P111100111122120112022221210221122221101001
121a112021b2222100120020121222212020201122022101212120212212221110111111001110101111011110111011111111111001111111110P011010221212112111220112220021121020111100
111a210022b1011212222211022122121112012210210220222121120101111111111011101011110101111101101011111111111011011111111P100110220121210111121122021121120011101111
120b112110PPPPPPPPPPPPPPPPPPPPPPPPPPPPPPPPPPPPPPPPPPPPPPPPPPPPPPPPPPPPPPPPPPPPPPPPPPPPPPPPPPPPPPPPPPPPPPPPPPPPPPPPPPPaaaaaabbabbaaaaaaabbaaaaaabbbbabbabbbaaaaaa
001b2PPPPP112010211222121121011202221211211202212112012121011011110111010111111001111111011111110111111101111111111110111101110200102202022122110222211121011111
122aP11220110222111212212111212121122101221221111112010122212110111111111101011111111110111111110011111101111111011111011110102122212112112111212120211111111111
222P111121112110010112222201202212102110120120122111212221212210011110111110111111111111111110011111100111111111001111111011021122012210121221221102211221111110
102P112221121022102121101101212101122102111110101212201121101211111111101110101101011111110101111111111011011111111011111111011201120111022102222121222220111011
222P221220211010011121201002212122211121212102022011212001112211111111110111011111111111111011111111011111111111111111111111112121122210112121002212012022111101
122P211201122211120111201110111121112222220201021211210110202211111000111101111111011110111111110011101111110111010111111111101111121202121211200012101112101110
020P122121021101112020211102111212121010120122221111102012101111011011111111011110011111111111111110011111110101010111111112020221221122211121120010202121111111
212P120011111111012112112120212111122222121201112111222212211111110001111111001111110011111111111011011110101111111101001111201101022212112121100222212101111111
122P211021222012110012222211111001022001111122122112121011111001111110011011011111101111110011111111010111111111011111011100021002110221001202122212221221111101
202P222222102201121120022021121122001010122020212102101112020001101111111100111111111111001111111111111101101110111101111011111010011111101111101101100111111111
222P211221221210222121122212021212110121212110102222110212110110010111101111111111101110011100011111010110101101110111110111010111111111111111111111111111010111
122P001121022212121212110011111211011201212112112212201102011010101111111111111101101111111111101110110101101111010111110111101011101011001011100110111101101111
112P1210211212101111220221102212021101011021110102212221211220111110111111110100111001110111011101110000111011110001111aaaaaaaaaaaaaaaaaaaaaaaaaaaaaaaaaaaaaaaaa
212P2221100020211122211212202011111111011110111011011111100001111101101101111010110011111111001110010111111111111110111a1111111110111101111111111100011111111111
222P2211101111100020101102102210111111011110001110110111111111111111111101101111011011111111111011111111111101111110111a1111010010011111111111111111111100111111
112P1201222121111222211112001221110111111111101001100010111111010111101101111111111111111111100100011111111100110111110a0111011111011011011111110001101111101111
112P2212222020211112110220121221111110110111011111111111111111101100011101011001111111101010101110111111111011110111011a1111111110111101111110111110110101101111
111P2020122122211212202222221101111110101011011111111010111111110111111111011111010111110111111011111111111111111100110a1110011111011111111111111111110111111111
111P1210211211022111110001212021111111110110011101101100110111111101111111011111111111111011001111011011111110111011111a0111110011111110111010111111111011100100
211P2221112220021201101221120111100100110111011011111111111111011101111110101111110011111011101111111110111010111111011a1111111111011111001011111110111100101111
121P2121011012221011222111112011111111011011101111111001111111110111111111111100011110111101111111111110110111101101101a1100111111111111110111111110111110111100
112P1212001220102110022101222201111111111111111011101111110111101111110101111110110111101110111111111110100111111110111a1011111111111111011111101111101011111111
110P0111111101011111010001111110111101100010001111011110011100111111111111111101011101111111111111111111111111101110111a1111011111111001111010010111111111111111
011P1110111001101110010101110111011111100111101111111110110111111011110011011111110111010010110111111111011110111111111a1101111111111111110001100111101011111111
111P1011110110011011011111101101011001011110111110111011111110111101110101011111011111101111111100111111110101111111111a1100111111101101111111110111111111111011
111P1010101111111011111111111111001111111111101111101011011111001101111111110101101111110111101001111101111101111010111a1111001011001110011111100101111111111101
111P1010111011111011101011111111111111011011111101111110110111111100111110111111111111001111101111111101110111011101011a1111011100010111111011101101111101011111
111P1111111111111111011111101011111111111111110101111110111111111111111111111111110011111010111011101011010111111100111a1011111111111110111111111011111111111110
111P1101111100101110111111101111011111111111011011011011111111101011111111111111111011111011011011101011010111101000111a0011111001011110110111011111111111111111
110P1110111111111111111100110111011110110111111110101011101101111011010111110111101111111001011110111011110111110101001a1101111101101101111111101111110111101101
111P1111011111110111111010111110001110011111111101110011111111001111101110010111010011101101111111111011101111111111101a1111110000111110111101111010111010011001
111P1111111010111011011011010111110111010111111101110110111111100111011111111111101001011111101111111101110011011101110a1111111111010111111011111101111111011111
111P1011111111111111111111111001100111111111111111111111101111111111101110110111111111111101111111111011111101111111111a0110111111101010111111111110111111111010
110P0111111111011111100111111111110111101110011111011101111111111011111111111111110101101011111011111110111011011110100a1011110011111111111111000111111111011111
111P1111011111110011111101111001110110001111111111111111110111011111111011111111011101111111001111001111111011111011111a1111111111111111011111011111111101111011
111P0111111101111111101111111111111101111110111111111111001111111111011100111110111111111110111111111111111101110110111a1100110111010111001011111111110011111111
111P1111011101111111111011111101111111111101011111111111011101011111111111111111111101111110001110111111011111101101101a1111111111110111110111110111101011011111
111P1111011110010110110111111111100111111111110011111111111110100111110101100011101011110011101111111111010111111111110a1111111101011111011111111111111111111101
010P1111111111111111111111111111111111010101111101100101111011111100100101111101101111110111111110001111010111111110110a1111111111111001111111111101110110111111
110P1110111010111011111111011111110111111110111111111111110111001111110011111101111100101111111011101111101111011111111a1111111111111111011011011111010111111111
111P0111111111111111010110111101111111111111011000111111001101100110111110111011101111111101111011101111111001110111101a1111101001001001010111010111111111111111
101P1101111111011101111100011111011111111111111001111111111011101011111111001101010111111111111101000111110110111111111a1101100111010011110110111011011111111001
111P1100111011111101011111111111011111111011111111011101101110101110101011111111110111111111111110111111111111011110111a1111111111111101111001111111111101111011
111P1111101101111111101010101101011111111011110111111001111010111111111111111110111010111111011111101111011111111111001a1111101110110011011111111110111111101110
111P1110111111111011111100111101111111011010111111110111011110011111101011111101110111111111111111111111101001110111110a0011111111010101011011111110111111111111
111P1111111100111010111110101111110111111111101011111110111110111101111111110101111111111111111111111111100011110111111a1101111011111111101101110101110111101111
111P1101101011111101001111001001111111011111000111111111111111011111111111111111011111111011101111111111110111111111011a1111101011111111111111111111110111111011
111P1010111000111101211110121122111122001122111110111111101101111010101111110111111110110011111111101111111111101111111a0101111111111111111011010111011110111110
011P1111111011111120111121121221221202220111122111111111111101111110100101011011111110101111111011110110111111100111111a1111110111111111110111111110111111110011
111P1011011100111111201211121001121121121111211111101101111111011110111011111100111111111111111011111101100111111111111a1110110010111101111111010101111110111011
111P1011111110102110021022001112201222021111122011111111111111111111111111111111111011111111111111011111101111101110011a1011111111101111111111111101011111101000
111P1111111101002121211222122220111020221110101101111101111111100101110010111111011011001111011110011111011111111101111a1111111011111110111110011111100111111111
110P1001101101110121212212220220211202112112211110111111110111111111111111101110111111111111101011110101110101111110111a0111101110111111111110101111010111111111
111P0110011101010212212211112111110222011112222111111111111101111111111101101111111111111011011110111111111111111101111a1011101011110001111111101111111111110111
010P1110101011102112222222222212122221020121102011101111111111111101111101111111111111111101111111111111111101111111011a1011001111111110111011011011101101110011
111P0111101111111101011210121212101122121220101011111110111011111111111110110110101110101111111111011111110111111111111a1101011010101111111011101111111111111111
110P1010111110012212201202202002122020222012102011111101111111111111111111111111111011101111110110111111011111110110011a0111111111110111111111111101111111111111
111P1111101011012101102022102120202110221222111111010111111111110111100111011111101111111111110111111010110111101111111a0110111111111110101101011111101111111111
111P1111101111112121210122122221211001012102201111011011011011111101111111111111010101010111111111011001111001011111111a1101111001111011110111111011111111011011
111P1111111111110120100011211000212112011120021111011011111110111101101010111111101111111110110101100111101111101202201b1121212201220221110111101101110110111111
001P1101110110010222111011021112211212122122112101111101111111110011111011111011111111110010101010111111010111012111120a0212102110211212212120001110011111111111
111P1110111110111222212221010121211022221110212101111010111111111000111101111111111110110111011101111010011111021012121b1211012121221222112211111101111111111111
010P1111110111101102211211112211120111122110021111101111011011111111111111111010111100101101110011111111111110220220222a0212012121101212211211111111100111110101
110P1111101111112201122212111102222101220110212100111111111110111011111111111111111111111111110001110001110111122121221b2002111122111122111021111111111111111101
110P1111101101112220210122221101122021022210112111011111101111111111110111011111110011011110111111001100111110221202211b1222100212111122221111111111111111110100
111P1111111111111202221222211200211212122212100111110111011111110111111010011111111110110100011000011011111110102011020a2110100212212101122111111110100001111111
111P0111101111101220002121122121221012211022112010011001111111101111111111011111111111110111010111111100111111201011012a1021212101022122211110011111101110111111
111P1011100101112121221022022021202121100222211111110110110100111011111101111100111111111101110101111111011111102222212a1112121010111220010110111110111111111111
111P1101010110112112122101021222111222211121221011101011110111101111111111110111111110111111111110111110111111201221120a1021222212111221111101111101001010111111
110P0011011101101112222202120122012121011211001111111011011111111101111111111110111111011111110101110110101111000220002b2012122120211002111020110101110111100110
100P1111111000102212212221122221122121212220101110110111110101100110111111111111110101111111101111101111111001211012220b1000011112221122121021111111111110011111
101P0111110111111111021101201221222221121111222111111011111111001110111111111110100110111111111100111011111111120121121b1120221120120111112221010101111101111101
011P1111110010111122101211211212110112100222102111101111101101111100011111111011100111101011101111110100111111011202021b1122221210222111220200101111110110011101
111aPPPPPPP111112121022211200021202212100222012111111111111101111111111011111110101100111111111111111111111111100221122a1012111111002222121101111100101111111110
111a1111111111102122110221212111011122222210222111011110111111111001111011111111011011110011100111110110111110221122210b0002111222022212012221001111110011111111
111a1110111111102222221112112112200202202122120111011111010111111111110110111000111110111011111101011111011011120122011a0121110012102212120220101111011110011101
111a1111111111110011122201221221120221021121001101110110111011101111111111101111111011110100110111111111001111112121102b1122120121112112122121010011101111111011
111a1111111111112112001222222111202122200220211111111011111111111111111111100011111111101111111011101110111111122201120a1100121120111202220200110111111101111111
111a1111001111101110111111111100111111111101110101111111011011101111111111111100111110111111111101011111111001211211102a2221112021211011010221111111111101111111
