118 19
96 102
22 23
138 34
46 38
18 4
125 115
31 103
80 5
1 47

01121112112111020221011001212111121111011111111011111011a1110111112021212211212211211220112122001111101111010111111111101110001000011011111a00111111111001111111
11121212211022122212212210011222111111010111111110010111a1011101120111021022211102020111121122001011011111011111011011111110111111111100111a11111110101111010111
11111011011202121212121211121021111011101110101101111111a1011111112011021221221202120111211201121110101001111111101111100101110111111110100a11111000001110111111
11121121222222120020211022022212101111011110111101010110a0011111022122110220222020212100121212221111100111101111010111010111011111111001111a01101011011101111101
00122121102102221212220212222212120111111111011110111110a0111111112012212212112222101110212202120111111111111110101110110111111110111111101a00111111101110111111
11111221222121222011211120110222011110111101101111111101a1111111122110222101212021122101102121221111001111010101011111111111111111111011111a11110110111110110101
10121121210101102200222120112210211011110110111111111111a1111001010111211111112122221211200211011111111111111111111101101111110011110001111a10000111111110111011
11122221102022222111100202002210211111001111110110101111a1101111022221111210112112222102111021221011011101111111111011111101010001110101111a11111101111111111111
01112222212122021022021022122121220222111111110111010011a1111111021121011202121210211112121121021111111111100011111111111110111111111111110a10111110110111110110
01100122122221221111220102121222202021011100111110101101a1111101122011201112122212021002221021011111111101111111111111111111011011111111101a11110111111110110110
11012122220200221220022120221222221211111011111011011111a1111110112000122022000111001202121110121111111111110111101011101111111011111100111a11110111010111011011
11121110020101222202120222222122020120011111101101111111a0111111122102210202212111121212202012111110111111111101111101111110111111111111111a11111111001111111100
11112122021101122210220222022202221221111010011101011101a1111101111122222112012010012212121120121111111011111111111111011110101101111101110a11011111111111111111
11022212211202200222122202221212202121111111111101111111a1011111122211000100102211121211112222000111111111111110100111011111011111110111001a11111111111111111001
01101011121202202021012020122222221021101111101001111111a1111111111111011202100002121012221201201111111101111001111101111110110111111111011a11111111110010010011
11120020220200222022200210220221022111110110110110111111a1111111121021211211222211122102120112211100011100111111101011110111011110111011111a11111111111111011111
11010112022200122220200102220222002211111101111111010100a1111111121202121122211211001101011210221011010111011111111111101111111110011110110a11111100111111101111
11001212202210222221122122200221222212111111001111111111a1111111121111011200121022201101111110221111111111111111111010111111111111111011111a11101111111101001011
10010110121022122022221222010222221022100110101011110011a1101111110022122112211211202110211120110101111111011011111011111111010111111111111a10011111111111111110
11111201202220012222202112222012211101001110101110011111a0111111110220222011222011222212200122021111101111111110111011011111102112011110112b20221111212211011111
11012201121002221202210222200222021101111101111010111011a1110011101110221221001211111212200211120111110101111111111111111111221111222211212a22202212120122001010
01122112020211210100222221222222211111010010111010111111a1011011111122202210112122021112222210211110101010111111011111111110221122201112122b12211111210101111111
10111020211222222222202202202021212112111111111101101111a1111111022220201210212221111202122121221101111111111110101111001112101100221121220b11111122202022110101
10112022222222122021022122202112202102211222122122221121a0120211022102022112221212210121120021111111010110111110101111111111222110021202101a12011002211111111100
10021012222102222012122222022012222222212201112101112121a1211201122112211212200222221202211201010111111111111111111100101110122121222211112b01210221010222111111
11101121222122200212220210212210212120110101121122222201b1001101110210120002001212102211122102111101111111011011111111110110212011212101111a21022111021011111110
11101201221020222010221202022112121220012021001121221122b2201201021221112111111102201220100220021010111110111111011111010110222101120121110a20212121212201111110
11112122122220222220121220010101122122122221111011221211a2222011111110102220022001012221212200220111111011110111101111111112220212121220120b11111111222222101011
10121222102122210212022220222222222222121010120011222221a1002211111111110202122212220102101211201110111111111111111111101012200222012021021a11122201121111101111
11112122222220221122021202222222021220211101012212100201b00011011212222222111202212202122002120111011111011111111011110aaaaabababaababbabbba12010100112122111111
11112010212222220221011120022022010222221212202011002111a22101111200222112201201211202122221102111110011111010111111111a1110111201121222121112110111220202100010
11111100120122210201222121010022202212110211112101111212a21012111100111111110100111101111111111100110110111111111101111a1111100212111010111012112102011100111010
22122022202122111202222211222122222220210201122022010111a21122111111101101111011111111111111011110110111111101111011111a1112121112112021012221121011211021011111
12212222021101222022022222221021122211210112212102122202a10021110101011111110111111111110111111111011111111111111111111a0112211121021021222110210112220220011111
22122222221022122020202120221222221221122212102101112220a00122111111111111101110111111111101101110111011111111111111011a1112221212020222002220212121001002111100
21211012212120220212112122022212220202112200120021001111b01222111101011001101101111110111110111010111100011011111101101a1011122212211112111121010012122112101100
21010102001211222020211220222201222222021111122222120221a20210011111111101101000111011010101001010101111111111101111111a1112112222212200122011102211122022111111
22211021222012221200122112201212122220012012000220211011a00000111111111101111010111101111011011011100111011011110110111a1112022210011211111122100222221102111111
12211022121221210020102222010212220012202001222221211122a12212111111111111100111111111111101110111101101111101101111111a1112221111011221222111112121211120011111
bbbaabbbbabaabbbbbabaaaa02121110112101212010102221221211b22121111011111111101011101111111110111111111011011111111000111a1112021112112020102212222221111222111110
12212112111221202210121a02222112101011101220210222002101a11202111111111111110111111111111111111110111111111111111111110a1112122101211221222121221022022211111010
20212220212110112110111b12122211111111202120111020120222b10100011110111111111011101111111110111111110111111110111111111a1112122211010011100120121112221110101101
21202122222122112200201b21111220211020212201012102221202a01012111011111110111101111110011111111111111111111011111111101a1100111112111212222100221110102112011101
21121111222220112221201b22212112211222112112101120112121a10121111101111101111101111101011010111101001111100111111111111a1100022112112222201110122121202110111110
01212212011221102121202b22212100210111102211021212110121b12222101101111111111011011111011111101011011111110111110010111a1111111122102220121121121010011112011111
11212110112221110022222b01011011212202212010020021221202a12100101101111111011111111111011111101110111011111110111011010a1111101200011221121101221211111222111010
11102212121000120011222a22022102121112001222222020221211a20212111110110111110111111011111111111101010011111111111111010a1110020221221212110122212122012220111111
11021221112102021121212b01121122102212112111112211112111a11211011111111111100111011111111101111111101101101011111101111a1102011020210112112001222100020212111111
01222220222220221201111b21212120211211222102211211011120a21211111110111101111111111111101011111011111111111111111011101a0111112111222210112221121222012122001111
12212222211120221121111b22211210112120222120121222122122b12112110010111101101111101011001011111011110011111010010111111aaaabbbabaabbbabbaaabbbbaaaaaaabbaaaaaaaa
22201100102111012021212b12020202212221101212121111112202b1211211111111111001111110111111111111111101101110111110101011011111111101111111101111011110111010111111
12121002210111100012011b21122220022101210102211112222112b1011110011110111010101110111111111110110111101111011001111111111111111110111111111111010111101011111110
22200112112220222111202a11021222110212201210012022212221a2112011111011101111111111101111111010111110111110101111111111110111101111011111110010100011111111101000
11112211221111020020100b21021210012020121122201020211021b0110211011110111111111111011101011100100111111111111110111110110011011111111111011110111101111011101111
21221221101201220111100b21212111111111011011111111101101a11aaaaaaaaaaaaaaaaaaaaaaaaaaaaaaaaaaaaaaaaa111110111111111111011111011011001111111111011111111111111111
22112120111211221111202b10120221111001011101101111111101a11a111100111111111101011111011101010111110a111111001110101111101101111111101010001101110111110100011111
22010220121111110212101a11111021011111011111111111110111a11a111011011111110011111111111111111111111a110110110111110101110110111111111111010100110111111111101101
10120110200012211221221a12010111100111111111101111111000a11a111111110101111111011111110111111111111a111111110101010011101101111111111111110110111111111111111111
20101011122111101112220b11120221111011100111111111001111a01a111101111111011111011111101111011011110a111111111111110110111011111111111101111100011111011111111111
22210121121121011212012b21122121111111110011011111111111a11a101101110101111110010111011110011111111a111101011111111111010111111100101000111111111100101011101110
22211122202222122211020b11211211111011111011111111101111a10a110111101111010101111111110011101111100a110111101111001111011101101111111001110101111100111111011111
12222100102210021201120b10102211111111111111110111101011a11a111111110011111111110111111001111111101a101011111111110110110111101111111111111111011111111011111011
11212201221121211022221a21120121011011111111000110101111a11a111001110111111011111111111111110111011a111111111111111111111111111010101111111101101101111110100100
01110111111111111111111a00011100101101110101110111111111a11a001111111101111011111100111111010011110a111111111001011011101011111111111111111111110101111001111010
11101110000000110111111a01111111111111011101111011111111a11a011001111101110011111111101111111111011a111110111101111111111111110111110011101111110000111101111111
11111111111101110101111a01101101110111111011111111111111a10a110111011011011111111001111101111111011a111001111110111011111111111101110011101111100101111110111111
11111010111011111011111a11011010111111011101111111011110a10a111111011110111111110011110101011111011a101111111011010111111101011101011100111111111111000111111101
10111010111111111111000a10111111111111111011111011011011a11a101111111101011011111111111111011001111a011101111111110100101101111111111111100111111111111111111101
11110111111111111111101a01111010101111110111111111110011a01a111111111111111111110101110111111101101a111111111001110111111110010111101111111100110001111101111111
10111111111111111111011a11101111111111011111101001110101a11a100101111111111111101100101110010101111a101110111111001011111101011111101010111101101101010111011011
10000111101111111111111a01011101111111001111111111111111a11a010011001111100110111111011110111111110a111111111011111111111110111110111110111111110111101111011101
11111101111111011111011a01111101011011111111111111111111a11a111110001011111011101111001011111010111a110011111111111101100110110110111111111101111011111101011111
01111001111011111011011a10011011110111111001111111111111a11a110111011111111010011101010110111111110a111101111111101111101111110111111111100011111111101111100111
11111111110110111111101a11110110111111111001111111111110a11a111111111111011111101011101110111101111a111111010111101111101111111111111110100111110110111000111111
00100101111111011011111a01111111011101011110101110111101a11a111111111011111110011011010111011101111aaaaaaaaaaaaaaaaaaaaaaaaaaaaaaaaaaaaaaaaaaaaaaaaaaaaaaaaaaaaa
11111110101111111111011a01001101101111101111101110111111a11a1111111011111111111110011111011111110101111111011111111111111111111110111110111101111111111111110111
11111110110010110111001a01111111111111110011101111111100a11a1111111101111110111110110000111111111111101101111110010111110111101111110111100011101111110111011111
11011101111110011001111a11111111111011110101111110111110a01a1001111111111111111111110111110111011101111111110101111111101101110011111111001111111110111111111111
11111010111101011111101a11111101011011111011100011110111a11a1101110010011001111110010111110011100110001110100110011110101111001111111011111111111111111111111111
11101110011111110110001aaaaaaaaaaaaaaaaaaaaa101011110111a11a1111110111111111111111111011111001111111111111110111111111110111110111111101111010011111110111111101
1111111100111110101001110011101010011011111a110111111111a11a0110011111101111110101111001111100101110001011111111111101111111101111111111111011001110010000111111
0101111111101110111111111111001111111101111a111111100111a11a1101111011011011011100111101111111111111111101101110111111111111111111011111011101111111111111101111
1110011000111011101111100011110111111111110a101111111111a01a1111111110111110111111101111111110111011001111001101101110111001100111111111111011111111111011111101
1101111101111111111111011011111111111101101a100111011100a11a1111111111111011111101101111011111111101111111111111111110111110101111111101101011001101111111111110
1011010111111111111111011111111111111101111a111101101101a11a0111111011111111111111111111111101111111110010101111101011111111111111111110111111111101111110010111
1111001111101111111111110111111111011111111a110111011111a01a1111101111111110001111101110111110001111111110111111011111111111111101111111101111111101111111111111
0111100110111111111111111111101111101110111a001110111111a01a0101111111111111100011110111110101101111111101111111111111110111101111111111111010010111111111101111
1111010011111111110011111111111111111111111a111111001111a01a1100011111110101111000011111111110000111011110111111101110111101111111011111010111100001111111101110
1011011111111110102112011200201100121222021a210111111111a11a1111011111110101111101110111010111101111111111111111110011111101111101111101101111111110111011111111
0010111111101100101212222021110201212120111b021111111111a10a1011101111111011101101111111100111110011111111111111110111110110101111101111101101100111011011011101
1101111110111111021100112212112212220100121a221111101011a10a1011011111011110111010101011101111111111101111101101111011111100101110101111111101111101111111111111
1011111010011101010212102022211112101221211b211111110111a11a0010110110111111011110101101011111011111101111111110111111111111111011111111111111111011110011111101
0111110111111111211111222102122002221221211b111111110110a01a1101111111111110110111110111111111011111101010101111111111111111111111111111110110111111111111011110
0101101111111111122221210121221211022101112a122101111101a11a1110101010111100011111100010011011101101111111011111110100111101111111111011111111111111110111111110
1111101111111111022112001220111200121222210a211111110111a11a0101101101011011111111111111111011111111011110110111111111110111111111111111101111101100111110111111
1110110111011111100112221110221202222212100b212001111111a11a1011011111001101111111110110111110111111011111101101110011111011111111111011100101101110110111111111
1110010100010011120211201122212221122212011a100111110111a11a1110111011110101101111011111011111111111111111101111111111011011111011111111101011011111101001011011
0011111111110111222201122221222222212111210a222111111010a11a1111101111101001011111111111001111011111110111010111111111111101111100110001111111111011111011111101
1111101110111011221212212212011010110122102a121110111111a10a1101111111011111011111110111111011101111111110111111111111101111111010111111111001111110111011111100
1111101111111111002202121221111222212201011a102001011111a11a1111111111111101011101101101011111011111110111011111100101111111110010111011110110011110101111111111
1111000001011111222111100122012222022022021b212110100111a01a1110011111110100101111111111111111110011111011011102222121120120120000012112212220111111011111111011
1101111100111111001222122012101212122111112a221011111011a11a1111111101110111111110111111111011111011111111110111220200121110201212200121221121110111011111111111
0101101111110111021101010102120010112222221b011111011110a01a1110111000011001011111111011111111111111101101111122201200210221121112212221210100111110111111111111
0101111011011101121011222010122200120021211a101111011111a11a1100011111111101100011100110100111101111111110110121221120202111212111202021110001111111111011101100
1110100111010111211100211212212212101112112a122111111110a11a0101111111111111111111111111111111101111000101111110122221112212002022200012122001110111111011011111
1111110110101110112221210122101122200000121b111111100111a10a1111011111111111111111000111010110111111111111111120100112211011110010012011212211111110111111100110
1111010111111111202212121202002122100211021b120101101111a11a1111011010110011011011011111101011111011111111011121211212111222222210222220212221111111111111101111
1111111101110100012221222220222122122022111a202110101111a11a0111111101111111111110110111111111111111111111111121121111112111210022001111111101101111111111111111
0011111111111010122012011122122021200202202b201111111110a11a0101101111101111111111111111110111111101111111111112112122011120211000020102122101110111101111111101
1111011111101011212200211221122221010111221a211111110101a11a1111011101101101111111001111111101111111111111110112111112111211221112012122202210111001010110110111
0111111111011111202122122212012100111222121b022110111101a11a1111011111110111111111111111111111101111110111110101022001122222122110222212012021111111111111101111
1111111111111111222020221221022122102112221a211110111010a11a1110111111111111101100101111101011111111001101101121122010120222110211112212202211111111111101111111
1111111111101101112200001210122202211021211a201111100111a11a1111100101011111111011111111111100110001111111111121220212010222000002011211222121010111110011110010
0100010111101101002222111112121022112210021b211011111111a11a1111111011111111111110111101111111111111111111111112022011111210100111122221112111101101111110111111
0110110110111111111001121112221121100211111a112011110111a11a1101111111011011111110111101011111111111011011110121221102211011121112111011022121111111111011111111
1010110111010111002122221120102212112121122a111101011101a11a1101111011111010101111111001111111111111111111001112122011121121211122220001221021111111111111111111
1111011111111101111222202222112221101221110b212011000111a11a1111101101011011011111111111111111111101111101111102211010212121222110220120111021110101011101010100
1101111011111011101022120222012200221220222a212110010101a11a0011111111110011111110111111111111110111101111110111112020121122212112222122212211111011111011010111
1111111111111110022100121001011111001121021a222111111111a11a1111011111111111100111111101111111101111111111100122120121122021121220112120211101110011111111110010
1110111111111111111111111111101101111011111a111101111001a01a1111111101111110111111101111111111111110111001111112012121212011121011211122221121111111100111111111
