143 49
8 116
22 23
138 34
46 38
18 4
125 115
31 103
80 5
1 47

100212221111122b21222110110212122211111101a1111001a01011101101111210212011111022221221111102012b1111111111011101111111111110111011011111111011100110111111111110
111212211110222a22122211121021221211111111a1111101a11101101110111212220100112120110010210112221b1111101111110111101111101111100110111111111111111101111101110110
110212102122220a00111111201122022210111111a1010111a11111111111011011212102221112112112121112022a1011111111111101110111101011111111110010011111101111111111110111
100222211212122a12011022111222200211111011a1101111a11111110111111021120122212212112112212111122a0111111110111111111111111111111111111101110100101110111101111011
111121010111222a10110111102210012011110001a1111111a10110111110101010122112112012101112212120112a1111110111111111000011001111101110001111101101110111111110111111
111222102012022a21022122011211112010110000a1111011a11111001111111210221102221020221212221110220a0011111111111001011010010111011111101111111101001011111111111111
111022021010211b21001101101112220201100111a1100111a11111100111111110022222222121122221112111002a1010111011011001110111101111111111111001110111111011110111101000
001120121211100a21122202211221021210111111a1111110a11111110110010111100201222211111021221122010a1111100111111111110111111001100111011111101101111111101101111111
111212221222221b11200020222220222221021111a1111111a11111011111111111112210120110221111102200122a0111101111101101011110110110101111111111111011010111111111011111
101211120122222b22222100011122212212221011a1110101a11111101111101202212021112112112221201221101b1110111111111111111001011111101111000101101110011110111011101111
111012211222222b22121001220112200000210101a1100111a10110101111111111210212111121122121211221210b1111111111111111111111100111101100111110111111110111111101110111
001011102220022b01212022222212221221221111a0111111a11111111111111112112010102202122221221222111b1011111111111110111111010011111111101111011111111111010011110111
111122102112122b11211012221022222222020110a1101111a10101110111111001000122122101010121101222201a1011100011111001111001011101101111111011111011111111111111111110
111111002222222b22221022022222002220011111a1110111a11111111101111101111112221102211112111212011a0111010111101111011111111111111111101111111111100101110111111101
111210122212122b22122210122111021001221110a0111111a10111111111111201102202221112111121122112022b1111111110100111011011100111111011111111110110111111111111111001
011022120222121b11110222112212121222011110a1110001a00011010111111201211102111212201102121210011a1111111000111110111111101101111111111001111010110101101010110111
111122222112102b20210201222221222201111111a1010111a11011110111110201112011120212100121201111011b1011111011111111011111111111011110111111111110101111111111100100
011022112200112b01121211221002222221111111a1111111a11111110010010200101211002212221121202222002b1111011111111110111110111101111010011101111111111101011111111111
111222022222000b20220220120212202120221111a1011111a10111110111111212112201111011120122010211121b0111111111111111001110110100111111111111010011111111011111100101
111121202011200b02120010222222221211211111a1111111a10111111011110000112122201201211112211020011b0010111111111010110111110112002112201210200121102000222212111011
111211022020021b20222210102202202202121111a0111111aaaaaaaaaaaaaaaaabbba211202202111111211021011a0110111111011101111101101112211002210222210011112121221222111111
111221122122222b22222222122222111122101111a101110111101111111110021220b122011211011221221111022a1010111011111111101111110111112211111211122122221021121110111111
010211110122222b22022222222202202202111100a101111010011111100111122020b101121221111221221222111a1101111011011111110111111111112111011221121022111112122202111111
110111002212100b20220122011022220222002120b112221110102212212111012121b102111220111201222200010b1110111010110111111101111112111211121020121110202222101112111011
111201202211201b20211012020212221222221211b012222211120202111011121210a221222110102220111211221a1111111111111101111111011012122111110222211000220122222211111111
111220202020202b20220212021012120221002100a200002212112200202111010111a111221112111000210022202a0111110101011100101111010101222001222111221012111112121102101110
011012110220220b20201201212212220002222111b122122112210110201200111211b021212210200221012211111b1011100111110111000101101112211202010122021122121210212221111111
111222222202202b02222202202202122212101101b110221210001002222201120102b111222220120211100200211b0111011111110111111111111011021222222121220101222221212101111111
011100120222221b11022222222212222222210111a221111112120221122211111220b212112121120000211200012b1001111011111011011111111101101202011102022011110012022201111111
110102112121210b11220020012022222211100221b121021202112221222211112121b022000220212111202122210a0011011111110111100111111111211120012010210201221012120121001101
111012122021220b21121221222222200022122002a101211020212121122111121122a220001212220122212122001a1111100011111111110111011112122121112021201222210111222122111111
110110120012101b02200210212212222012111211b100101110212211112111111110a111111101110110111111111a1111111011011011111011110111021012200122111021112221122212110101
010220020220022b22022221122202001222220112a211111210212122022001110011a101001111111111011011111a1101111100011111011111101112101011101102120212222202111121111011
011122220212220b22222212201222022021211212a220022221121211211211111101a100100110101111000111001a1111101111001011111101111112211222212111002210221022101002111101
011022202120200a00212212221112222222211010b110111112011221121211101111a010111111110111111001111a1111111011111001111111110012222222122212111122022222211112111111
222101122112202b10101201221212120022221020b210202222210011211211010111a111111011111111001011111a1111001110101111111111111111202201211211022222212221212121110111
001102222202222a22101202011122102202021101a112101112121101211010101101a011111011111100001111011a1111111111111111111110001000212110021210110021221200122011111111
122120120002122b02222102022022222212220002a222121220111021211211111111a110111101011111011101111a1111011011111111011111110112202120220222112100221222211120111111
201211222220222a22012011001122221220222122b110211111221210211111111101a111111111111111011111111a1111111001010111111111011112011120102022211221212201210022111111
211122021202010a12212100111121220012012101abbaaababbaaaaaababba1110111a111111111011111001011011a1111110011000111011111111111102212020110220101211202111101111111
022012011121200b2121101111201210210211112002200002210122202220a0111111a101111101111111111011101a1111111111110000111010110112112222020102212222211122210102011111
111211110112220a2022020120202111221111112101121111111220102021a1111010a111100010010100111110111a0111111101100101111110111111221212211112220212222212121121111111
122220121202201a1102210101210212102121100202221222001202221211a1111111a111111111011111111010100a1111010111111111001111111111221112111221222122021021221222111111
011221122221212b2122221211220120202110001211211121100120100222a0111111a111111111100111110111111a1110111111111111111000111112201012021212212221102222111001111110
021212221122212b2222201001221110011111210212122101012101202222a0111111a101111110101110111111001a1111111111111111111111101111211201112200211120021112221110111011
121212121122110b1101002121222212122211211121010122022211211101a1111111a101011110100001111111111a1010110011011111111111110111210210222101222211121121110110111101
110110211002211b2122211211201121221222100022202221121011222222a1111011a111110110111111111011111a0101011111110111011110111101110211112121002121011201211212111111
111222021002120b1200212210011002221222102122112211112222101211a1110101a011111111011111110111100a1110111110011011110110011012021222122221211101020122202210100111
110122112202021b2121221222012201110112011021212212101222201122a1110110a111110111111111111101111a1101110111101110111101111102101112001222101211222101121202101111
222211202111122b0110122211222122012121012102111021210101222222a1110111a111110101111111101100111a1111101011111111111111111112022222121211011021112220112021011111
222210101201112a0120112111122112211112001220201201100201110122a1111101a111111011101111101111110a1111111101111101111101101111111111111111101000111110111011111101
011111111200112a0001111121111102121200111221212122211011201120a1101111a111110110101110111111111a1111001111111111110011010111111111011011110011101110111111010111
210101222011102b1221011211122222210001100112221222112210122121a1111111a011111111111111111111111a1111101111110101101010101100111101111111101111111111111110010101
112220212221201a1221221121221122102210112111122121022110121112a1011101a111111111111111111111111a1111011011110111110111111001111111001111001011101101010111111111
111210112121101b1011021222202011111111011111111011111111101111a1111111a111101111110101111101111a0111011111111111101111111110101011111111011111111111011101011110
101121111112212a2221101121111200111111010111101111111011011111a1111101a111100111111010111111110a0111110100100111101101111111101101101111111100010111111111101111
021121121020100b1021111102111121111110110111111111111111111110a1011111a111110100110101111111111a1101111110111101111100111111111111010111110111111101111111110001
120211121121121b0220012211210211111101110110101110110101111101a1011111a111110111111100111111011a1111111110111011111111111110111111010110111111111111111100111111
011212121221221b1122122102222221111111111111111110111110110011a1111111a111111111111100111111111a0111011011111011111111111110111111111011110111010111111111111111
112112221122012b2112112221122220011111111111111110110111110111a1110000a011110111111110001111111a1111111111111100111111110111010111111011111111110111111101101111
221022002011211b0122000212111001111011111011111111110010111110a1111111a111011111110110101101111aaaaaaaaaaaaaaaaaaaaaaaaaaaaaaaaaaaaaaaaa111011110101110111011111
120221212222201a2022222212111121101111101111111111111111011111a1111111a1111111111111111011111111010111110111110101111111111111110111111a111101110111001111111111
002212221110221b1212102202011101111111110111110110111110011010a1111101a1101111111101110111101111111011111110001101011001110111001111111a010011101111111011111100
011101111111101a1111011111111101101101111111111111111011111101a1111111a0110101111111011101111100110111111111110111011111111100101011111a111111110111111111111111
011011111111011a1111101101101011101110111111111111001111111011a1111111a0111110111010111111111110111110111101111010101111111111111111110a101011111110101111111011
111110111001111a1011001111011111111111011111111111111011111101a1011001a1001011101111111101110110111111111111111110111110111110000111110a110011110110011111111011
101110001110111a0110011111110111100100111010111101110111101111a1010111a1011111111111011111111111111011111111011111111101110111111111011a101111111110101111000101
110010011111011a1111111111110111111110111010101011111101011111a0001110a0110010110110011111111110011111111110101110100011111111010111011a111011111011110111111101
110011111111111a0110111101111111111011111111111111100111101111a0011001a1110111111111111111111111111001111111101110111100101111111011111a011000110111111111111111
111111111101110a1111111111111101011111111111111110111110011111a1101010a0101101101110111001111111011011111111111111011111111011011011111a111010111011111111111110
010111111011011a1111010111111111111111111111011110111010111110a1001111a1101101111101111010111111111111111010111111111111111111111110101a011111001111111011001101
111110011101111a1101011111111111111111100101101111110111001101a1011111a1111111111011111101011111111010111111101101111111110011111111110a111101110111111101111011
111111001111111a0011010100101011111011111101111010111100110101a1011011a1111111011111111101110010111111111111111011011110111101011111111a011011111110111111011011
110110111101110a1111111111111111101111001010111111111110011111a1110111a1111111111111110111111011101111110111111111001111111001111011101a110111111111011111110111
111111111110111a1110110111011011111111101111111101110110111011a1110011a1111111000101111101111111111101101110110111111011100111100111111a101111111111111111111111
111111011111111a1101111011111110111111110110111111011111010111a1011111a1111110111111101111111110011011101101110100011101110110011111111a101011111101111111111011
011111100011110a1111111111111011111011111011111010111111011111a1111101a1111001111101011110111111111110011010111111111101111011110110011a110000101111111111111111
010110100111111a0110111111011111111110101111101101111111111001a1111111a1111111101111111111011111111111111111111101111111101111110111111a111111100111111011011111
111111111111111a1101111111111111101111111011111111111111011100a1100011a1111101101111111111011111011011110111101111011111101111111111011a111111111101110101111110
011011111110111a0110100101010101111111101110111111111011011011a1011110a1111111111011110111111011111011111111001111111111111110111111111a001111011111011011111100
011010111111111a1111111011111000111111111101111111101111111111a1111110a1111101111111111011111111111111111110111011111111111011111101011a111111111001111011100111
001110111111111a1111111111111111010011000011011001111111111111a1111101a1111011111111111011110111111111101111111101001111110111111111111a110111010111111101110110
111111111111111a0010110111011111001111111110101110110111101111a1111101a1111111111101011111011010111100001111110111111011111111010111111a010111111111111110110111
011100111110001a0010101111111111111111110111011111111111111010a1111111a1111001111001011111110111010101111101111111001111111111110011111a111110111111111111110111
111011111111110a1101011111101011111110111111011101111011111011a1111110a1111111111110011100111100111111111111110110111010111111111110011a111111011101111111100011
011111001111111a1111101110111010111110111101111111111111111110a0111111a1010101111011011011100101111111111101100111111111110110111111111a111111111111001111111111
111110111111111a1111111011111100110011111111111101111011111110a0111101a0111111101010111010111111011111011011111111110110111011111111011a111111111111111011111011
011111101111111a1111011010101111101010101111011011110111101111a1101111a1111101111100010101111111111101111001101111110100110011110100111a101011111111111101110111
111101111001111a2220001211112211021122222011101111111111111111a1100101a1111101111110111111111110111111111111011111111111101101111111111a111011111101111010101010
101111111110110a1210112122111111112222012122112011111111111111a0101111a1011111111111000111111000101111111111111011111111001110111110111a001100110111110111101111
111101111111111a2202212221021122022112212221122111111111111010a0101111a0111111101110101111111111111111111111010111111111101111111101101a001111111011111111101111
111101111111001a0011122112221202210222212200102011111101111111a0110111a1111111011011111011101111110111111111111111111101111111010101011a011101111111010111111001
110111101100111a2122222110111122222201201121002111101101110011a0111101a1111111111101111110001110100011101101111101011110111111110110110a101010111011100110011111
111110101011111a0211101121111220121221210112000111111111111001a0011110a1011110101101011111111011111111111111111101111101011111111111111a110110111111111111101101
011011111111111a2102201220210212121200112222021011111111111110a1111101a1111111111101111011111001101000111111101101011111111101111101100a101101111111111111111111
111101111111111a1101100122020121021121120210020010111111101101a1111101a1101101011111101110111111111011101101110111110101100111110111011a110101111011011111101110
111111111101110a2220111022111111211211121010111110110101010111a1011100a0011110111011111111111111011100111111101110111111111111101111011a111111111001101111100001
101111110011111a2001211022022122111112210220120101111110111101a1011110a0111111110101111101111111101101011111111011111111111111111001111a111111111111011111101011
110111011110011a2102212220002121210120222022111101101011101011a1111000a1110111110011110111101111001111110111111111111101001110110111100a111101111111101111111011
111001010110101a2120101221212011021212222102210011111111111111a1110101a1111101101110111111110100111111111111111111111111111111111111111a111111111010010111101011
111101111011111a2202222201102110121121120211111111111111011101a1110011a1001101101111111111101111111111110110102110121222220001110022121a011111001110101001101101
111001110101011a2221122001202201221110210222202111111111111010a0111111a1111101111101111000111111111111111011111002110222221001022120022b200211111111111111111011
111111111111101a2112021201001000212120220110012010110111111111a1111111a1101101111111111111111011111111111111111211221210110221212101211b221111100111001111111101
111011111111111a2112212202221222020220122121120111011111111101a1010111a1011011101111011101100111111111011110112112112222222101212211021b221021011011111110101110
010110111110011a1102002222021111212122220101210111011110111111a1111111a1101111111111111111111111111111110001112212122122012011101012220a210111101111111111011111
011111011111111a0121200211110122112221111112210011111010111111a1111111a1111101010111110101110101111100111111101122212022111210112121022a121201111111111011111010
011101101110010a1211021212122222001122111101110111011111111111a0111101a1011111111111111111101011111110111111100102200011121122101101101b012211001111101111111110
100111111000111a2102102120122221212202222201011111111111111110a1111111a0011101111110111010100111111110101101011021012221020222021202212a122221111110111011111011
111111110011111a2121111222021112212212201210121111111111011011a1111110a0101011001111100111110111011111111111111112111022222022122121000b122110111111001111111111
111101011111111a2211111102121022121101211220222111111111011111a1101101a1101010111111111111011011110111111010100102021212210102101212122a101210111111100111111111
111111110111111a2012212121111210222222212112122111111111111111a1111110a1011101111110101011111111111110111111101212212201211111112220222a001210111111101110100011
111101001101111a0212210211121212112111121001212010101111111111a1111111a1111001101111010101100110111100111111112120121210221122120210212b020121101001111110111110
010111101111101a0011220212112101122220202112222011011111111111a1101011a1110110111111101111110111101110011111110111212120010210111011222b111221110111100110111110
111111111011111a1222211202221001111120012210221011011100110111a1111111a1110111110110111101011011110011111111112102112122222112221020011b122121001111011111111111
111110111010110a1212102022022221112020201200222011010011011111a1101111a1101111111111111111111111111011111111011211011210111220101120001a112221111111111111111011
111111111011000a0112221211120121011212122221212111111101101110a1111011a1101111001100110111101110011111111101110111121200121211112211212b010221111111111011111111
110111111101111a1200102022120020122001112121002110111111011111a0100011a1111110110101111011111111111111101111102111101112212202201121022b101111011111001111011110
111110011111111a2120102010120011111101122200200011110111111111a0100111a1111111111110110001011101011010111011101012012211102020111120021a202211111111111111111101
110111110001110a2001022102221110102011221121001011101111011111a1011111a1001011111011110111111111011010101111101222101211222111111120122a212021110111111011111111
111111111111110a0000111111111101110110111110111111111110101101a1101111a1110110011010101101110101111010101111112011121112202011111011110b121111101001111101110111
