54 17
98 106
22 23
138 34
46 38
18 4
125 115
31 103
80 5
1 47

110122211211122210122022111202011211111000111101010111111011100112112212212212212111022221a12a11110101111110111100110100101101111111111101a111101001a11101011011
111201000112101101022122221112122111101111111111011111111111101110112221121120112111011201a02b10101111111111111110011111111111110111111011a111111101a10000111111
101010121222102212100111220122101110110011111111111111111101111100012020011102211122221021a21b21011111011111111011111111001110111011101110a011111111a11111101101
111000211122222012122212021120222111111101101011111011101101101102221112201200011201212200a21a12011111111111111111111111011111111110111111a111010111a11111011111
111122012012100010210211102102021011100111111111111101111111111101112210111122222112221202a22b11111101111110111111111101001111110101111111a111111110a11111101111
111221121000212110012122221220222101011111110110111010111011111112001221221210202100222100a12a02111111111101110110111101111111111111111110a111011010a11010111111
101112212121221221111122101002101111111111111011111101111111101012220111220220112112012212a00b21110111111010101111111111101011101111111111a111111101a11111111111
111022021120222221202222221021112011111110101011110111111110111110011201120001121222110111b22b01010111110110011101111101111111111111011101a111110111a11101111111
011111122222212122202002222211122021211111110011001101111111111011221122101211221111011112b22b22101111111111010010011110011011101110111111a101111011a10111111101
110021121011201220111221222022022022201111011111111111111001110111022121221210212022111022a20b22101111111000111100111111111110100000111110a111111111a00101111111
110221122220220022220222122222222212011011110111011111111111111112200200221222202121222221a22a10011111111111111111111111101111111111111101a111111111a11111101110
011110221122012210110000222212001201011110011111010111101111110011202212221222002211112022a12a11101111111111111101011010001111111111111111a111111111a11111111111
101101212002222111222212020210222021101111101111111100111011101112221121021020221201122012b11a21111101111101111111111000101111111111111001a110111111a10111011011
101011202121212202120002022222201222201111111110011110111111110111212112112101201201002122b20a12001111111111001011101111100111101111111111a011111111a11100111111
111221110102020012012221222122222221221111101111111101011101010102221202002220121020000021b22b02111111111111010110011111111111010111111101a101111111a01011111111
010121222022022011212222222102120211111110110101111111011101110111111021121202121012112000b22a02110101111011011111011111111111110100111101a110101111a01110110011
101110222212022222220222222222222211110101011101111101111101101111012211022212110220201121b02a22111110111111111111010111111111111010111101a111011111a10111010111
111122102212100220122022112221122112111101010111101111111111011112222002112211002210111210b02a12110111101011111111110101111011111101111110a010011111a11111011000
111200222022222202122222200111122220110110011111010111111111101012122201211022202110221222a12b01111111011101111111110111111111111110011101a111110111a10011111111
011022202222122122122221102221010120111001111011111011111111110111201021212110102111122202a20a22111111101111111110111101011021221112101211a200001210a22102010111
111112212222122220002122121121122212211111011111111111011110111002002111121111102222121121b20a12101110101111111111011011101221222201222121a112221211a20112011111
111002211210022120222212121122222000111111111101111111111111111011102221022002100111122211a21a12110111111111011110111101101110022112111021b211211112a21021111111
101212122121122022222222122220022212111111111011101111101111001112121121122222210222211122b12a01011101111110110101001111111211112212110012b021021200a20001111111
111210112002122211012212100222002212212012201011122222111111221112211121020100222102222100a11b02111111100011111101011111111120210121222122a211021022a22222011100
101012122211120201202222222002100102202222122021211121122222121102112011121012122221111212b02b01111011110111100110111111010212211011111101a111221110a22222011011
111121102220120121011220221210122202011112021112212121002022111110112100211122212100112221a21a12111111111111111010100111111112212221120002b021222120a02002101111
111012120211211200220211122220212222221212101210222102122210001110212222012212211211211012a11a20011011111101110111101101101202222212011112a012212111b20211010110
111212022200221211012222220121221220222121110022212222220001211110112202211210122102111212a11a12011011011111111110111111111011121111011121a211212101a22112101111
111000020222022020220202202221202212121021021112022122112211011112112221121212221221120112a10a02111111111111101011111111111120211120011112a211111112b21221111011
111221022222210222022101221222220222001011102021200111212122120111221210102002120121101011a12b21111101111111111011011110111111202110212210a121202222b11201111111
111202222222222212211212002112222222022220112121012121222200101111021210020020011122100221a02a11111111011111111111011111111121102012020122a222211211b11112111111
111111121021222221112202110122121222220121212002012020222110110111111111101111111011010110a00a11011111111111111111101101101001121221212121a201101221a22102001100
121122020122200100212122222122012212211222122212022220201112211101111000111111011111111111a11a11111111111111011101101010111122022112111221a010111120b21102111111
122020122222222222221222222201002001201212222121122021010211221111111110101111111101111111a00a11111011111101110011001111001122200211221122b211121022a11211110110
111011102212112221222221222122221110221012222102212011202210001011110111001111111111011110a11a11111111111011111110111111111222012220122211a011112210b21221111101
021101212210222222222222020222122220210202022221111212112121120111111011101110110101111111a11a11111001111111111110111111011211212121021112a011112112b01121111111
120211022212202200102012200021222120220022122222221221222120111111001111111111111111111111a11a00111111100001111111111111111122221021111011a211201222b10122111100
111121011122212200201122022222211101212211221221211122220121121110111111111111111111011011a11a10110110111111010111110111010122111212022100b110020211b02020111101
000022122100221120222222120122222221001112212011211221111102110110101111111110111011111111a01a10000111101111001111101011111022222110212111b100120201a21202111011
221011111020211021211021122222122221101112101021221221112102111111111101111111110011111111a11a11111101111111111101001111111021121211100122a201211121b11112011110
202011001111201202022201021210110102211220102110111021100202021110101111011111111101111111a01a10111111101111010011111101111112111110012112b222021222b01010101111
221222112111121222222202112222210110212110220120122022220022220111111111111111111001111100a11a11111110111100111011111111111211102021200221b012211101b20120111111
112212221222212110102221011201211120222120212002222221221120021111111111111111111111101111a11a11111111111000111111111111101222211122022201b221010121b22121111001
212112211120001022022220100101112122110101012112121012012201111111111011011111011111110011a10a11011110101111011111111110111211212202112012a212110120a20121101111
211211221201101012211101212110201021102212120212021110022011120111111111011111110111111101a11a11000111101011111111011011111222222212110200b020111200b12111101111
120212222020010201120222122122211000222002212222112202222112021111111111011101111111111111a11a00110110111101001111111101111202222111110002a212211001b22111110111
010122122111212222110222110121102222210020122222210121001201211111111111111111110111111111a11a10110111111011101111111010101111212212222101a122221022b22211010001
112001202112122212101222212112112011212212120212221212011200011111111111111110111100101111a11a01111110110010011111111111100122212212111002a101121210a02110111111
212101121221212111111121112212122010210111110122022112221211211011111011110111001111111111a11a11111111111111111111110110111200211220111121b112221001b11211011111
211111122012222222001211221222212212100210111212210112120122011111111111110100011011111101a11a10100111100010111101110111111021111202221211b212102201b10100100111
222112220221121211121222211212102022100211210112200020121120121111110110111111111111111110a11a01101101011110111111111111111111111011111011a111101110a11110110111
201211211220102120102210112112212221201201212121000200012100121000011110010111110111101101a11a11110111111111111110110111101111000111011111a101111111a01111011110
001120211201111121010210111211112111002221212222122211122120121111111101101111111101111111a11a11111100100111101111110110111111101010111101a110011111a00101101110
221021111002120102221021112101212220121212111122102012120121010111111111111111111111111001a11a01111110000111111111111101111101010101111101a110111111a11101011100
212202211222221012212110012111111011111111100111101111111010111111111111111101100111111110a10a10111111111011111010111111010111111111111111a111011111a11111111011
110221102022222012210211112121010111111111110111110111111111101100111011111111111110011111a10a11111111111011101101111111110111111111111010a110101111a11011011000
101021220101111000011211121221211101111111111011111110011111011110101011111111111111111111a11a01101101111111111111011110111111111111011101a101111100a11011011010
122102111020111211101220111112111110111111111111111111011011111011111111001011110011111101a11a11111111110111111011111111111111111001011011a111100011a11101111110
222220220110222120111101222121010011111111111001110011100010111111110111111101111101111010a11a10111111110010111111110111011000011111111111a110111111a10011011011
111120211201212122211020122212211011011111100101100110110111110111111111111111100111111111a11a11111111100111100011111101111111111111011101a101111111a11011111011
200212112122222121112122212222111111101111101111110101110111010001111101011111111111111110a11a00011001110111111010100101111111111001110111a111111110a11101111111
111221111122201211122122001111111011111110110111101011101111111111110111111111111110111111a01a11111111101111111011111111111110110111111110a101111111a01010011111
222122012210111202012222122211111111101000011011101111111111101111010011111111011111110111a11a11111111011111011111110111011010111111111001a111111101a11011011111
101101011111111111111111111111111011111011011011111111111111111111111011110111111110111011a11a00111111110111011111111110111111111111110111a111111111a00111111111
101111011110101111111100111101110111011111101101011011110110011111011100110110111100110111a11a11010111101101111101010011110101111110111101a111111101a11110101111
011101111011111111101101110111111001111010111111111101111111110110111111111110110110111111a11a11101111111111111111111111101111111111111011a111111111a00111111101
011111111111101011011111111110011010110111111111101111101011011111100101101101111011111111a01a11011111111101111111111111111110111111111100a110110111a11111110011
110111111111111111110111111111011111111111111011111110110111011000111010011111111111110101a01a10111101101110111111111111111001101111111110a111111110a11111111111
111110111110111001110111111111111011101100111101101011011101010111011111110110001111111110a11a11110110111101111111111111111111111001011110a110011111a11111110011
011111101011101111000101111010101111110111101101111111001111111110011101110111111111110011a11a10011111110110111011110111011101011101111110a111111011a10111101101
111111010111111111101111011010111111111111011111111011111110111111101111111111011111011111a10a11111011011101110000100111111111111111011011a111110111a11111110001
111111111011111111111111111011100111011111111011111101011010011111111111111011111111111111a11a11111011110101111111111011101111111011011111a111110111a01110101011
111111111111110110101011111111111011101111111111111110111111101111111111111111111111001011a11a11111111111111111110101100101111101111011111a111011110a11101011111
111011101111111010111111111111111110111011101111111111111111111010111111111101111101111110a11a10111101111110111111111110110111111011001101a101100110a11101001001
111110111111111101111011101110011011111011111111011111111110111111111011011100111110101111a11a01111001111111111111111010101100111101011111a010011011a10111111101
111101000100111111111111111111111011111111111111011110111111111111111111110111110011101011a11a11111101101110111101101111011111111100111111a111111010a11111111111
101111011111111111111011111101011011101111111111111011001110111111111111111111011101110111a11a11101111111111111111110110111011111011111011a110111111a11100111111
111111111111101110111001111110111101111110101111111100000110111101111000111101011111011111a11a11000111011110101110100010101111111111111111a110111111a11101011010
101111011111101111111010111111110111111101111111011111100111011111111010111111111111001011a11a11111111111111111110001111101111111111110111a111100111a01111011111
101111111111111111111100001111001101010111011100011110111110111111111111011111111111111111a11a01111110111111111100011111011101110011111111a111011101a11101111101
111111111011101111001111011011111111111111110101011101101111110111111111111111100011111111a11a11111111111110111111111111111110111111111100a111111111a11011001111
110010111010110111110111000111111111011110111110111111100101111110101111101111111101000101a11a11111111011111111010011110111111001111110111a011111111a11111111111
110111111111111111111000110111111110110111011110111111111111110001101111110111111111001011a11a10111011111100011111111111111111111111110011a101111111a11111111011
001111111100011101011111011111111111011111110111111111010111011111001111110111101011111111a11a01110111111111111101110111110111111111111111a011111111a11101111101
010011010111111101111111111111101111101110101101111100110101011111111110110111101111110111a11a11111101010111111101000100101001001111101111a111111111a11111111001
110100011111011111111111010110110011101111101001111101111010111111101101111111110110111111a01a01111110110101011010111111110111011111011111a111111111a11101011111
101100111111101110111111011111111110111111011110111101010111011111011111001111111101110101a11a10111110110011111111111111111011110111101101a111111110a11110110011
101111101100100011111111111011101101111111111111111111111101101011111101111111101001101111a11a11111111111101101110111111111111111111111110a001111011a11101101110
111111111111111121102012211122121101221222222100111111111111101101111111111110111111110101a11a11111111011111101111101111101111111101101011a011111100a00111111111
111111011011111101001220112010221202221012110201001111110111011111111111110111110111111111a11a00101101011011111111011111110111101011111001a111111111a11111111111
111111110111111110120111022121021210212112121001011011110111010111110111111011111110011111a10a11111111111111011000111101111101111110111111a011111111a11111101111
110111101011110122010012212221201212121221120220011111011011111101111110100011111010111110a11a10111111100111011101011111111111110110111101a110011111a11111111111
111111111011111112121222011201111202001111222110110111111011010110111111111111111111110001a11a01100111101101111100111101101011000111111111a101111011a11111110111
011101111111111112120020211210212122211020200210111101011011111011111111111111010011111101a11a11100111110111111111111011111101110110111101a000111111a10111111111
011111111111011112020211202021100121210021221221111011011000111101011011111111011111111111a11a11011111101111111111101011111101110111101101a001110011a11110011111
011110111001111122221221020202222211211212221021111011111110111111111011110111111101111111a11a11111111101101011111111011110001100111101111a110111111a11111011110
011111111111110110111121122212011111222201212121101111111111111001110111111110111111011111a01a01011110111110111111011110111001111101111100a101001101a10110110110
111111111111110122122121002222201111112221210011011111110111111110101111111101101111011111a11a11111110101111111010011011111011110111111101a110110111a11111111111
111010110110011110211021210122222221121201120121111110111111101111111111011111101011111110a11a11011011101011111111111101111111111110110100a111111111a11110111010
101101111111111121221011111220221111211210120021011001111111110111101110001111111111111101a11a11110111111010111010101100111111111110110101a111111110a10111111011
101011111111101112121101222122022211212121012111011001101111101011111111111111111001111101a10a11111100111111101222110222001111012121112201b221101011a11111101111
110011111011111102001021012021211020210222122220111111111101110111110100011111011111111011a11a11110111001111011212122022211112112110201202b101111111a11110101110
111011111011001111210111011201212000222221210121111111111011110110001111011111111111011110a10a10110111111001111022212111002201110201121010a111111110a10110001011
011011111110110112211001022212122220220222012221101111101110111111110011111111000101101111a11a11111111101101111210111222221211012111011122a021111111a11111111111
110111111011111122121011122221222222221221122121111111111111110111110011111101101111111110a11a01101111010111111002021011212011210222122121b121111010a10110101110
011011110010001012212221012222202222011201121221111111110111111111111110111111101101110111a10a10111110111110012112101002102110120212102112a121111111a11001100111
111111111111010101012211010012120101011221002211101111111111110110101111111110011011011111a01a11111101111111002022111111002111212011221012b110110111a11011111111
111110101111110110010112202011212222112202122221110110101010111111011100011111110111111111a01a11100110111011112112211011120221112201102222b201111111a11111101101
111101110111110121102212212112121022112100200211110111111111111111111111111111111111111101a11a11111111110111111011212221221211220201011122b210100101a11111010111
110111111111101101012211010112202212011112122121011111111111110011010111101110111101110111a11a11111111111111110110222221111111011221022001b211101111a11111100110
011101011111101112101101122121220112112022000011111101111111111101111011101111111111110111a11a11111111011001011122022101221202222011111111b101111111a11110111111
101011110011111112121100011220002020221101222211011111101101111111111111110001010111011110a10a10110111111111112221221111222102221121221021a201100111a11110101111
101110110111111121221112200212212100021221020101100111111001111110101101111111111111111101a00a11011111111011112222122111111200012211022222a221111111a11101111110
011111111111111120122121222201111212212211122111101101111010111101100101111110100111111111a01a11101111111111100201211210021101121111211002a211011110a11010111111
001011111111110102122110220101122101211222022211010111111111111111010101101111101111101100a11a01111111011111110111212012112221220221100222b221111111a11111111100
111111101111111011012222221222122122212222202111111001110111111110111110011111111111111111a10a00111111011111102011101221020021222211100212a211001111a11111101111
010110011111110012212111221221211122211212220111110011110111111101111111010101110110011111a11a11011111110111010211121012111001222221121120a211111111a10111111111
111111111111111121122121212100100122210112222201110001111111011111100110110101111111011111a01a10111011111000112122211112200122121202220202a211111100a01111111111
111110111011101102122210001120012121110221222101111101111000111101111111111111111111111111a11a11111111110111111212210222000111212202021101b111111111a10111101011
111011111101111000111110111001111111110011111111111100010011111111111111111111110011100011a11a11111110110111112122201111011211022110221222a021011111a11110101111
